date,control_point,arrivals_residents,arrivals_chinavisitors,arrivals_othervisitors,arrivals_total,departures_residents,departures_chinavisitors,departures_othervisitors,departures_total,weekday
2020-01-24,Lo Wu,26340,7383,429,34152,72074,6231,413,78718,Friday
2020-01-24,Lok Ma Chau Spur Line,16750,4979,196,21925,32215,3766,167,36148,Friday
2020-01-24,Hong Kong-Zhuhai-Macao Bridge,7294,1949,2130,11373,15775,2804,2086,20665,Friday
2020-01-24,Lok Ma Chau,10591,2921,407,13919,17682,3901,283,21866,Friday
2020-01-24,Man Kam To,1093,367,9,1469,1890,219,9,2118,Friday
2020-01-24,Sha Tau Kok,1008,264,27,1299,3207,210,40,3457,Friday
2020-01-24,Shenzhen Bay,8792,5354,685,14831,37864,5142,484,43490,Friday
2020-01-24,China Ferry Terminal,1013,442,373,1828,3511,453,312,4276,Friday
2020-01-24,Harbour Control,7,0,259,266,77,0,4,81,Friday
2020-01-24,Kai Tak Cruise Terminal,466,707,2400,3573,2487,775,280,3542,Friday
2020-01-24,Macau Ferry Terminal,6001,358,1395,7754,8985,390,1314,10689,Friday
2020-01-24,Tuen Mun Ferry Terminal,434,7,38,479,548,4,17,569,Friday
2020-01-24,Total,102663,36705,22872,162240,294785,31340,13018,339143,Friday
2020-01-25,Airport,14907,8489,10953,34349,58711,5326,7335,71372,Saturday
2020-01-25,Express Rail Link West Kowloon,1852,2278,285,4415,8489,2089,224,10802,Saturday
2020-01-25,Hung Hom,575,176,67,818,1509,153,53,1715,Saturday
2020-01-25,Lo Wu,20716,4368,317,25401,39692,5468,347,45507,Saturday
2020-01-25,Lok Ma Chau Spur Line,12511,3237,117,15865,16675,3347,155,20177,Saturday
2020-01-25,Hong Kong-Zhuhai-Macao Bridge,9121,2682,2339,14142,13570,2949,1830,18349,Saturday
2020-01-25,Lok Ma Chau,7187,2662,234,10083,10351,3163,195,13709,Saturday
2020-01-25,Man Kam To,753,262,12,1027,895,203,5,1103,Saturday
2020-01-25,Sha Tau Kok,923,208,19,1150,1702,165,38,1905,Saturday
2020-01-25,Shenzhen Bay,9834,4540,532,14906,20440,4993,451,25884,Saturday
2020-01-25,Harbour Control,2,0,89,91,2,0,2,4,Saturday
2020-01-25,Kai Tak Cruise Terminal,168,25,2315,2508,2997,129,2521,5647,Saturday
2020-01-25,Macau Ferry Terminal,6118,490,1355,7963,8120,378,1048,9546,Saturday
2020-01-25,Tuen Mun Ferry Terminal,567,11,44,622,782,19,14,815,Saturday
2020-01-25,Total,86417,29891,19177,135485,186168,28788,14633,229589,Saturday
2020-01-26,Airport,22646,10955,7522,41123,47580,7870,8813,64263,Sunday
2020-01-26,Express Rail Link West Kowloon,7481,2481,415,10377,2360,2875,300,5535,Sunday
2020-01-26,Hung Hom,2237,272,137,2646,575,307,54,936,Sunday
2020-01-26,Lo Wu,44781,4994,406,50181,22105,6754,348,29207,Sunday
2020-01-26,Lok Ma Chau Spur Line,19606,3816,265,23687,10678,4376,226,15280,Sunday
2020-01-26,Hong Kong-Zhuhai-Macao Bridge,12967,2486,2311,17764,10182,3053,2082,15317,Sunday
2020-01-26,Lok Ma Chau,10754,3119,362,14235,7058,3642,240,10940,Sunday
2020-01-26,Man Kam To,1093,345,24,1462,709,324,5,1038,Sunday
2020-01-26,Sha Tau Kok,2077,284,40,2401,1058,312,48,1418,Sunday
2020-01-26,Shenzhen Bay,26235,6051,868,33154,9524,7404,529,17457,Sunday
2020-01-26,China Ferry Terminal,2418,522,501,3441,1391,603,504,2498,Sunday
2020-01-26,Harbour Control,0,0,256,256,0,0,0,0,Sunday
2020-01-26,Kai Tak Cruise Terminal,2510,806,2251,5567,1000,394,317,1711,Sunday
2020-01-26,Macau Ferry Terminal,8216,554,1325,10095,6571,379,1284,8234,Sunday
2020-01-26,Tuen Mun Ferry Terminal,647,5,24,676,605,7,28,640,Sunday
2020-01-26,Total,163668,36690,16707,217065,121396,38300,14778,174474,Sunday
2020-01-27,Airport,36215,10309,6764,53288,41316,8203,11319,60838,Monday
2020-01-27,Hung Hom,2025,221,116,2362,244,308,54,606,Monday
2020-01-27,Lo Wu,43145,3643,387,47175,13999,5193,387,19579,Monday
2020-01-27,Lok Ma Chau Spur Line,17463,2863,203,20529,7787,3592,175,11554,Monday
2020-01-27,Hong Kong-Zhuhai-Macao Bridge,14306,1998,1998,18302,7369,2822,2088,12279,Monday
2020-01-27,Lok Ma Chau,10708,1945,356,13009,5174,3655,233,9062,Monday
2020-01-27,Man Kam To,1280,281,12,1573,569,324,5,898,Monday
2020-01-27,Sha Tau Kok,2212,189,36,2437,617,337,81,1035,Monday
2020-01-27,Shenzhen Bay,27513,4507,759,32779,5065,6538,598,12201,Monday
2020-01-27,China Ferry Terminal,3124,477,431,4032,944,530,411,1885,Monday
2020-01-27,Harbour Control,69,0,32,101,28,0,25,53,Monday
2020-01-27,Kai Tak Cruise Terminal,638,56,12,706,706,66,2190,2962,Monday
2020-01-27,Macau Ferry Terminal,7258,394,1271,8923,4981,343,1094,6418,Monday
2020-01-27,Tuen Mun Ferry Terminal,601,10,18,629,511,2,24,537,Monday
2020-01-27,Total,177470,28780,12816,219066,90477,34703,18930,144110,Monday
2020-01-28,Airport,54491,7187,5422,67100,41100,8306,12151,61557,Tuesday
2020-01-28,Express Rail Link West Kowloon,13133,1828,322,15283,864,2499,212,3575,Tuesday
2020-01-28,Hung Hom,1754,194,64,2012,203,316,56,575,Tuesday
2020-01-28,Lo Wu,39880,3633,381,43894,12598,4654,290,17542,Tuesday
2020-01-28,Lok Ma Chau Spur Line,17313,2575,194,20082,7253,3018,175,10446,Tuesday
2020-01-28,Hong Kong-Zhuhai-Macao Bridge,12420,1551,1534,15505,5417,1795,1625,8837,Tuesday
2020-01-28,Lok Ma Chau,10279,1831,329,12439,4780,2722,202,7704,Tuesday
2020-01-28,Man Kam To,1551,283,4,1838,582,269,3,854,Tuesday
2020-01-28,Sha Tau Kok,2173,245,66,2484,433,210,58,701,Tuesday
2020-01-28,Shenzhen Bay,26094,4217,738,31049,3797,5022,513,9332,Tuesday
2020-01-28,China Ferry Terminal,2761,314,222,3297,509,371,323,1203,Tuesday
2020-01-28,Harbour Control,17,0,34,51,1,0,12,13,Tuesday
2020-01-28,Kai Tak Cruise Terminal,705,56,8,769,427,75,6,508,Tuesday
2020-02-01,Hung Hom,0,0,0,0,0,0,0,0,Saturday
2020-02-01,Lo Wu,21578,1883,276,23737,13759,2347,234,16340,Saturday
2020-02-01,Lok Ma Chau Spur Line,12975,1505,165,14645,8541,1805,139,10485,Saturday
2020-02-01,Hong Kong-Zhuhai-Macao Bridge,4926,632,1021,6579,3259,784,1339,5382,Saturday
2020-02-01,Lok Ma Chau,6674,1134,236,8044,4940,1855,179,6974,Saturday
2020-02-01,Man Kam To,0,0,0,0,0,0,0,0,Saturday
2020-02-01,Sha Tau Kok,0,0,0,0,0,0,0,0,Saturday
2020-02-01,Shenzhen Bay,9788,2429,505,12722,3378,3425,499,7302,Saturday
2020-02-01,China Ferry Terminal,0,0,0,0,0,0,0,0,Saturday
2020-02-01,Harbour Control,0,0,60,60,0,0,5,5,Saturday
2020-02-01,Kai Tak Cruise Terminal,25,8,2334,2367,129,6,1965,2100,Saturday
2020-02-01,Macau Ferry Terminal,3180,88,596,3864,3043,105,550,3698,Saturday
2020-02-01,Tuen Mun Ferry Terminal,0,0,0,0,0,0,0,0,Saturday
2020-02-01,Total,115122,13382,9760,138264,65847,15399,12956,94202,Saturday
2020-01-24,Airport,20724,9124,14116,43964,74876,4451,7242,86569,Friday
2020-01-24,Hung Hom,433,470,71,974,3498,194,51,3743,Friday
2020-01-28,Total,188788,24156,10248,223192,81904,29546,16517,127967,Tuesday
2020-01-29,Airport,50292,9196,5871,65359,33880,7550,10514,51944,Wednesday
2020-01-29,Express Rail Link West Kowloon,20022,1817,403,22242,1195,3524,261,4980,Wednesday
2020-01-29,Hung Hom,2038,201,87,2326,222,462,79,763,Wednesday
2020-01-29,Lo Wu,44426,4343,485,49254,13519,5099,350,18968,Wednesday
2020-01-29,Lok Ma Chau Spur Line,19574,3003,323,22900,8304,3414,245,11963,Wednesday
2020-01-29,Hong Kong-Zhuhai-Macao Bridge,10793,1363,1168,13324,4213,1588,1479,7280,Wednesday
2020-01-29,Lok Ma Chau,11236,1900,385,13521,5371,3111,252,8734,Wednesday
2020-01-29,Man Kam To,1459,293,11,1763,629,308,10,947,Wednesday
2020-01-29,Sha Tau Kok,2739,320,61,3120,517,311,87,915,Wednesday
2020-01-29,Shenzhen Bay,26892,4695,996,32583,4398,6648,678,11724,Wednesday
2020-01-29,China Ferry Terminal,3138,320,271,3729,522,497,266,1285,Wednesday
2020-01-29,Harbour Control,0,0,41,41,0,0,0,0,Wednesday
2020-01-29,Kai Tak Cruise Terminal,427,75,10,512,372,49,21,442,Wednesday
2020-01-29,Macau Ferry Terminal,4223,250,869,5342,3211,223,877,4311,Wednesday
2020-01-29,Tuen Mun Ferry Terminal,313,4,17,334,293,1,24,318,Wednesday
2020-01-29,Total,197572,27780,10998,236350,76646,32785,15143,124574,Wednesday
2020-01-30,Airport,46214,9907,5530,61651,31072,7122,9882,48076,Thursday
2020-01-30,Express Rail Link West Kowloon,0,0,0,0,0,0,0,0,Thursday
2020-01-30,Hung Hom,0,0,0,0,0,0,0,0,Thursday
2020-01-30,Lo Wu,30427,2470,308,33205,13178,3893,294,17365,Thursday
2020-01-30,Lok Ma Chau Spur Line,15978,1711,205,17894,8048,2570,168,10786,Thursday
2020-01-30,Hong Kong-Zhuhai-Macao Bridge,7032,946,923,8901,3554,1360,1155,6069,Thursday
2020-01-30,Lok Ma Chau,9186,1430,312,10928,4706,3386,322,8414,Thursday
2020-01-30,Man Kam To,0,0,0,0,0,0,0,0,Thursday
2020-01-30,Sha Tau Kok,0,0,0,0,0,0,0,0,Thursday
2020-01-30,Shenzhen Bay,17109,2785,660,20554,3707,6196,660,10563,Thursday
2020-01-30,China Ferry Terminal,0,0,0,0,0,0,0,0,Thursday
2020-01-30,Harbour Control,1,0,69,70,0,0,22,22,Thursday
2020-01-30,Kai Tak Cruise Terminal,2921,134,161,3216,682,52,1761,2495,Thursday
2020-01-30,Macau Ferry Terminal,3638,172,694,4504,3132,249,806,4187,Thursday
2020-01-30,Tuen Mun Ferry Terminal,0,0,0,0,0,0,0,0,Thursday
2020-01-30,Total,132506,19555,8862,160923,68079,24828,15070,107977,Thursday
2020-01-31,Airport,49093,7817,5089,61999,28231,5737,7599,41567,Friday
2020-01-31,Express Rail Link West Kowloon,0,0,0,0,0,0,0,0,Friday
2020-01-31,Hung Hom,0,0,0,0,0,0,0,0,Friday
2020-01-31,Lo Wu,24064,1960,257,26281,13695,2845,267,16807,Friday
2020-01-31,Lok Ma Chau Spur Line,14044,1518,181,15743,8490,1939,163,10592,Friday
2020-01-31,Hong Kong-Zhuhai-Macao Bridge,5754,653,883,7290,3626,897,1078,5601,Friday
2020-01-31,Lok Ma Chau,7807,1200,225,9232,4879,2598,302,7779,Friday
2020-01-31,Man Kam To,0,0,0,0,0,0,0,0,Friday
2020-01-31,Sha Tau Kok,0,0,0,0,0,0,0,0,Friday
2020-01-31,Shenzhen Bay,11541,2412,567,14520,3727,4789,632,9148,Friday
2020-01-31,China Ferry Terminal,0,0,0,0,0,0,0,0,Friday
2020-01-31,Harbour Control,2,0,330,332,2,0,9,11,Friday
2020-01-31,Kai Tak Cruise Terminal,828,377,91,1296,1603,65,242,1910,Friday
2020-01-31,Macau Ferry Terminal,3411,121,634,4166,3253,124,660,4037,Friday
2020-01-31,Tuen Mun Ferry Terminal,0,0,0,0,0,0,0,0,Friday
2020-01-31,Total,116544,16058,8257,140859,67506,18994,10952,97452,Friday
2020-02-01,Airport,55976,5703,4567,66246,28798,5072,8046,41916,Saturday
2020-02-01,Express Rail Link West Kowloon,0,0,0,0,0,0,0,0,Saturday
2020-02-02,Airport,59083,4649,3762,67494,25570,4360,6898,36828,Sunday
2020-01-28,Macau Ferry Terminal,5745,238,912,6895,3634,288,864,4786,Tuesday
2020-01-28,Tuen Mun Ferry Terminal,472,4,18,494,306,1,27,334,Tuesday
2020-02-02,Express Rail Link West Kowloon,0,0,0,0,0,0,0,0,Sunday
2020-02-02,Hung Hom,0,0,0,0,0,0,0,0,Sunday
2020-02-02,Lo Wu,13138,1159,190,14487,6575,1392,151,8118,Sunday
2020-02-02,Lok Ma Chau Spur Line,17716,1739,177,19632,9832,2902,209,12943,Sunday
2020-02-02,Hong Kong-Zhuhai-Macao Bridge,5108,487,804,6399,3165,649,1270,5084,Sunday
2020-02-02,Lok Ma Chau,10954,1272,254,12480,4362,1820,234,6416,Sunday
2020-02-02,Man Kam To,0,0,0,0,0,0,0,0,Sunday
2020-02-02,Sha Tau Kok,0,0,0,0,0,0,0,0,Sunday
2020-02-02,Shenzhen Bay,11706,2253,606,14565,2968,3130,454,6552,Sunday
2020-02-02,China Ferry Terminal,0,0,0,0,0,0,0,0,Sunday
2020-02-02,Harbour Control,0,0,184,184,0,0,0,0,Sunday
2020-02-02,Kai Tak Cruise Terminal,1637,58,53,1748,2172,22,241,2435,Sunday
2020-02-02,Macau Ferry Terminal,3057,98,369,3524,2697,110,486,3293,Sunday
2020-02-02,Tuen Mun Ferry Terminal,0,0,0,0,0,0,0,0,Sunday
2020-02-02,Total,122399,11715,6399,140513,57341,14385,9943,81669,Sunday
2020-02-03,Airport,41208,6996,3846,52050,21704,3596,5428,30728,Monday
2020-02-03,Express Rail Link West Kowloon,0,0,0,0,0,0,0,0,Monday
2020-02-03,Hung Hom,0,0,0,0,0,0,0,0,Monday
2020-02-03,Lo Wu,27196,1873,368,29437,14938,3078,320,18336,Monday
2020-02-03,Lok Ma Chau Spur Line,17037,1038,242,18317,10113,1815,205,12133,Monday
2020-02-03,Hong Kong-Zhuhai-Macao Bridge,3595,358,674,4627,3023,723,849,4595,Monday
2020-02-03,Lok Ma Chau,9823,1206,281,11310,5461,2150,190,7801,Monday
2020-02-03,Man Kam To,0,0,0,0,0,0,0,0,Monday
2020-02-03,Sha Tau Kok,0,0,0,0,0,0,0,0,Monday
2020-02-03,Shenzhen Bay,8284,1871,504,10659,3960,3754,486,8200,Monday
2020-02-03,China Ferry Terminal,0,0,0,0,0,0,0,0,Monday
2020-02-03,Harbour Control,0,0,25,25,0,0,29,29,Monday
2020-02-03,Kai Tak Cruise Terminal,330,22,6,358,203,21,4,228,Monday
2020-02-03,Macau Ferry Terminal,3560,97,564,4221,3333,109,589,4031,Monday
2020-02-03,Total,111033,13461,6510,131004,62735,15246,8100,86081,Monday
2020-02-04,Airport,31173,6317,3647,41137,20187,3550,4471,28208,Tuesday
2020-02-04,Express Rail Link West Kowloon,0,0,0,0,0,0,0,0,Tuesday
2020-01-25,China Ferry Terminal,1183,463,499,2145,2233,406,415,3054,Saturday
2020-02-04,Hong Kong-Zhuhai-Macao Bridge,4555,402,1020,5977,3177,985,1020,5182,Tuesday
2020-02-04,Lok Ma Chau,0,0,0,0,0,0,0,0,Tuesday
2020-02-04,Man Kam To,0,0,0,0,0,0,0,0,Tuesday
2020-02-04,Sha Tau Kok,0,0,0,0,0,0,0,0,Tuesday
2020-02-04,Shenzhen Bay,18852,2771,786,22409,10838,6731,809,18378,Tuesday
2020-02-04,China Ferry Terminal,0,0,0,0,0,0,0,0,Tuesday
2020-02-04,Harbour Control,33,0,30,63,30,0,33,63,Tuesday
2020-02-04,Kai Tak Cruise Terminal,203,21,2,226,173,10,2,185,Tuesday
2020-02-04,Macau Ferry Terminal,0,0,0,0,0,0,0,0,Tuesday
2020-02-04,Tuen Mun Ferry Terminal,0,0,0,0,0,0,0,0,Tuesday
2020-02-04,Total,54816,9511,5485,69812,34405,11276,6335,52016,Tuesday
2020-02-05,Airport,24832,6041,3592,34465,22297,2591,4404,29292,Wednesday
2020-02-05,Express Rail Link West Kowloon,0,0,0,0,0,0,0,0,Wednesday
2020-02-05,Hung Hom,0,0,0,0,0,0,0,0,Wednesday
2020-02-05,Lo Wu,0,0,0,0,0,0,0,0,Wednesday
2020-02-05,Lok Ma Chau Spur Line,0,0,0,0,0,0,0,0,Wednesday
2020-02-05,Hong Kong-Zhuhai-Macao Bridge,3172,329,1121,4622,2025,925,885,3835,Wednesday
2020-02-05,Lok Ma Chau,0,0,0,0,0,0,0,0,Wednesday
2020-02-05,Man Kam To,0,0,0,0,0,0,0,0,Wednesday
2020-02-05,Sha Tau Kok,0,0,0,0,0,0,0,0,Wednesday
2020-02-05,Shenzhen Bay,16387,2378,714,19479,11893,6359,837,19089,Wednesday
2020-02-05,China Ferry Terminal,0,0,0,0,0,0,0,0,Wednesday
2020-02-05,Harbour Control,0,0,0,0,0,0,0,0,Wednesday
2020-02-05,Macau Ferry Terminal,0,0,0,0,0,0,0,0,Wednesday
2020-02-05,Tuen Mun Ferry Terminal,0,0,0,0,0,0,0,0,Wednesday
2020-02-05,Total,44566,8760,5458,58784,36217,9877,6126,52220,Wednesday
2020-02-06,Airport,21261,5728,3478,30467,22252,2512,4222,28986,Thursday
2020-02-06,Express Rail Link West Kowloon,0,0,0,0,0,0,0,0,Thursday
2020-02-06,Hung Hom,0,0,0,0,0,0,0,0,Thursday
2020-02-06,Lo Wu,0,0,0,0,0,0,0,0,Thursday
2020-02-06,Lok Ma Chau Spur Line,0,0,0,0,0,0,0,0,Thursday
2020-02-06,Hong Kong-Zhuhai-Macao Bridge,4941,468,1188,6597,2608,1068,834,4510,Thursday
2020-02-06,Lok Ma Chau,0,0,0,0,0,0,0,0,Thursday
2020-02-06,Man Kam To,0,0,0,0,0,0,0,0,Thursday
2020-02-06,Sha Tau Kok,0,0,0,0,0,0,0,0,Thursday
2020-02-06,Shenzhen Bay,38920,4813,1220,44953,21360,7071,1197,29628,Thursday
2020-02-06,China Ferry Terminal,0,0,0,0,0,0,0,0,Thursday
2020-02-06,Harbour Control,0,0,0,0,0,0,0,0,Thursday
2020-02-06,Kai Tak Cruise Terminal,0,0,0,0,0,0,0,0,Thursday
2020-02-06,Macau Ferry Terminal,0,0,0,0,0,0,0,0,Thursday
2020-02-06,Tuen Mun Ferry Terminal,0,0,0,0,0,0,0,0,Thursday
2020-02-06,Total,65122,11009,5886,82017,46220,10651,6253,63124,Thursday
2020-02-07,Airport,19694,5563,3556,28813,21417,2735,4012,28164,Friday
2020-02-07,Express Rail Link West Kowloon,0,0,0,0,0,0,0,0,Friday
2020-02-07,Hung Hom,0,0,0,0,0,0,0,0,Friday
2020-02-07,Lo Wu,0,0,0,0,0,0,0,0,Friday
2020-02-07,Lok Ma Chau Spur Line,0,0,0,0,0,0,0,0,Friday
2020-02-07,Lok Ma Chau,0,0,0,0,0,0,0,0,Friday
2020-02-07,Man Kam To,0,0,0,0,0,0,0,0,Friday
2020-02-07,Sha Tau Kok,0,0,0,0,0,0,0,0,Friday
2020-02-07,Shenzhen Bay,50506,6555,1441,58502,16746,7282,1320,25348,Friday
2020-02-07,China Ferry Terminal,0,0,0,0,0,0,0,0,Friday
2020-02-07,Harbour Control,0,0,0,0,0,0,0,0,Friday
2020-02-07,Kai Tak Cruise Terminal,0,0,0,0,0,0,0,0,Friday
2020-02-07,Macau Ferry Terminal,0,0,0,0,0,0,0,0,Friday
2020-02-07,Tuen Mun Ferry Terminal,0,0,0,0,0,0,0,0,Friday
2020-02-07,Total,76899,12746,6337,95982,40739,11119,6130,57988,Friday
2020-02-08,Airport,17956,943,3070,21969,20163,1127,3253,24543,Saturday
2020-02-08,Express Rail Link West Kowloon,0,0,0,0,0,0,0,0,Saturday
2020-02-08,Hung Hom,0,0,0,0,0,0,0,0,Saturday
2020-02-08,Lo Wu,0,0,0,0,0,0,0,0,Saturday
2020-02-08,Lok Ma Chau Spur Line,0,0,0,0,0,0,0,0,Saturday
2020-02-08,Hong Kong-Zhuhai-Macao Bridge,659,9,508,1176,750,163,442,1355,Saturday
2020-02-08,Lok Ma Chau,0,0,0,0,0,0,0,0,Saturday
2020-02-08,Man Kam To,0,0,0,0,0,0,0,0,Saturday
2020-02-08,Sha Tau Kok,0,0,0,0,0,0,0,0,Saturday
2020-02-08,Shenzhen Bay,208,43,3,254,1291,1351,549,3191,Saturday
2020-02-08,China Ferry Terminal,0,0,0,0,0,0,0,0,Saturday
2020-02-08,Harbour Control,0,0,0,0,0,0,0,0,Saturday
2020-02-08,Kai Tak Cruise Terminal,0,0,0,0,0,0,0,0,Saturday
2020-02-08,Macau Ferry Terminal,0,0,0,0,0,0,0,0,Saturday
2020-02-08,Tuen Mun Ferry Terminal,0,0,0,0,0,0,0,0,Saturday
2020-02-08,Total,18823,995,3581,23399,22204,2641,4244,29089,Saturday
2020-02-09,Airport,22077,913,2591,25581,17782,971,3200,21953,Sunday
2020-02-09,Hung Hom,0,0,0,0,0,0,0,0,Sunday
2020-02-09,Lo Wu,0,0,0,0,0,0,0,0,Sunday
2020-02-09,Lok Ma Chau Spur Line,0,0,0,0,0,0,0,0,Sunday
2020-02-09,Hong Kong-Zhuhai-Macao Bridge,710,7,493,1210,1185,167,524,1876,Sunday
2020-02-09,Lok Ma Chau,0,0,0,0,0,0,0,0,Sunday
2020-02-09,Man Kam To,0,0,0,0,0,0,0,0,Sunday
2020-02-09,Sha Tau Kok,0,0,0,0,0,0,0,0,Sunday
2020-02-09,Shenzhen Bay,314,36,3,353,1802,1303,573,3678,Sunday
2020-02-09,China Ferry Terminal,0,0,0,0,0,0,0,0,Sunday
2020-02-09,Harbour Control,0,0,0,0,0,0,0,0,Sunday
2020-02-09,Kai Tak Cruise Terminal,1838,0,33,1871,0,0,0,0,Sunday
2020-02-09,Macau Ferry Terminal,0,0,0,0,0,0,0,0,Sunday
2020-03-09,Total,15574,955,2438,18967,13142,1046,2491,16679,Monday
2020-02-04,Lo Wu,0,0,0,0,0,0,0,0,Tuesday
2020-02-10,Airport,17139,766,2037,19942,15550,535,3219,19304,Monday
2020-02-10,Hung Hom,0,0,0,0,0,0,0,0,Monday
2020-02-10,Lo Wu,0,0,0,0,0,0,0,0,Monday
2020-02-10,Lok Ma Chau Spur Line,0,0,0,0,0,0,0,0,Monday
2020-02-10,Hong Kong-Zhuhai-Macao Bridge,808,10,496,1314,1508,137,444,2089,Monday
2020-02-10,Lok Ma Chau,0,0,0,0,0,0,0,0,Monday
2020-02-10,Man Kam To,0,0,0,0,0,0,0,0,Monday
2020-02-10,Sha Tau Kok,0,0,0,0,0,0,0,0,Monday
2020-02-10,Shenzhen Bay,461,56,4,521,1835,1016,185,3036,Monday
2020-02-10,China Ferry Terminal,0,0,0,0,0,0,0,0,Monday
2020-02-10,Harbour Control,0,0,0,0,0,0,0,0,Monday
2020-02-10,Kai Tak Cruise Terminal,0,0,0,0,0,0,0,0,Monday
2020-02-10,Macau Ferry Terminal,0,0,0,0,0,0,0,0,Monday
2020-02-10,Tuen Mun Ferry Terminal,0,0,0,0,0,0,0,0,Monday
2020-02-10,Total,18408,832,2537,21777,18893,1688,3848,24429,Monday
2020-02-11,Airport,14663,647,2107,17417,12645,481,2556,15682,Tuesday
2020-02-11,Express Rail Link West Kowloon,0,0,0,0,0,0,0,0,Tuesday
2020-02-11,Hung Hom,0,0,0,0,0,0,0,0,Tuesday
2020-02-11,Lo Wu,0,0,0,0,0,0,0,0,Tuesday
2020-02-11,Lok Ma Chau Spur Line,0,0,0,0,0,0,0,0,Tuesday
2020-02-11,Hong Kong-Zhuhai-Macao Bridge,729,11,458,1198,960,103,452,1515,Tuesday
2020-02-11,Lok Ma Chau,0,0,0,0,0,0,0,0,Tuesday
2020-02-11,Man Kam To,0,0,0,0,0,0,0,0,Tuesday
2020-02-11,Sha Tau Kok,0,0,0,0,0,0,0,0,Tuesday
2020-02-11,Shenzhen Bay,561,80,4,645,1105,739,140,1984,Tuesday
2020-02-11,China Ferry Terminal,0,0,0,0,0,0,0,0,Tuesday
2020-02-11,Harbour Control,0,0,0,0,0,0,0,0,Tuesday
2020-02-11,Kai Tak Cruise Terminal,0,0,0,0,0,0,0,0,Tuesday
2020-02-11,Macau Ferry Terminal,0,0,0,0,0,0,0,0,Tuesday
2020-02-11,Tuen Mun Ferry Terminal,0,0,0,0,0,0,0,0,Tuesday
2020-02-11,Total,15953,738,2569,19260,14710,1323,3148,19181,Tuesday
2020-02-12,Airport,14221,619,1725,16565,13637,471,2358,16466,Wednesday
2020-02-12,Hung Hom,0,0,0,0,0,0,0,0,Wednesday
2020-02-12,Lo Wu,0,0,0,0,0,0,0,0,Wednesday
2020-02-12,Lok Ma Chau Spur Line,0,0,0,0,0,0,0,0,Wednesday
2020-02-12,Hong Kong-Zhuhai-Macao Bridge,862,4,449,1315,904,109,350,1363,Wednesday
2020-02-12,Lok Ma Chau,0,0,0,0,0,0,0,0,Wednesday
2020-02-12,Man Kam To,0,0,0,0,0,0,0,0,Wednesday
2020-02-12,Sha Tau Kok,0,0,0,0,0,0,0,0,Wednesday
2020-02-12,Shenzhen Bay,709,106,2,817,1219,862,114,2195,Wednesday
2020-02-12,China Ferry Terminal,0,0,0,0,0,0,0,0,Wednesday
2020-02-12,Harbour Control,0,0,0,0,0,0,0,0,Wednesday
2020-02-12,Kai Tak Cruise Terminal,0,0,0,0,0,0,0,0,Wednesday
2020-02-12,Macau Ferry Terminal,0,0,0,0,0,0,0,0,Wednesday
2020-02-12,Tuen Mun Ferry Terminal,0,0,0,0,0,0,0,0,Wednesday
2020-02-12,Total,15792,729,2176,18697,15760,1442,2822,20024,Wednesday
2020-02-13,Airport,11620,638,1938,14196,15259,453,2150,17862,Thursday
2020-02-13,Express Rail Link West Kowloon,0,0,0,0,0,0,0,0,Thursday
2020-02-13,Hung Hom,0,0,0,0,0,0,0,0,Thursday
2020-02-13,Lo Wu,0,0,0,0,0,0,0,0,Thursday
2020-02-13,Lok Ma Chau Spur Line,0,0,0,0,0,0,0,0,Thursday
2020-02-13,Hong Kong-Zhuhai-Macao Bridge,936,8,503,1447,1089,124,450,1663,Thursday
2020-02-13,Lok Ma Chau,0,0,0,0,0,0,0,0,Thursday
2020-02-13,Man Kam To,0,0,0,0,0,0,0,0,Thursday
2020-02-13,Sha Tau Kok,0,0,0,0,0,0,0,0,Thursday
2020-02-13,Shenzhen Bay,756,105,17,878,1056,856,104,2016,Thursday
2020-02-13,China Ferry Terminal,0,0,0,0,0,0,0,0,Thursday
2020-02-13,Harbour Control,0,0,0,0,0,0,0,0,Thursday
2020-02-13,Kai Tak Cruise Terminal,0,0,0,0,0,0,0,0,Thursday
2020-02-13,Macau Ferry Terminal,0,0,0,0,0,0,0,0,Thursday
2020-02-13,Total,13312,751,2458,16521,17404,1433,2704,21541,Thursday
2020-02-14,Airport,11246,584,2015,13845,15770,477,2012,18259,Friday
2020-02-14,Express Rail Link West Kowloon,0,0,0,0,0,0,0,0,Friday
2020-02-14,Hung Hom,0,0,0,0,0,0,0,0,Friday
2020-02-14,Lo Wu,0,0,0,0,0,0,0,0,Friday
2020-02-14,Lok Ma Chau Spur Line,0,0,0,0,0,0,0,0,Friday
2020-02-14,Hong Kong-Zhuhai-Macao Bridge,1491,5,553,2049,1298,110,447,1855,Friday
2020-02-14,Lok Ma Chau,0,0,0,0,0,0,0,0,Friday
2020-02-14,Man Kam To,0,0,0,0,0,0,0,0,Friday
2020-02-14,Sha Tau Kok,0,0,0,0,0,0,0,0,Friday
2020-02-14,Shenzhen Bay,770,94,6,870,1092,1016,117,2225,Friday
2020-02-14,China Ferry Terminal,0,0,0,0,0,0,0,0,Friday
2020-02-14,Harbour Control,0,0,0,0,0,0,0,0,Friday
2020-02-14,Kai Tak Cruise Terminal,0,0,0,0,0,0,0,0,Friday
2020-02-14,Macau Ferry Terminal,0,0,0,0,0,0,0,0,Friday
2020-02-14,Tuen Mun Ferry Terminal,0,0,0,0,0,0,0,0,Friday
2020-02-14,Total,13507,683,2574,16764,18160,1603,2576,22339,Friday
2020-02-15,Airport,14097,692,2098,16887,14575,390,2064,17029,Saturday
2020-02-15,Express Rail Link West Kowloon,0,0,0,0,0,0,0,0,Saturday
2020-02-15,Hung Hom,0,0,0,0,0,0,0,0,Saturday
2020-02-15,Lo Wu,0,0,0,0,0,0,0,0,Saturday
2020-02-15,Lok Ma Chau Spur Line,0,0,0,0,0,0,0,0,Saturday
2020-02-15,Lok Ma Chau,0,0,0,0,0,0,0,0,Saturday
2020-02-15,Man Kam To,0,0,0,0,0,0,0,0,Saturday
2020-02-15,Sha Tau Kok,0,0,0,0,0,0,0,0,Saturday
2020-02-15,Shenzhen Bay,809,94,7,910,945,621,150,1716,Saturday
2020-02-15,China Ferry Terminal,0,0,0,0,0,0,0,0,Saturday
2020-02-09,Total,24939,956,3120,29015,20769,2441,4297,27507,Sunday
2020-02-15,Tuen Mun Ferry Terminal,0,0,0,0,0,0,0,0,Saturday
2020-02-15,Total,16089,791,2629,19509,16580,1130,2700,20410,Saturday
2020-02-16,Airport,18422,650,1848,20920,12257,349,2524,15130,Sunday
2020-02-16,Express Rail Link West Kowloon,0,0,0,0,0,0,0,0,Sunday
2020-02-16,Hung Hom,0,0,0,0,0,0,0,0,Sunday
2020-02-16,Lo Wu,0,0,0,0,0,0,0,0,Sunday
2020-02-16,Lok Ma Chau Spur Line,0,0,0,0,0,0,0,0,Sunday
2020-02-16,Hong Kong-Zhuhai-Macao Bridge,1106,2,465,1573,1473,76,646,2195,Sunday
2020-02-16,Lok Ma Chau,0,0,0,0,0,0,0,0,Sunday
2020-02-16,Man Kam To,0,0,0,0,0,0,0,0,Sunday
2020-02-16,Sha Tau Kok,0,0,0,0,0,0,0,0,Sunday
2020-02-16,Shenzhen Bay,797,97,6,900,1166,764,203,2133,Sunday
2020-02-16,China Ferry Terminal,0,0,0,0,0,0,0,0,Sunday
2020-02-16,Harbour Control,0,0,0,0,0,0,0,0,Sunday
2020-02-16,Kai Tak Cruise Terminal,0,0,0,0,0,0,0,0,Sunday
2020-02-16,Macau Ferry Terminal,0,0,0,0,0,0,0,0,Sunday
2020-02-16,Tuen Mun Ferry Terminal,0,0,0,0,0,0,0,0,Sunday
2020-02-16,Total,20325,749,2319,23393,14896,1189,3373,19458,Sunday
2020-02-17,Airport,13748,532,1876,16156,10210,212,2018,12440,Monday
2020-02-17,Hung Hom,0,0,0,0,0,0,0,0,Monday
2020-02-17,Lo Wu,0,0,0,0,0,0,0,0,Monday
2020-02-17,Lok Ma Chau Spur Line,0,0,0,0,0,0,0,0,Monday
2020-02-17,Hong Kong-Zhuhai-Macao Bridge,1264,3,488,1755,2000,87,625,2712,Monday
2020-02-17,Lok Ma Chau,0,0,0,0,0,0,0,0,Monday
2020-02-17,Man Kam To,0,0,0,0,0,0,0,0,Monday
2020-02-17,Sha Tau Kok,0,0,0,0,0,0,0,0,Monday
2020-02-17,Shenzhen Bay,978,108,4,1090,1724,600,173,2497,Monday
2020-02-17,China Ferry Terminal,0,0,0,0,0,0,0,0,Monday
2020-02-17,Harbour Control,0,0,0,0,0,0,0,0,Monday
2020-02-17,Kai Tak Cruise Terminal,0,0,0,0,0,0,0,0,Monday
2020-02-17,Macau Ferry Terminal,0,0,0,0,0,0,0,0,Monday
2020-02-17,Tuen Mun Ferry Terminal,0,0,0,0,0,0,0,0,Monday
2020-02-17,Total,15990,643,2368,19001,13934,899,2816,17649,Monday
2020-02-18,Airport,12068,479,1862,14409,8900,266,1722,10888,Tuesday
2020-02-18,Express Rail Link West Kowloon,0,0,0,0,0,0,0,0,Tuesday
2020-02-18,Hung Hom,0,0,0,0,0,0,0,0,Tuesday
2020-02-18,Lo Wu,0,0,0,0,0,0,0,0,Tuesday
2020-02-18,Lok Ma Chau Spur Line,0,0,0,0,0,0,0,0,Tuesday
2020-02-18,Hong Kong-Zhuhai-Macao Bridge,1361,5,579,1945,1955,74,730,2759,Tuesday
2020-02-18,Lok Ma Chau,0,0,0,0,0,0,0,0,Tuesday
2020-02-18,Man Kam To,0,0,0,0,0,0,0,0,Tuesday
2020-02-18,Sha Tau Kok,0,0,0,0,0,0,0,0,Tuesday
2020-02-18,Shenzhen Bay,954,95,10,1059,1160,519,155,1834,Tuesday
2020-02-18,China Ferry Terminal,0,0,0,0,0,0,0,0,Tuesday
2020-02-18,Harbour Control,0,0,0,0,0,0,0,0,Tuesday
2020-02-18,Kai Tak Cruise Terminal,0,0,0,0,0,0,0,0,Tuesday
2020-02-18,Macau Ferry Terminal,0,0,0,0,0,0,0,0,Tuesday
2020-02-18,Tuen Mun Ferry Terminal,0,0,0,0,0,0,0,0,Tuesday
2020-02-18,Total,14383,579,2451,17413,12015,859,2607,15481,Tuesday
2020-02-19,Airport,10612,462,1789,12863,10048,214,1582,11844,Wednesday
2020-02-19,Hung Hom,0,0,0,0,0,0,0,0,Wednesday
2020-02-19,Lo Wu,0,0,0,0,0,0,0,0,Wednesday
2020-02-19,Lok Ma Chau Spur Line,0,0,0,0,0,0,0,0,Wednesday
2020-02-19,Hong Kong-Zhuhai-Macao Bridge,1280,8,496,1784,1776,64,609,2449,Wednesday
2020-02-19,Lok Ma Chau,0,0,0,0,0,0,0,0,Wednesday
2020-02-19,Man Kam To,0,0,0,0,0,0,0,0,Wednesday
2020-02-19,Sha Tau Kok,0,0,0,0,0,0,0,0,Wednesday
2020-02-19,Shenzhen Bay,909,97,5,1011,1145,508,113,1766,Wednesday
2020-02-19,China Ferry Terminal,0,0,0,0,0,0,0,0,Wednesday
2020-02-19,Harbour Control,0,0,0,0,0,0,0,0,Wednesday
2020-02-19,Kai Tak Cruise Terminal,0,0,0,0,0,0,0,0,Wednesday
2020-02-19,Macau Ferry Terminal,0,0,0,0,0,0,0,0,Wednesday
2020-02-19,Tuen Mun Ferry Terminal,0,0,0,0,0,0,0,0,Wednesday
2020-02-19,Total,12801,567,2290,15658,12969,786,2304,16059,Wednesday
2020-02-20,Airport,10398,525,1730,12653,11622,280,1944,13846,Thursday
2020-02-20,Express Rail Link West Kowloon,0,0,0,0,0,0,0,0,Thursday
2020-02-20,Hung Hom,0,0,0,0,0,0,0,0,Thursday
2020-02-20,Lo Wu,0,0,0,0,0,0,0,0,Thursday
2020-02-20,Lok Ma Chau Spur Line,0,0,0,0,0,0,0,0,Thursday
2020-02-20,Hong Kong-Zhuhai-Macao Bridge,2299,13,585,2897,3135,96,551,3782,Thursday
2020-02-20,Lok Ma Chau,0,0,0,0,0,0,0,0,Thursday
2020-02-20,Man Kam To,0,0,0,0,0,0,0,0,Thursday
2020-02-20,Sha Tau Kok,0,0,0,0,0,0,0,0,Thursday
2020-02-20,Shenzhen Bay,980,110,9,1099,1167,564,111,1842,Thursday
2020-02-20,China Ferry Terminal,0,0,0,0,0,0,0,0,Thursday
2020-02-20,Harbour Control,0,0,0,0,0,0,0,0,Thursday
2020-02-20,Macau Ferry Terminal,0,0,0,0,0,0,0,0,Thursday
2020-02-20,Tuen Mun Ferry Terminal,0,0,0,0,0,0,0,0,Thursday
2020-02-20,Total,13677,648,2324,16649,15924,940,2606,19470,Thursday
2020-02-21,Airport,9821,539,2007,12367,12942,356,1749,15047,Friday
2020-02-21,Express Rail Link West Kowloon,0,0,0,0,0,0,0,0,Friday
2020-02-21,Hung Hom,0,0,0,0,0,0,0,0,Friday
2020-02-21,Lo Wu,0,0,0,0,0,0,0,0,Friday
2020-02-21,Lok Ma Chau Spur Line,0,0,0,0,0,0,0,0,Friday
2020-02-21,Hong Kong-Zhuhai-Macao Bridge,3647,28,685,4360,3362,95,549,4006,Friday
2020-02-21,Lok Ma Chau,0,0,0,0,0,0,0,0,Friday
2020-02-21,Man Kam To,0,0,0,0,0,0,0,0,Friday
2020-02-15,Macau Ferry Terminal,0,0,0,0,0,0,0,0,Saturday
2020-02-21,China Ferry Terminal,0,0,0,0,0,0,0,0,Friday
2020-02-21,Harbour Control,0,0,0,0,0,0,0,0,Friday
2020-02-21,Macau Ferry Terminal,0,0,0,0,0,0,0,0,Friday
2020-02-21,Tuen Mun Ferry Terminal,0,0,0,0,0,0,0,0,Friday
2020-02-21,Total,14557,682,2696,17935,17499,985,2413,20897,Friday
2020-02-22,Airport,11096,530,2030,13656,10534,247,1888,12669,Saturday
2020-02-21,Shenzhen Bay,1089,115,4,1208,1195,534,115,1844,Friday
2020-02-22,Express Rail Link West Kowloon,0,0,0,0,0,0,0,0,Saturday
2020-02-22,Hung Hom,0,0,0,0,0,0,0,0,Saturday
2020-02-22,Lo Wu,0,0,0,0,0,0,0,0,Saturday
2020-02-22,Lok Ma Chau Spur Line,0,0,0,0,0,0,0,0,Saturday
2020-02-22,Hong Kong-Zhuhai-Macao Bridge,3364,14,648,4026,3511,83,641,4235,Saturday
2020-02-22,Lok Ma Chau,0,0,0,0,0,0,0,0,Saturday
2020-02-22,Man Kam To,0,0,0,0,0,0,0,0,Saturday
2020-02-22,Sha Tau Kok,0,0,0,0,0,0,0,0,Saturday
2020-02-22,Shenzhen Bay,980,107,2,1089,1115,487,124,1726,Saturday
2020-02-22,China Ferry Terminal,0,0,0,0,0,0,0,0,Saturday
2020-02-22,Harbour Control,0,0,0,0,0,0,0,0,Saturday
2020-02-22,Kai Tak Cruise Terminal,0,0,0,0,0,0,0,0,Saturday
2020-02-22,Macau Ferry Terminal,0,0,0,0,0,0,0,0,Saturday
2020-02-22,Tuen Mun Ferry Terminal,0,0,0,0,0,0,0,0,Saturday
2020-02-22,Total,15440,651,2680,18771,15160,817,2653,18630,Saturday
2020-02-23,Airport,15891,537,2009,18437,9225,296,2141,11662,Sunday
2020-02-23,Hung Hom,0,0,0,0,0,0,0,0,Sunday
2020-02-23,Lo Wu,0,0,0,0,0,0,0,0,Sunday
2020-02-23,Lok Ma Chau Spur Line,0,0,0,0,0,0,0,0,Sunday
2020-02-23,Hong Kong-Zhuhai-Macao Bridge,3203,10,633,3846,3342,86,775,4203,Sunday
2020-02-23,Lok Ma Chau,0,0,0,0,0,0,0,0,Sunday
2020-02-23,Man Kam To,0,0,0,0,0,0,0,0,Sunday
2020-02-23,Sha Tau Kok,0,0,0,0,0,0,0,0,Sunday
2020-02-23,Shenzhen Bay,1147,126,9,1282,1338,579,273,2190,Sunday
2020-02-23,China Ferry Terminal,0,0,0,0,0,0,0,0,Sunday
2020-02-23,Harbour Control,0,0,0,0,0,0,0,0,Sunday
2020-02-23,Kai Tak Cruise Terminal,0,0,0,0,0,0,0,0,Sunday
2020-02-23,Macau Ferry Terminal,0,0,0,0,0,0,0,0,Sunday
2020-02-23,Tuen Mun Ferry Terminal,0,0,0,0,0,0,0,0,Sunday
2020-02-23,Total,20241,673,2651,23565,13905,961,3189,18055,Sunday
2020-02-24,Airport,12267,451,1792,14510,8041,231,1919,10191,Monday
2020-02-24,Express Rail Link West Kowloon,0,0,0,0,0,0,0,0,Monday
2020-02-24,Hung Hom,0,0,0,0,0,0,0,0,Monday
2020-02-24,Lo Wu,0,0,0,0,0,0,0,0,Monday
2020-02-24,Lok Ma Chau Spur Line,0,0,0,0,0,0,0,0,Monday
2020-02-24,Hong Kong-Zhuhai-Macao Bridge,3352,7,611,3970,4211,74,682,4967,Monday
2020-02-24,Lok Ma Chau,0,0,0,0,0,0,0,0,Monday
2020-02-24,Man Kam To,0,0,0,0,0,0,0,0,Monday
2020-02-24,Sha Tau Kok,0,0,0,0,0,0,0,0,Monday
2020-02-24,Shenzhen Bay,1353,130,7,1490,1964,482,181,2627,Monday
2020-02-24,China Ferry Terminal,0,0,0,0,0,0,0,0,Monday
2020-02-24,Harbour Control,0,0,0,0,0,0,0,0,Monday
2020-02-24,Kai Tak Cruise Terminal,0,0,0,0,0,0,0,0,Monday
2020-02-24,Macau Ferry Terminal,0,0,0,0,0,0,0,0,Monday
2020-02-24,Tuen Mun Ferry Terminal,0,0,0,0,0,0,0,0,Monday
2020-02-24,Total,16972,588,2410,19970,14216,787,2782,17785,Monday
2020-02-25,Airport,10734,414,1471,12619,7458,181,1574,9213,Tuesday
2020-02-25,Hung Hom,0,0,0,0,0,0,0,0,Tuesday
2020-02-25,Lo Wu,0,0,0,0,0,0,0,0,Tuesday
2020-02-25,Lok Ma Chau Spur Line,0,0,0,0,0,0,0,0,Tuesday
2020-02-25,Hong Kong-Zhuhai-Macao Bridge,3145,13,591,3749,3281,88,593,3962,Tuesday
2020-02-25,Lok Ma Chau,0,0,0,0,0,0,0,0,Tuesday
2020-02-25,Man Kam To,0,0,0,0,0,0,0,0,Tuesday
2020-02-25,Sha Tau Kok,0,0,0,0,0,0,0,0,Tuesday
2020-02-25,Shenzhen Bay,1328,131,5,1464,1510,503,141,2154,Tuesday
2020-02-25,China Ferry Terminal,0,0,0,0,0,0,0,0,Tuesday
2020-02-25,Harbour Control,0,0,0,0,0,0,0,0,Tuesday
2020-02-25,Kai Tak Cruise Terminal,0,0,0,0,0,0,0,0,Tuesday
2020-02-25,Macau Ferry Terminal,0,0,0,0,0,0,0,0,Tuesday
2020-02-25,Tuen Mun Ferry Terminal,0,0,0,0,0,0,0,0,Tuesday
2020-02-25,Total,15207,558,2067,17832,12249,772,2308,15329,Tuesday
2020-02-26,Airport,9882,410,1484,11776,7629,212,1521,9362,Wednesday
2020-02-26,Express Rail Link West Kowloon,0,0,0,0,0,0,0,0,Wednesday
2020-02-26,Hung Hom,0,0,0,0,0,0,0,0,Wednesday
2020-02-26,Lo Wu,0,0,0,0,0,0,0,0,Wednesday
2020-02-26,Lok Ma Chau Spur Line,0,0,0,0,0,0,0,0,Wednesday
2020-02-26,Hong Kong-Zhuhai-Macao Bridge,3233,11,662,3906,3424,78,580,4082,Wednesday
2020-02-26,Lok Ma Chau,0,0,0,0,0,0,0,0,Wednesday
2020-02-26,Man Kam To,0,0,0,0,0,0,0,0,Wednesday
2020-02-26,Sha Tau Kok,0,0,0,0,0,0,0,0,Wednesday
2020-02-26,Shenzhen Bay,1202,166,11,1379,1695,548,179,2422,Wednesday
2020-02-26,China Ferry Terminal,0,0,0,0,0,0,0,0,Wednesday
2020-02-26,Harbour Control,0,0,0,0,0,0,0,0,Wednesday
2020-02-26,Macau Ferry Terminal,0,0,0,0,0,0,0,0,Wednesday
2020-02-26,Tuen Mun Ferry Terminal,0,0,0,0,0,0,0,0,Wednesday
2020-02-26,Total,14317,587,2157,17061,12748,838,2280,15866,Wednesday
2020-02-27,Airport,9177,512,1780,11469,9051,168,1501,10720,Thursday
2020-02-27,Express Rail Link West Kowloon,0,0,0,0,0,0,0,0,Thursday
2020-02-27,Hung Hom,0,0,0,0,0,0,0,0,Thursday
2020-02-27,Lo Wu,0,0,0,0,0,0,0,0,Thursday
2020-02-27,Lok Ma Chau Spur Line,0,0,0,0,0,0,0,0,Thursday
2020-02-27,Lok Ma Chau,0,0,0,0,0,0,0,0,Thursday
2020-02-27,Man Kam To,0,0,0,0,0,0,0,0,Thursday
2020-02-27,Sha Tau Kok,0,0,0,0,0,0,0,0,Thursday
2020-02-27,Shenzhen Bay,1249,170,8,1427,1564,647,183,2394,Thursday
2020-02-27,China Ferry Terminal,0,0,0,0,0,0,0,0,Thursday
2020-02-27,Harbour Control,0,0,0,0,0,0,0,0,Thursday
2020-02-27,Kai Tak Cruise Terminal,0,0,0,0,0,0,0,0,Thursday
2020-02-27,Macau Ferry Terminal,0,0,0,0,0,0,0,0,Thursday
2020-02-27,Tuen Mun Ferry Terminal,0,0,0,0,0,0,0,0,Thursday
2020-02-27,Total,13846,702,2404,16952,14287,914,2354,17555,Thursday
2020-02-28,Airport,9205,369,1767,11341,10755,255,1747,12757,Friday
2020-02-28,Express Rail Link West Kowloon,0,0,0,0,0,0,0,0,Friday
2020-02-28,Hung Hom,0,0,0,0,0,0,0,0,Friday
2020-02-28,Lo Wu,0,0,0,0,0,0,0,0,Friday
2020-02-28,Lok Ma Chau Spur Line,0,0,0,0,0,0,0,0,Friday
2020-02-28,Lok Ma Chau,0,0,0,0,0,0,0,0,Friday
2020-02-28,Man Kam To,0,0,0,0,0,0,0,0,Friday
2020-02-28,Sha Tau Kok,0,0,0,0,0,0,0,0,Friday
2020-02-28,Shenzhen Bay,1280,181,10,1471,1724,566,175,2465,Friday
2020-02-28,China Ferry Terminal,0,0,0,0,0,0,0,0,Friday
2020-02-28,Harbour Control,0,0,0,0,0,0,0,0,Friday
2020-02-28,Kai Tak Cruise Terminal,0,0,0,0,0,0,0,0,Friday
2020-02-28,Macau Ferry Terminal,0,0,0,0,0,0,0,0,Friday
2020-02-28,Tuen Mun Ferry Terminal,0,0,0,0,0,0,0,0,Friday
2020-02-28,Total,15248,558,2642,18448,17148,911,2585,20644,Friday
2020-02-29,Airport,11818,870,1893,14581,9860,230,1688,11778,Saturday
2020-02-29,Express Rail Link West Kowloon,0,0,0,0,0,0,0,0,Saturday
2020-02-29,Hung Hom,0,0,0,0,0,0,0,0,Saturday
2020-02-29,Lo Wu,0,0,0,0,0,0,0,0,Saturday
2020-02-29,Lok Ma Chau Spur Line,0,0,0,0,0,0,0,0,Saturday
2020-02-29,Hong Kong-Zhuhai-Macao Bridge,4676,19,901,5596,4866,87,787,5740,Saturday
2020-02-29,Lok Ma Chau,0,0,0,0,0,0,0,0,Saturday
2020-02-29,Man Kam To,0,0,0,0,0,0,0,0,Saturday
2020-02-29,Sha Tau Kok,0,0,0,0,0,0,0,0,Saturday
2020-02-29,Shenzhen Bay,1387,195,3,1585,1807,947,329,3083,Saturday
2020-02-29,China Ferry Terminal,0,0,0,0,0,0,0,0,Saturday
2020-02-29,Harbour Control,0,0,0,0,0,0,0,0,Saturday
2020-02-29,Kai Tak Cruise Terminal,0,0,0,0,0,0,0,0,Saturday
2020-02-29,Macau Ferry Terminal,0,0,0,0,0,0,0,0,Saturday
2020-02-29,Tuen Mun Ferry Terminal,0,0,0,0,0,0,0,0,Saturday
2020-02-29,Total,17881,1084,2797,21762,16533,1264,2804,20601,Saturday
2020-03-01,Airport,14584,1122,2461,18167,9115,354,1850,11319,Sunday
2020-03-01,Hung Hom,0,0,0,0,0,0,0,0,Sunday
2020-03-01,Lo Wu,0,0,0,0,0,0,0,0,Sunday
2020-03-01,Lok Ma Chau Spur Line,0,0,0,0,0,0,0,0,Sunday
2020-03-01,Hong Kong-Zhuhai-Macao Bridge,4820,13,767,5600,4587,194,905,5686,Sunday
2020-03-01,Lok Ma Chau,0,0,0,0,0,0,0,0,Sunday
2020-03-01,Man Kam To,0,0,0,0,0,0,0,0,Sunday
2020-03-01,Sha Tau Kok,0,0,0,0,0,0,0,0,Sunday
2020-03-01,Shenzhen Bay,1587,211,9,1807,2053,1247,931,4231,Sunday
2020-03-01,China Ferry Terminal,0,0,0,0,0,0,0,0,Sunday
2020-03-01,Harbour Control,0,0,0,0,0,0,0,0,Sunday
2020-03-01,Kai Tak Cruise Terminal,0,0,0,0,0,0,0,0,Sunday
2020-03-01,Macau Ferry Terminal,0,0,0,0,0,0,0,0,Sunday
2020-03-01,Tuen Mun Ferry Terminal,0,0,0,0,0,0,0,0,Sunday
2020-03-01,Total,20991,1346,3237,25574,15755,1795,3686,21236,Sunday
2020-03-02,Airport,10261,732,1935,12928,6755,206,1314,8275,Monday
2020-03-02,Express Rail Link West Kowloon,0,0,0,0,0,0,0,0,Monday
2020-03-02,Hung Hom,0,0,0,0,0,0,0,0,Monday
2020-03-02,Lo Wu,0,0,0,0,0,0,0,0,Monday
2020-03-02,Lok Ma Chau Spur Line,0,0,0,0,0,0,0,0,Monday
2020-03-02,Hong Kong-Zhuhai-Macao Bridge,4244,10,738,4992,5321,93,836,6250,Monday
2020-03-02,Lok Ma Chau,0,0,0,0,0,0,0,0,Monday
2020-03-02,Man Kam To,0,0,0,0,0,0,0,0,Monday
2020-03-02,Sha Tau Kok,0,0,0,0,0,0,0,0,Monday
2020-03-02,Shenzhen Bay,2124,231,9,2364,2551,924,655,4130,Monday
2020-03-02,China Ferry Terminal,0,0,0,0,0,0,0,0,Monday
2020-03-02,Harbour Control,0,0,0,0,0,0,0,0,Monday
2020-03-02,Kai Tak Cruise Terminal,0,0,0,0,0,0,0,0,Monday
2020-03-02,Macau Ferry Terminal,0,0,0,0,0,0,0,0,Monday
2020-03-02,Tuen Mun Ferry Terminal,0,0,0,0,0,0,0,0,Monday
2020-03-02,Total,16629,973,2682,20284,14627,1223,2805,18655,Monday
2020-03-03,Airport,7960,734,1923,10617,6684,190,1349,8223,Tuesday
2020-03-03,Hung Hom,0,0,0,0,0,0,0,0,Tuesday
2020-03-03,Lo Wu,0,0,0,0,0,0,0,0,Tuesday
2020-03-03,Lok Ma Chau Spur Line,0,0,0,0,0,0,0,0,Tuesday
2020-03-03,Hong Kong-Zhuhai-Macao Bridge,4398,19,756,5173,4798,117,780,5695,Tuesday
2020-03-03,Lok Ma Chau,0,0,0,0,0,0,0,0,Tuesday
2020-03-03,Man Kam To,0,0,0,0,0,0,0,0,Tuesday
2020-03-03,Sha Tau Kok,0,0,0,0,0,0,0,0,Tuesday
2020-03-03,Shenzhen Bay,1479,165,3,1647,1970,793,667,3430,Tuesday
2020-03-03,China Ferry Terminal,0,0,0,0,0,0,0,0,Tuesday
2020-03-03,Harbour Control,0,0,0,0,0,0,0,0,Tuesday
2020-03-03,Kai Tak Cruise Terminal,0,0,0,0,0,0,0,0,Tuesday
2020-03-03,Macau Ferry Terminal,0,0,0,0,0,0,0,0,Tuesday
2020-03-03,Tuen Mun Ferry Terminal,0,0,0,0,0,0,0,0,Tuesday
2020-03-03,Total,13837,918,2682,17437,13452,1100,2796,17348,Tuesday
2020-03-04,Airport,7590,772,1847,10209,7170,213,1123,8506,Wednesday
2020-03-04,Express Rail Link West Kowloon,0,0,0,0,0,0,0,0,Wednesday
2020-03-04,Lo Wu,0,0,0,0,0,0,0,0,Wednesday
2020-03-04,Hong Kong-Zhuhai-Macao Bridge,4368,9,753,5130,4539,92,802,5433,Wednesday
2020-03-04,Lok Ma Chau,0,0,0,0,0,0,0,0,Wednesday
2020-03-04,Man Kam To,0,0,0,0,0,0,0,0,Wednesday
2020-03-04,Sha Tau Kok,0,0,0,0,0,0,0,0,Wednesday
2020-03-04,Shenzhen Bay,1306,192,7,1505,1684,806,664,3154,Wednesday
2020-03-04,China Ferry Terminal,0,0,0,0,0,0,0,0,Wednesday
2020-03-04,Harbour Control,0,0,0,0,0,0,0,0,Wednesday
2020-03-04,Kai Tak Cruise Terminal,0,0,0,0,0,0,0,0,Wednesday
2020-03-04,Macau Ferry Terminal,0,0,0,0,0,0,0,0,Wednesday
2020-03-04,Tuen Mun Ferry Terminal,0,0,0,0,0,0,0,0,Wednesday
2020-03-04,Total,13264,973,2607,16844,13393,1111,2589,17093,Wednesday
2020-03-05,Airport,7074,673,1749,9496,8141,190,1289,9620,Thursday
2020-03-05,Express Rail Link West Kowloon,0,0,0,0,0,0,0,0,Thursday
2020-03-05,Hung Hom,0,0,0,0,0,0,0,0,Thursday
2020-03-05,Lo Wu,0,0,0,0,0,0,0,0,Thursday
2020-03-05,Lok Ma Chau Spur Line,0,0,0,0,0,0,0,0,Thursday
2020-03-05,Hong Kong-Zhuhai-Macao Bridge,4752,17,782,5551,4999,96,776,5871,Thursday
2020-03-05,Lok Ma Chau,0,0,0,0,0,0,0,0,Thursday
2020-03-05,Man Kam To,0,0,0,0,0,0,0,0,Thursday
2020-03-05,Sha Tau Kok,0,0,0,0,0,0,0,0,Thursday
2020-03-05,Shenzhen Bay,1419,226,3,1648,1589,767,638,2994,Thursday
2020-03-05,China Ferry Terminal,0,0,0,0,0,0,0,0,Thursday
2020-03-05,Harbour Control,0,0,0,0,0,0,0,0,Thursday
2020-03-05,Kai Tak Cruise Terminal,0,0,0,0,0,0,0,0,Thursday
2020-03-05,Tuen Mun Ferry Terminal,0,0,0,0,0,0,0,0,Thursday
2020-03-05,Total,13245,916,2534,16695,14729,1053,2703,18485,Thursday
2020-03-06,Airport,7474,705,1877,10056,8746,215,1150,10111,Friday
2020-03-06,Express Rail Link West Kowloon,0,0,0,0,0,0,0,0,Friday
2020-03-06,Hung Hom,0,0,0,0,0,0,0,0,Friday
2020-03-06,Lo Wu,0,0,0,0,0,0,0,0,Friday
2020-03-06,Lok Ma Chau Spur Line,0,0,0,0,0,0,0,0,Friday
2020-03-06,Hong Kong-Zhuhai-Macao Bridge,6255,22,894,7171,6030,116,768,6914,Friday
2020-03-06,Lok Ma Chau,0,0,0,0,0,0,0,0,Friday
2020-03-06,Man Kam To,0,0,0,0,0,0,0,0,Friday
2020-03-06,Sha Tau Kok,0,0,0,0,0,0,0,0,Friday
2020-03-06,Shenzhen Bay,1425,251,8,1684,1550,734,544,2828,Friday
2020-03-06,China Ferry Terminal,0,0,0,0,0,0,0,0,Friday
2020-03-06,Harbour Control,0,0,0,0,0,0,0,0,Friday
2020-03-06,Kai Tak Cruise Terminal,0,0,0,0,0,0,0,0,Friday
2020-03-06,Macau Ferry Terminal,0,0,0,0,0,0,0,0,Friday
2020-03-06,Tuen Mun Ferry Terminal,0,0,0,0,0,0,0,0,Friday
2020-03-06,Total,15154,978,2779,18911,16326,1065,2462,19853,Friday
2020-03-07,Airport,8659,795,1919,11373,7316,216,1398,8930,Saturday
2020-03-07,Express Rail Link West Kowloon,0,0,0,0,0,0,0,0,Saturday
2020-03-07,Hung Hom,0,0,0,0,0,0,0,0,Saturday
2020-03-07,Lo Wu,0,0,0,0,0,0,0,0,Saturday
2020-03-07,Lok Ma Chau Spur Line,0,0,0,0,0,0,0,0,Saturday
2020-03-07,Lok Ma Chau,0,0,0,0,0,0,0,0,Saturday
2020-03-07,Man Kam To,0,0,0,0,0,0,0,0,Saturday
2020-03-07,Sha Tau Kok,0,0,0,0,0,0,0,0,Saturday
2020-03-07,Shenzhen Bay,1180,269,2,1451,1380,856,622,2858,Saturday
2020-03-07,China Ferry Terminal,0,0,0,0,0,0,0,0,Saturday
2020-03-07,Harbour Control,0,0,0,0,0,0,0,0,Saturday
2020-03-07,Kai Tak Cruise Terminal,0,0,0,0,0,0,0,0,Saturday
2020-03-07,Macau Ferry Terminal,0,0,0,0,0,0,0,0,Saturday
2020-03-07,Tuen Mun Ferry Terminal,0,0,0,0,0,0,0,0,Saturday
2020-03-07,Total,15774,1090,2894,19758,15136,1204,2923,19263,Saturday
2020-03-08,Airport,12538,730,1833,15101,6371,276,1376,8023,Sunday
2020-03-08,Express Rail Link West Kowloon,0,0,0,0,0,0,0,0,Sunday
2020-03-08,Hung Hom,0,0,0,0,0,0,0,0,Sunday
2020-03-08,Lo Wu,0,0,0,0,0,0,0,0,Sunday
2020-03-08,Lok Ma Chau Spur Line,0,0,0,0,0,0,0,0,Sunday
2020-03-08,Hong Kong-Zhuhai-Macao Bridge,6331,23,806,7160,5935,109,1127,7171,Sunday
2020-03-08,Lok Ma Chau,0,0,0,0,0,0,0,0,Sunday
2020-03-08,Man Kam To,0,0,0,0,0,0,0,0,Sunday
2020-03-08,Sha Tau Kok,0,0,0,0,0,0,0,0,Sunday
2020-03-08,Shenzhen Bay,1386,252,9,1647,1547,897,678,3122,Sunday
2020-03-08,China Ferry Terminal,0,0,0,0,0,0,0,0,Sunday
2020-03-08,Harbour Control,0,0,0,0,0,0,0,0,Sunday
2020-03-08,Kai Tak Cruise Terminal,0,0,0,0,0,0,0,0,Sunday
2020-03-08,Macau Ferry Terminal,0,0,0,0,0,0,0,0,Sunday
2020-03-08,Tuen Mun Ferry Terminal,0,0,0,0,0,0,0,0,Sunday
2020-03-08,Total,20255,1005,2648,23908,13853,1282,3181,18316,Sunday
2020-03-09,Airport,8304,706,1623,10633,4721,139,970,5830,Monday
2020-03-09,Hung Hom,0,0,0,0,0,0,0,0,Monday
2020-03-09,Lo Wu,0,0,0,0,0,0,0,0,Monday
2020-03-09,Lok Ma Chau Spur Line,0,0,0,0,0,0,0,0,Monday
2020-03-09,Hong Kong-Zhuhai-Macao Bridge,5638,16,805,6459,6224,133,929,7286,Monday
2020-03-09,Lok Ma Chau,0,0,0,0,0,0,0,0,Monday
2020-03-09,Man Kam To,0,0,0,0,0,0,0,0,Monday
2020-03-09,Sha Tau Kok,0,0,0,0,0,0,0,0,Monday
2020-03-09,Shenzhen Bay,1632,233,10,1875,2197,774,592,3563,Monday
2020-03-09,China Ferry Terminal,0,0,0,0,0,0,0,0,Monday
2020-03-09,Harbour Control,0,0,0,0,0,0,0,0,Monday
2020-03-09,Kai Tak Cruise Terminal,0,0,0,0,0,0,0,0,Monday
2020-03-09,Macau Ferry Terminal,0,0,0,0,0,0,0,0,Monday
2020-03-09,Tuen Mun Ferry Terminal,0,0,0,0,0,0,0,0,Monday
2020-03-10,Hung Hom,0,0,0,0,0,0,0,0,Tuesday
2020-03-10,Lo Wu,0,0,0,0,0,0,0,0,Tuesday
2020-03-10,Lok Ma Chau Spur Line,0,0,0,0,0,0,0,0,Tuesday
2020-03-10,Hong Kong-Zhuhai-Macao Bridge,5366,31,757,6154,5687,84,900,6671,Tuesday
2020-03-10,Lok Ma Chau,0,0,0,0,0,0,0,0,Tuesday
2020-03-10,Man Kam To,0,0,0,0,0,0,0,0,Tuesday
2020-03-10,Sha Tau Kok,0,0,0,0,0,0,0,0,Tuesday
2020-03-10,Shenzhen Bay,1491,212,5,1708,1762,802,432,2996,Tuesday
2020-03-10,China Ferry Terminal,0,0,0,0,0,0,0,0,Tuesday
2020-03-10,Harbour Control,0,0,0,0,0,0,0,0,Tuesday
2020-03-10,Kai Tak Cruise Terminal,0,0,0,0,0,0,0,0,Tuesday
2020-03-10,Macau Ferry Terminal,0,0,0,0,0,0,0,0,Tuesday
2020-03-10,Tuen Mun Ferry Terminal,0,0,0,0,0,0,0,0,Tuesday
2020-03-10,Total,13908,906,2293,17107,11251,1028,2246,14525,Tuesday
2020-03-11,Airport,7610,838,1539,9987,3443,205,841,4489,Wednesday
2020-03-11,Express Rail Link West Kowloon,0,0,0,0,0,0,0,0,Wednesday
2020-03-11,Hung Hom,0,0,0,0,0,0,0,0,Wednesday
2020-03-11,Lo Wu,0,0,0,0,0,0,0,0,Wednesday
2020-03-11,Lok Ma Chau Spur Line,0,0,0,0,0,0,0,0,Wednesday
2020-03-11,Hong Kong-Zhuhai-Macao Bridge,5248,25,733,6006,5258,122,765,6145,Wednesday
2020-03-11,Lok Ma Chau,0,0,0,0,0,0,0,0,Wednesday
2020-03-11,Man Kam To,0,0,0,0,0,0,0,0,Wednesday
2020-03-11,Sha Tau Kok,0,0,0,0,0,0,0,0,Wednesday
2020-03-11,Shenzhen Bay,1418,244,2,1664,1632,866,443,2941,Wednesday
2020-03-11,China Ferry Terminal,0,0,0,0,0,0,0,0,Wednesday
2020-03-11,Harbour Control,0,0,0,0,0,0,0,0,Wednesday
2020-03-11,Macau Ferry Terminal,0,0,0,0,0,0,0,0,Wednesday
2020-03-11,Tuen Mun Ferry Terminal,0,0,0,0,0,0,0,0,Wednesday
2020-03-11,Total,14276,1107,2274,17657,10333,1193,2049,13575,Wednesday
2020-03-12,Airport,6416,944,1426,8786,4050,152,995,5197,Thursday
2020-03-12,Express Rail Link West Kowloon,0,0,0,0,0,0,0,0,Thursday
2020-03-12,Hung Hom,0,0,0,0,0,0,0,0,Thursday
2020-03-12,Lo Wu,0,0,0,0,0,0,0,0,Thursday
2020-03-12,Lok Ma Chau Spur Line,0,0,0,0,0,0,0,0,Thursday
2020-03-12,Hong Kong-Zhuhai-Macao Bridge,5391,21,753,6165,5753,177,790,6720,Thursday
2020-03-12,Lok Ma Chau,0,0,0,0,0,0,0,0,Thursday
2020-03-12,Man Kam To,0,0,0,0,0,0,0,0,Thursday
2020-03-12,Sha Tau Kok,0,0,0,0,0,0,0,0,Thursday
2020-03-12,Shenzhen Bay,1376,235,3,1614,1602,887,417,2906,Thursday
2020-03-12,China Ferry Terminal,0,0,0,0,0,0,0,0,Thursday
2020-03-12,Harbour Control,0,0,0,0,0,0,0,0,Thursday
2020-03-12,Kai Tak Cruise Terminal,0,0,0,0,0,0,0,0,Thursday
2020-03-12,Macau Ferry Terminal,0,0,0,0,0,0,0,0,Thursday
2020-03-12,Tuen Mun Ferry Terminal,0,0,0,0,0,0,0,0,Thursday
2020-03-12,Total,13183,1200,2182,16565,11405,1216,2202,14823,Thursday
2020-03-13,Airport,6758,1075,1401,9234,4435,269,1044,5748,Friday
2020-03-13,Express Rail Link West Kowloon,0,0,0,0,0,0,0,0,Friday
2020-03-13,Hung Hom,0,0,0,0,0,0,0,0,Friday
2020-03-13,Lo Wu,0,0,0,0,0,0,0,0,Friday
2020-03-13,Lok Ma Chau Spur Line,0,0,0,0,0,0,0,0,Friday
2020-03-13,Lok Ma Chau,0,0,0,0,0,0,0,0,Friday
2020-03-13,Man Kam To,0,0,0,0,0,0,0,0,Friday
2020-03-13,Sha Tau Kok,0,0,0,0,0,0,0,0,Friday
2020-03-13,Shenzhen Bay,1418,254,3,1675,1520,1018,369,2907,Friday
2020-03-13,China Ferry Terminal,0,0,0,0,0,0,0,0,Friday
2020-03-13,Harbour Control,0,0,0,0,0,0,0,0,Friday
2020-03-13,Kai Tak Cruise Terminal,0,0,0,0,0,0,0,0,Friday
2020-03-13,Macau Ferry Terminal,0,0,0,0,0,0,0,0,Friday
2020-03-13,Tuen Mun Ferry Terminal,0,0,0,0,0,0,0,0,Friday
2020-03-13,Total,15048,1348,2349,18745,12649,1429,2352,16430,Friday
2020-03-14,Airport,7513,1435,1587,10535,3764,214,996,4974,Saturday
2020-03-14,Express Rail Link West Kowloon,0,0,0,0,0,0,0,0,Saturday
2020-03-14,Hung Hom,0,0,0,0,0,0,0,0,Saturday
2020-03-14,Lo Wu,0,0,0,0,0,0,0,0,Saturday
2020-03-14,Lok Ma Chau Spur Line,0,0,0,0,0,0,0,0,Saturday
2020-03-14,Hong Kong-Zhuhai-Macao Bridge,6098,25,1075,7198,7110,206,1126,8442,Saturday
2020-03-14,Lok Ma Chau,0,0,0,0,0,0,0,0,Saturday
2020-03-14,Man Kam To,0,0,0,0,0,0,0,0,Saturday
2020-03-14,Sha Tau Kok,0,0,0,0,0,0,0,0,Saturday
2020-03-14,Shenzhen Bay,1276,270,3,1549,1560,1303,406,3269,Saturday
2020-03-14,China Ferry Terminal,0,0,0,0,0,0,0,0,Saturday
2020-03-14,Harbour Control,0,0,0,0,0,0,0,0,Saturday
2020-03-14,Kai Tak Cruise Terminal,0,0,0,0,0,0,0,0,Saturday
2020-03-14,Macau Ferry Terminal,0,0,0,0,0,0,0,0,Saturday
2020-03-14,Tuen Mun Ferry Terminal,0,0,0,0,0,0,0,0,Saturday
2020-03-14,Total,14887,1730,2665,19282,12434,1723,2528,16685,Saturday
2020-03-15,Airport,10027,1558,1950,13535,2516,315,863,3694,Sunday
2020-03-15,Hung Hom,0,0,0,0,0,0,0,0,Sunday
2020-03-15,Lo Wu,0,0,0,0,0,0,0,0,Sunday
2020-03-15,Lok Ma Chau Spur Line,0,0,0,0,0,0,0,0,Sunday
2020-03-15,Hong Kong-Zhuhai-Macao Bridge,8172,33,674,8879,7405,194,1233,8832,Sunday
2020-03-15,Lok Ma Chau,0,0,0,0,0,0,0,0,Sunday
2020-03-15,Man Kam To,0,0,0,0,0,0,0,0,Sunday
2020-03-15,Sha Tau Kok,0,0,0,0,0,0,0,0,Sunday
2020-03-15,Shenzhen Bay,1745,351,18,2114,1628,1565,632,3825,Sunday
2020-03-15,China Ferry Terminal,0,0,0,0,0,0,0,0,Sunday
2020-03-15,Harbour Control,0,0,0,0,0,0,0,0,Sunday
2020-05-01,Lo Wu,0,0,0,0,0,0,0,0,Friday
2020-03-15,Macau Ferry Terminal,0,0,0,0,0,0,0,0,Sunday
2020-03-15,Tuen Mun Ferry Terminal,0,0,0,0,0,0,0,0,Sunday
2020-03-15,Total,19944,1942,2642,24528,11549,2074,2728,16351,Sunday
2020-03-16,Airport,8498,1662,2038,12198,2117,382,896,3395,Monday
2020-03-16,Hung Hom,0,0,0,0,0,0,0,0,Monday
2020-03-16,Lo Wu,0,0,0,0,0,0,0,0,Monday
2020-03-16,Lok Ma Chau Spur Line,0,0,0,0,0,0,0,0,Monday
2020-03-16,Hong Kong-Zhuhai-Macao Bridge,6258,28,792,7078,6782,314,1408,8504,Monday
2020-03-16,Lok Ma Chau,0,0,0,0,0,0,0,0,Monday
2020-03-16,Man Kam To,0,0,0,0,0,0,0,0,Monday
2020-03-16,Sha Tau Kok,0,0,0,0,0,0,0,0,Monday
2020-03-16,Shenzhen Bay,1878,326,8,2212,2182,1450,593,4225,Monday
2020-03-16,China Ferry Terminal,0,0,0,0,0,0,0,0,Monday
2020-03-16,Harbour Control,0,0,0,0,0,0,0,0,Monday
2020-03-16,Kai Tak Cruise Terminal,0,0,0,0,0,0,0,0,Monday
2020-03-16,Macau Ferry Terminal,0,0,0,0,0,0,0,0,Monday
2020-03-16,Tuen Mun Ferry Terminal,0,0,0,0,0,0,0,0,Monday
2020-03-16,Total,16634,2016,2838,21488,11081,2146,2897,16124,Monday
2020-03-17,Airport,7472,1702,1272,10446,1483,339,666,2488,Tuesday
2020-03-17,Express Rail Link West Kowloon,0,0,0,0,0,0,0,0,Tuesday
2020-03-17,Hung Hom,0,0,0,0,0,0,0,0,Tuesday
2020-03-17,Lo Wu,0,0,0,0,0,0,0,0,Tuesday
2020-03-17,Lok Ma Chau Spur Line,0,0,0,0,0,0,0,0,Tuesday
2020-03-17,Hong Kong-Zhuhai-Macao Bridge,5812,21,753,6586,5791,287,979,7057,Tuesday
2020-03-17,Lok Ma Chau,0,0,0,0,0,0,0,0,Tuesday
2020-03-17,Man Kam To,0,0,0,0,0,0,0,0,Tuesday
2020-03-17,Sha Tau Kok,0,0,0,0,0,0,0,0,Tuesday
2020-03-17,Shenzhen Bay,1393,257,4,1654,1672,1420,446,3538,Tuesday
2020-03-17,China Ferry Terminal,0,0,0,0,0,0,0,0,Tuesday
2020-03-17,Harbour Control,0,0,0,0,0,0,0,0,Tuesday
2020-03-17,Kai Tak Cruise Terminal,0,0,0,0,0,0,0,0,Tuesday
2020-03-17,Tuen Mun Ferry Terminal,0,0,0,0,0,0,0,0,Tuesday
2020-03-17,Total,14677,1980,2029,18686,8946,2046,2091,13083,Tuesday
2020-03-18,Airport,9616,2027,1309,12952,1041,337,615,1993,Wednesday
2020-03-18,Express Rail Link West Kowloon,0,0,0,0,0,0,0,0,Wednesday
2020-03-18,Hung Hom,0,0,0,0,0,0,0,0,Wednesday
2020-03-18,Lo Wu,0,0,0,0,0,0,0,0,Wednesday
2020-03-18,Lok Ma Chau Spur Line,0,0,0,0,0,0,0,0,Wednesday
2020-03-18,Hong Kong-Zhuhai-Macao Bridge,5266,37,580,5883,4850,334,792,5976,Wednesday
2020-03-18,Lok Ma Chau,0,0,0,0,0,0,0,0,Wednesday
2020-03-18,Man Kam To,0,0,0,0,0,0,0,0,Wednesday
2020-03-18,Sha Tau Kok,0,0,0,0,0,0,0,0,Wednesday
2020-03-18,Shenzhen Bay,1394,344,10,1748,1570,1734,360,3664,Wednesday
2020-03-18,China Ferry Terminal,0,0,0,0,0,0,0,0,Wednesday
2020-03-18,Harbour Control,0,0,0,0,0,0,0,0,Wednesday
2020-03-18,Kai Tak Cruise Terminal,0,0,0,0,0,0,0,0,Wednesday
2020-03-18,Macau Ferry Terminal,0,0,0,0,0,0,0,0,Wednesday
2020-03-18,Tuen Mun Ferry Terminal,0,0,0,0,0,0,0,0,Wednesday
2020-03-18,Total,16276,2408,1899,20583,7461,2405,1767,11633,Wednesday
2020-03-19,Airport,6138,37,596,6771,1110,160,519,1789,Thursday
2020-03-19,Express Rail Link West Kowloon,0,0,0,0,0,0,0,0,Thursday
2020-03-19,Hung Hom,0,0,0,0,0,0,0,0,Thursday
2020-03-19,Lo Wu,0,0,0,0,0,0,0,0,Thursday
2020-03-19,Lok Ma Chau Spur Line,0,0,0,0,0,0,0,0,Thursday
2020-03-19,Lok Ma Chau,0,0,0,0,0,0,0,0,Thursday
2020-03-19,Man Kam To,0,0,0,0,0,0,0,0,Thursday
2020-03-19,Sha Tau Kok,0,0,0,0,0,0,0,0,Thursday
2020-03-19,Shenzhen Bay,1099,184,3,1286,1449,458,244,2151,Thursday
2020-03-19,China Ferry Terminal,0,0,0,0,0,0,0,0,Thursday
2020-03-19,Harbour Control,0,0,0,0,0,0,0,0,Thursday
2020-03-19,Kai Tak Cruise Terminal,0,0,0,0,0,0,0,0,Thursday
2020-03-19,Macau Ferry Terminal,0,0,0,0,0,0,0,0,Thursday
2020-03-19,Tuen Mun Ferry Terminal,0,0,0,0,0,0,0,0,Thursday
2020-03-19,Total,11924,243,951,13118,7383,664,1186,9233,Thursday
2020-03-20,Airport,6427,44,603,7074,1190,54,445,1689,Friday
2020-03-20,Express Rail Link West Kowloon,0,0,0,0,0,0,0,0,Friday
2020-03-20,Hung Hom,0,0,0,0,0,0,0,0,Friday
2020-03-20,Lo Wu,0,0,0,0,0,0,0,0,Friday
2020-03-20,Lok Ma Chau Spur Line,0,0,0,0,0,0,0,0,Friday
2020-03-20,Hong Kong-Zhuhai-Macao Bridge,5732,18,458,6208,5426,48,691,6165,Friday
2020-03-20,Lok Ma Chau,0,0,0,0,0,0,0,0,Friday
2020-03-20,Man Kam To,0,0,0,0,0,0,0,0,Friday
2020-03-20,Sha Tau Kok,0,0,0,0,0,0,0,0,Friday
2020-03-20,Shenzhen Bay,1328,245,3,1576,1404,401,176,1981,Friday
2020-03-20,China Ferry Terminal,0,0,0,0,0,0,0,0,Friday
2020-03-20,Harbour Control,0,0,0,0,0,0,0,0,Friday
2020-03-20,Kai Tak Cruise Terminal,0,0,0,0,0,0,0,0,Friday
2020-03-20,Macau Ferry Terminal,0,0,0,0,0,0,0,0,Friday
2020-03-20,Tuen Mun Ferry Terminal,0,0,0,0,0,0,0,0,Friday
2020-03-20,Total,13487,307,1064,14858,8020,503,1312,9835,Friday
2020-03-21,Airport,6547,43,526,7116,844,39,320,1203,Saturday
2020-03-21,Hung Hom,0,0,0,0,0,0,0,0,Saturday
2020-03-21,Lo Wu,0,0,0,0,0,0,0,0,Saturday
2020-03-21,Lok Ma Chau Spur Line,0,0,0,0,0,0,0,0,Saturday
2020-03-21,Hong Kong-Zhuhai-Macao Bridge,4805,37,388,5230,5244,70,536,5850,Saturday
2020-03-21,Lok Ma Chau,0,0,0,0,0,0,0,0,Saturday
2020-03-21,Man Kam To,0,0,0,0,0,0,0,0,Saturday
2020-03-21,Sha Tau Kok,0,0,0,0,0,0,0,0,Saturday
2020-03-21,China Ferry Terminal,0,0,0,0,0,0,0,0,Saturday
2020-03-21,Harbour Control,0,0,0,0,0,0,0,0,Saturday
2020-03-21,Macau Ferry Terminal,0,0,0,0,0,0,0,0,Saturday
2020-03-21,Tuen Mun Ferry Terminal,0,0,0,0,0,0,0,0,Saturday
2020-03-21,Total,12256,319,919,13494,7472,566,969,9007,Saturday
2020-03-22,Airport,5596,33,566,6195,659,49,228,936,Sunday
2020-03-22,Express Rail Link West Kowloon,0,0,0,0,0,0,0,0,Sunday
2020-03-22,Hung Hom,0,0,0,0,0,0,0,0,Sunday
2020-03-22,Lo Wu,0,0,0,0,0,0,0,0,Sunday
2020-03-22,Lok Ma Chau Spur Line,0,0,0,0,0,0,0,0,Sunday
2020-03-22,Hong Kong-Zhuhai-Macao Bridge,4996,31,235,5262,4386,49,453,4888,Sunday
2020-03-22,Lok Ma Chau,0,0,0,0,0,0,0,0,Sunday
2020-03-22,Man Kam To,0,0,0,0,0,0,0,0,Sunday
2020-03-22,Sha Tau Kok,0,0,0,0,0,0,0,0,Sunday
2020-03-22,Shenzhen Bay,1064,272,4,1340,1619,567,199,2385,Sunday
2020-03-22,China Ferry Terminal,0,0,0,0,0,0,0,0,Sunday
2020-03-22,Harbour Control,0,0,0,0,0,0,0,0,Sunday
2020-03-22,Kai Tak Cruise Terminal,0,0,0,0,0,0,0,0,Sunday
2020-03-22,Macau Ferry Terminal,0,0,0,0,0,0,0,0,Sunday
2020-03-22,Tuen Mun Ferry Terminal,0,0,0,0,0,0,0,0,Sunday
2020-03-22,Total,11656,336,805,12797,6664,665,880,8209,Sunday
2020-03-23,Airport,4536,30,529,5095,514,34,208,756,Monday
2020-03-23,Hung Hom,0,0,0,0,0,0,0,0,Monday
2020-03-23,Lo Wu,0,0,0,0,0,0,0,0,Monday
2020-03-23,Lok Ma Chau Spur Line,0,0,0,0,0,0,0,0,Monday
2020-03-23,Hong Kong-Zhuhai-Macao Bridge,4930,16,353,5299,5722,43,539,6304,Monday
2020-03-23,Lok Ma Chau,0,0,0,0,0,0,0,0,Monday
2020-03-23,Man Kam To,0,0,0,0,0,0,0,0,Monday
2020-03-23,Sha Tau Kok,0,0,0,0,0,0,0,0,Monday
2020-03-23,Shenzhen Bay,1053,201,4,1258,2229,462,207,2898,Monday
2020-03-23,China Ferry Terminal,0,0,0,0,0,0,0,0,Monday
2020-03-23,Harbour Control,0,0,0,0,0,0,0,0,Monday
2020-03-23,Kai Tak Cruise Terminal,0,0,0,0,0,0,0,0,Monday
2020-03-23,Macau Ferry Terminal,0,0,0,0,0,0,0,0,Monday
2020-03-23,Tuen Mun Ferry Terminal,0,0,0,0,0,0,0,0,Monday
2020-03-23,Total,10519,247,886,11652,8465,539,954,9958,Monday
2020-03-24,Airport,3488,73,855,4416,577,21,260,858,Tuesday
2020-03-24,Express Rail Link West Kowloon,0,0,0,0,0,0,0,0,Tuesday
2020-03-24,Hung Hom,0,0,0,0,0,0,0,0,Tuesday
2020-03-24,Lo Wu,0,0,0,0,0,0,0,0,Tuesday
2020-03-24,Lok Ma Chau Spur Line,0,0,0,0,0,0,0,0,Tuesday
2020-03-24,Hong Kong-Zhuhai-Macao Bridge,7851,47,942,8840,6050,67,1082,7199,Tuesday
2020-03-24,Lok Ma Chau,0,0,0,0,0,0,0,0,Tuesday
2020-03-24,Man Kam To,0,0,0,0,0,0,0,0,Tuesday
2020-03-24,Sha Tau Kok,0,0,0,0,0,0,0,0,Tuesday
2020-03-24,Shenzhen Bay,1198,317,12,1527,1793,453,401,2647,Tuesday
2020-03-24,China Ferry Terminal,0,0,0,0,0,0,0,0,Tuesday
2020-03-24,Harbour Control,0,0,0,0,0,0,0,0,Tuesday
2020-03-24,Kai Tak Cruise Terminal,0,0,0,0,0,0,0,0,Tuesday
2020-03-24,Macau Ferry Terminal,0,0,0,0,0,0,0,0,Tuesday
2020-03-24,Tuen Mun Ferry Terminal,0,0,0,0,0,0,0,0,Tuesday
2020-03-24,Total,12537,437,1809,14783,8420,541,1743,10704,Tuesday
2020-03-25,Airport,4053,6,158,4217,629,21,236,886,Wednesday
2020-03-25,Hung Hom,0,0,0,0,0,0,0,0,Wednesday
2020-03-25,Lo Wu,0,0,0,0,0,0,0,0,Wednesday
2020-03-25,Lok Ma Chau Spur Line,0,0,0,0,0,0,0,0,Wednesday
2020-03-25,Hong Kong-Zhuhai-Macao Bridge,106,7,19,132,212,25,173,410,Wednesday
2020-03-25,Lok Ma Chau,0,0,0,0,0,0,0,0,Wednesday
2020-03-25,Man Kam To,0,0,0,0,0,0,0,0,Wednesday
2020-03-25,Sha Tau Kok,0,0,0,0,0,0,0,0,Wednesday
2020-03-25,Shenzhen Bay,810,135,3,948,1525,326,21,1872,Wednesday
2020-03-25,China Ferry Terminal,0,0,0,0,0,0,0,0,Wednesday
2020-03-25,Harbour Control,0,0,0,0,0,0,0,0,Wednesday
2020-03-25,Kai Tak Cruise Terminal,0,0,0,0,0,0,0,0,Wednesday
2020-03-25,Macau Ferry Terminal,0,0,0,0,0,0,0,0,Wednesday
2020-03-25,Tuen Mun Ferry Terminal,0,0,0,0,0,0,0,0,Wednesday
2020-03-25,Total,4969,148,180,5297,2366,372,430,3168,Wednesday
2020-03-26,Airport,3303,6,126,3435,436,20,138,594,Thursday
2020-03-26,Express Rail Link West Kowloon,0,0,0,0,0,0,0,0,Thursday
2020-03-26,Hung Hom,0,0,0,0,0,0,0,0,Thursday
2020-03-26,Lo Wu,0,0,0,0,0,0,0,0,Thursday
2020-03-26,Lok Ma Chau Spur Line,0,0,0,0,0,0,0,0,Thursday
2020-03-26,Hong Kong-Zhuhai-Macao Bridge,95,8,23,126,342,42,113,497,Thursday
2020-03-26,Lok Ma Chau,0,0,0,0,0,0,0,0,Thursday
2020-03-26,Man Kam To,0,0,0,0,0,0,0,0,Thursday
2020-03-26,Sha Tau Kok,0,0,0,0,0,0,0,0,Thursday
2020-03-26,Shenzhen Bay,773,122,2,897,2476,522,16,3014,Thursday
2020-03-26,China Ferry Terminal,0,0,0,0,0,0,0,0,Thursday
2020-03-26,Harbour Control,0,0,0,0,0,0,0,0,Thursday
2020-03-26,Kai Tak Cruise Terminal,0,0,0,0,0,0,0,0,Thursday
2020-03-26,Macau Ferry Terminal,0,0,0,0,0,0,0,0,Thursday
2020-03-26,Total,4171,136,151,4458,3254,584,267,4105,Thursday
2020-03-27,Airport,2903,4,178,3085,1030,46,238,1314,Friday
2020-03-27,Express Rail Link West Kowloon,0,0,0,0,0,0,0,0,Friday
2020-03-27,Hung Hom,0,0,0,0,0,0,0,0,Friday
2020-03-27,Lo Wu,0,0,0,0,0,0,0,0,Friday
2020-03-27,Lok Ma Chau Spur Line,0,0,0,0,0,0,0,0,Friday
2020-06-05,Airport,1073,4,42,1119,633,10,78,721,Friday
2020-03-27,Lok Ma Chau,0,0,0,0,0,0,0,0,Friday
2020-03-27,Man Kam To,0,0,0,0,0,0,0,0,Friday
2020-03-27,Sha Tau Kok,0,0,0,0,0,0,0,0,Friday
2020-03-27,Shenzhen Bay,676,121,1,798,298,83,113,494,Friday
2020-03-27,China Ferry Terminal,0,0,0,0,0,0,0,0,Friday
2020-03-27,Harbour Control,0,0,0,0,0,0,0,0,Friday
2020-03-27,Macau Ferry Terminal,0,0,0,0,0,0,0,0,Friday
2020-03-27,Tuen Mun Ferry Terminal,0,0,0,0,0,0,0,0,Friday
2020-03-27,Total,3703,134,196,4033,2025,249,521,2795,Friday
2020-03-28,Airport,3744,7,175,3926,691,51,162,904,Saturday
2020-03-28,Express Rail Link West Kowloon,0,0,0,0,0,0,0,0,Saturday
2020-03-28,Hung Hom,0,0,0,0,0,0,0,0,Saturday
2020-03-28,Lo Wu,0,0,0,0,0,0,0,0,Saturday
2020-03-28,Lok Ma Chau Spur Line,0,0,0,0,0,0,0,0,Saturday
2020-03-28,Hong Kong-Zhuhai-Macao Bridge,67,7,16,90,45,3,146,194,Saturday
2020-03-28,Lok Ma Chau,0,0,0,0,0,0,0,0,Saturday
2020-03-28,Man Kam To,0,0,0,0,0,0,0,0,Saturday
2020-03-28,Sha Tau Kok,0,0,0,0,0,0,0,0,Saturday
2020-03-28,Shenzhen Bay,545,96,5,646,238,102,3,343,Saturday
2020-03-28,China Ferry Terminal,0,0,0,0,0,0,0,0,Saturday
2020-03-28,Harbour Control,0,0,0,0,0,0,0,0,Saturday
2020-03-28,Kai Tak Cruise Terminal,0,0,0,0,0,0,0,0,Saturday
2020-03-28,Macau Ferry Terminal,0,0,0,0,0,0,0,0,Saturday
2020-03-28,Tuen Mun Ferry Terminal,0,0,0,0,0,0,0,0,Saturday
2020-03-28,Total,4356,110,196,4662,974,156,311,1441,Saturday
2020-03-29,Airport,2616,6,215,2837,301,25,77,403,Sunday
2020-03-29,Hung Hom,0,0,0,0,0,0,0,0,Sunday
2020-03-29,Lo Wu,0,0,0,0,0,0,0,0,Sunday
2020-03-29,Lok Ma Chau Spur Line,0,0,0,0,0,0,0,0,Sunday
2020-03-29,Hong Kong-Zhuhai-Macao Bridge,60,7,16,83,36,5,181,222,Sunday
2020-03-29,Lok Ma Chau,0,0,0,0,0,0,0,0,Sunday
2020-03-29,Man Kam To,0,0,0,0,0,0,0,0,Sunday
2020-03-29,Sha Tau Kok,0,0,0,0,0,0,0,0,Sunday
2020-03-29,Shenzhen Bay,554,110,0,664,221,67,2,290,Sunday
2020-03-29,China Ferry Terminal,0,0,0,0,0,0,0,0,Sunday
2020-03-29,Harbour Control,0,0,0,0,0,0,0,0,Sunday
2020-03-29,Kai Tak Cruise Terminal,0,0,0,0,0,0,0,0,Sunday
2020-03-29,Macau Ferry Terminal,0,0,0,0,0,0,0,0,Sunday
2020-03-29,Tuen Mun Ferry Terminal,0,0,0,0,0,0,0,0,Sunday
2020-03-29,Total,3230,123,231,3584,558,97,260,915,Sunday
2020-03-30,Airport,1924,7,138,2069,346,10,92,448,Monday
2020-03-30,Express Rail Link West Kowloon,0,0,0,0,0,0,0,0,Monday
2020-03-30,Hung Hom,0,0,0,0,0,0,0,0,Monday
2020-03-30,Lo Wu,0,0,0,0,0,0,0,0,Monday
2020-03-30,Lok Ma Chau Spur Line,0,0,0,0,0,0,0,0,Monday
2020-03-30,Hong Kong-Zhuhai-Macao Bridge,60,4,16,80,50,4,145,199,Monday
2020-03-30,Lok Ma Chau,0,0,0,0,0,0,0,0,Monday
2020-03-30,Man Kam To,0,0,0,0,0,0,0,0,Monday
2020-03-30,Sha Tau Kok,0,0,0,0,0,0,0,0,Monday
2020-03-30,Shenzhen Bay,704,79,1,784,284,82,4,370,Monday
2020-03-30,China Ferry Terminal,0,0,0,0,0,0,0,0,Monday
2020-03-30,Harbour Control,0,0,0,0,0,0,0,0,Monday
2020-03-30,Kai Tak Cruise Terminal,0,0,0,0,0,0,0,0,Monday
2020-03-30,Macau Ferry Terminal,0,0,0,0,0,0,0,0,Monday
2020-03-30,Tuen Mun Ferry Terminal,0,0,0,0,0,0,0,0,Monday
2020-03-30,Total,2688,90,155,2933,680,96,241,1017,Monday
2020-03-31,Airport,1406,9,119,1534,569,20,142,731,Tuesday
2020-03-31,Hung Hom,0,0,0,0,0,0,0,0,Tuesday
2020-03-31,Lo Wu,0,0,0,0,0,0,0,0,Tuesday
2020-03-31,Lok Ma Chau Spur Line,0,0,0,0,0,0,0,0,Tuesday
2020-03-31,Hong Kong-Zhuhai-Macao Bridge,76,5,17,98,56,6,122,184,Tuesday
2020-03-31,Lok Ma Chau,0,0,0,0,0,0,0,0,Tuesday
2020-03-31,Man Kam To,0,0,0,0,0,0,0,0,Tuesday
2020-03-31,Sha Tau Kok,0,0,0,0,0,0,0,0,Tuesday
2020-03-31,Shenzhen Bay,763,97,3,863,366,67,3,436,Tuesday
2020-03-31,China Ferry Terminal,0,0,0,0,0,0,0,0,Tuesday
2020-03-31,Harbour Control,0,0,0,0,0,0,0,0,Tuesday
2020-03-31,Kai Tak Cruise Terminal,0,0,0,0,0,0,0,0,Tuesday
2020-03-31,Macau Ferry Terminal,0,0,0,0,0,0,0,0,Tuesday
2020-03-31,Tuen Mun Ferry Terminal,0,0,0,0,0,0,0,0,Tuesday
2020-03-31,Total,2245,111,139,2495,991,93,267,1351,Tuesday
2020-04-01,Airport,1144,5,34,1183,526,36,86,648,Wednesday
2020-04-01,Express Rail Link West Kowloon,0,0,0,0,0,0,0,0,Wednesday
2020-04-01,Hung Hom,0,0,0,0,0,0,0,0,Wednesday
2020-04-01,Lo Wu,0,0,0,0,0,0,0,0,Wednesday
2020-04-01,Lok Ma Chau Spur Line,0,0,0,0,0,0,0,0,Wednesday
2020-04-01,Hong Kong-Zhuhai-Macao Bridge,68,7,4,79,42,4,16,62,Wednesday
2020-04-01,Lok Ma Chau,0,0,0,0,0,0,0,0,Wednesday
2020-04-01,Man Kam To,0,0,0,0,0,0,0,0,Wednesday
2020-04-01,Sha Tau Kok,0,0,0,0,0,0,0,0,Wednesday
2020-04-01,Shenzhen Bay,798,84,2,884,385,123,0,508,Wednesday
2020-04-01,China Ferry Terminal,0,0,0,0,0,0,0,0,Wednesday
2020-04-01,Harbour Control,0,0,0,0,0,0,0,0,Wednesday
2020-04-01,Macau Ferry Terminal,0,0,0,0,0,0,0,0,Wednesday
2020-04-01,Tuen Mun Ferry Terminal,0,0,0,0,0,0,0,0,Wednesday
2020-04-01,Total,2010,96,40,2146,953,163,102,1218,Wednesday
2020-04-02,Airport,662,4,9,675,269,21,59,349,Thursday
2020-04-02,Express Rail Link West Kowloon,0,0,0,0,0,0,0,0,Thursday
2020-04-02,Lo Wu,0,0,0,0,0,0,0,0,Thursday
2020-04-02,Hong Kong-Zhuhai-Macao Bridge,67,3,0,70,70,0,6,76,Thursday
2020-04-02,Lok Ma Chau,0,0,0,0,0,0,0,0,Thursday
2020-04-02,Man Kam To,0,0,0,0,0,0,0,0,Thursday
2020-04-02,Sha Tau Kok,0,0,0,0,0,0,0,0,Thursday
2020-04-02,Shenzhen Bay,631,69,0,700,371,87,7,465,Thursday
2020-04-02,China Ferry Terminal,0,0,0,0,0,0,0,0,Thursday
2020-04-02,Harbour Control,0,0,0,0,0,0,0,0,Thursday
2020-04-02,Kai Tak Cruise Terminal,0,0,0,0,0,0,0,0,Thursday
2020-04-02,Macau Ferry Terminal,0,0,0,0,0,0,0,0,Thursday
2020-04-02,Tuen Mun Ferry Terminal,0,0,0,0,0,0,0,0,Thursday
2020-04-02,Total,1360,76,9,1445,710,108,72,890,Thursday
2020-04-03,Airport,979,6,24,1009,610,38,87,735,Friday
2020-04-03,Express Rail Link West Kowloon,0,0,0,0,0,0,0,0,Friday
2020-04-03,Hung Hom,0,0,0,0,0,0,0,0,Friday
2020-04-03,Lo Wu,0,0,0,0,0,0,0,0,Friday
2020-04-03,Lok Ma Chau Spur Line,0,0,0,0,0,0,0,0,Friday
2020-04-03,Lok Ma Chau,0,0,0,0,0,0,0,0,Friday
2020-04-03,Man Kam To,0,0,0,0,0,0,0,0,Friday
2020-04-03,Sha Tau Kok,0,0,0,0,0,0,0,0,Friday
2020-04-03,Shenzhen Bay,489,85,0,574,353,96,7,456,Friday
2020-04-03,China Ferry Terminal,0,0,0,0,0,0,0,0,Friday
2020-04-03,Harbour Control,0,0,0,0,0,0,0,0,Friday
2020-04-03,Kai Tak Cruise Terminal,0,0,0,0,0,0,0,0,Friday
2020-04-03,Macau Ferry Terminal,0,0,0,0,0,0,0,0,Friday
2020-04-03,Tuen Mun Ferry Terminal,0,0,0,0,0,0,0,0,Friday
2020-04-03,Total,1527,97,28,1652,1022,141,100,1263,Friday
2020-04-04,Airport,812,3,15,830,403,20,51,474,Saturday
2020-04-04,Express Rail Link West Kowloon,0,0,0,0,0,0,0,0,Saturday
2020-04-04,Hung Hom,0,0,0,0,0,0,0,0,Saturday
2020-04-04,Lo Wu,0,0,0,0,0,0,0,0,Saturday
2020-04-04,Lok Ma Chau Spur Line,0,0,0,0,0,0,0,0,Saturday
2020-04-04,Hong Kong-Zhuhai-Macao Bridge,50,2,3,55,58,6,3,67,Saturday
2020-04-04,Lok Ma Chau,0,0,0,0,0,0,0,0,Saturday
2020-04-04,Man Kam To,0,0,0,0,0,0,0,0,Saturday
2020-04-04,Sha Tau Kok,0,0,0,0,0,0,0,0,Saturday
2020-04-04,Shenzhen Bay,344,73,0,417,296,86,5,387,Saturday
2020-04-04,China Ferry Terminal,0,0,0,0,0,0,0,0,Saturday
2020-04-04,Harbour Control,0,0,0,0,0,0,0,0,Saturday
2020-04-04,Kai Tak Cruise Terminal,0,0,0,0,0,0,0,0,Saturday
2020-04-04,Macau Ferry Terminal,0,0,0,0,0,0,0,0,Saturday
2020-04-04,Tuen Mun Ferry Terminal,0,0,0,0,0,0,0,0,Saturday
2020-04-04,Total,1206,78,18,1302,757,112,59,928,Saturday
2020-04-05,Airport,806,0,7,813,284,10,71,365,Sunday
2020-04-05,Hung Hom,0,0,0,0,0,0,0,0,Sunday
2020-04-05,Lo Wu,0,0,0,0,0,0,0,0,Sunday
2020-04-05,Lok Ma Chau Spur Line,0,0,0,0,0,0,0,0,Sunday
2020-04-05,Hong Kong-Zhuhai-Macao Bridge,226,12,18,256,142,5,18,165,Sunday
2020-04-05,Lok Ma Chau,0,0,0,0,0,0,0,0,Sunday
2020-04-05,Man Kam To,0,0,0,0,0,0,0,0,Sunday
2020-04-05,Sha Tau Kok,0,0,0,0,0,0,0,0,Sunday
2020-04-05,Shenzhen Bay,479,100,1,580,267,80,1,348,Sunday
2020-04-05,China Ferry Terminal,0,0,0,0,0,0,0,0,Sunday
2020-04-05,Harbour Control,0,0,0,0,0,0,0,0,Sunday
2020-04-05,Kai Tak Cruise Terminal,0,0,0,0,0,0,0,0,Sunday
2020-04-05,Macau Ferry Terminal,0,0,0,0,0,0,0,0,Sunday
2020-04-05,Tuen Mun Ferry Terminal,0,0,0,0,0,0,0,0,Sunday
2020-04-05,Total,1511,112,26,1649,693,95,90,878,Sunday
2020-04-06,Airport,833,2,13,848,185,13,43,241,Monday
2020-04-06,Express Rail Link West Kowloon,0,0,0,0,0,0,0,0,Monday
2020-04-06,Hung Hom,0,0,0,0,0,0,0,0,Monday
2020-04-06,Lo Wu,0,0,0,0,0,0,0,0,Monday
2020-04-06,Lok Ma Chau Spur Line,0,0,0,0,0,0,0,0,Monday
2020-04-06,Hong Kong-Zhuhai-Macao Bridge,20,7,1,28,27,2,0,29,Monday
2020-04-06,Lok Ma Chau,0,0,0,0,0,0,0,0,Monday
2020-04-06,Man Kam To,0,0,0,0,0,0,0,0,Monday
2020-04-06,Sha Tau Kok,0,0,0,0,0,0,0,0,Monday
2020-04-06,Shenzhen Bay,498,89,2,589,446,72,6,524,Monday
2020-04-06,China Ferry Terminal,0,0,0,0,0,0,0,0,Monday
2020-04-06,Harbour Control,0,0,0,0,0,0,0,0,Monday
2020-04-06,Kai Tak Cruise Terminal,0,0,0,0,0,0,0,0,Monday
2020-04-06,Macau Ferry Terminal,0,0,0,0,0,0,0,0,Monday
2020-04-06,Tuen Mun Ferry Terminal,0,0,0,0,0,0,0,0,Monday
2020-04-06,Total,1351,98,16,1465,658,87,49,794,Monday
2020-04-07,Airport,347,4,16,367,217,14,43,274,Tuesday
2020-04-07,Hung Hom,0,0,0,0,0,0,0,0,Tuesday
2020-04-07,Lo Wu,0,0,0,0,0,0,0,0,Tuesday
2020-04-07,Lok Ma Chau Spur Line,0,0,0,0,0,0,0,0,Tuesday
2020-04-07,Hong Kong-Zhuhai-Macao Bridge,34,8,0,42,30,5,0,35,Tuesday
2020-04-07,Lok Ma Chau,0,0,0,0,0,0,0,0,Tuesday
2020-04-07,Man Kam To,0,0,0,0,0,0,0,0,Tuesday
2020-04-07,Sha Tau Kok,0,0,0,0,0,0,0,0,Tuesday
2020-04-07,Shenzhen Bay,511,72,0,583,355,107,7,469,Tuesday
2020-04-07,China Ferry Terminal,0,0,0,0,0,0,0,0,Tuesday
2020-04-07,Harbour Control,0,0,0,0,0,0,0,0,Tuesday
2020-04-07,Kai Tak Cruise Terminal,0,0,0,0,0,0,0,0,Tuesday
2020-04-07,Macau Ferry Terminal,0,0,0,0,0,0,0,0,Tuesday
2020-04-07,Tuen Mun Ferry Terminal,0,0,0,0,0,0,0,0,Tuesday
2020-04-07,Total,892,84,16,992,602,126,50,778,Tuesday
2020-04-08,Hung Hom,0,0,0,0,0,0,0,0,Wednesday
2020-04-08,Lo Wu,0,0,0,0,0,0,0,0,Wednesday
2020-04-08,Lok Ma Chau Spur Line,0,0,0,0,0,0,0,0,Wednesday
2020-04-08,Hong Kong-Zhuhai-Macao Bridge,24,3,0,27,24,2,1,27,Wednesday
2020-04-08,Lok Ma Chau,0,0,0,0,0,0,0,0,Wednesday
2020-04-08,Man Kam To,0,0,0,0,0,0,0,0,Wednesday
2020-04-08,Sha Tau Kok,0,0,0,0,0,0,0,0,Wednesday
2020-04-08,Shenzhen Bay,587,96,1,684,314,77,3,394,Wednesday
2020-04-08,China Ferry Terminal,0,0,0,0,0,0,0,0,Wednesday
2020-04-08,Harbour Control,0,0,0,0,0,0,0,0,Wednesday
2020-04-08,Kai Tak Cruise Terminal,0,0,0,0,0,0,0,0,Wednesday
2020-04-08,Macau Ferry Terminal,0,0,0,0,0,0,0,0,Wednesday
2020-04-08,Tuen Mun Ferry Terminal,0,0,0,0,0,0,0,0,Wednesday
2020-04-08,Total,1446,105,25,1576,699,93,63,855,Wednesday
2020-04-09,Airport,439,0,17,456,189,3,39,231,Thursday
2020-04-09,Express Rail Link West Kowloon,0,0,0,0,0,0,0,0,Thursday
2020-04-09,Hung Hom,0,0,0,0,0,0,0,0,Thursday
2020-04-09,Lo Wu,0,0,0,0,0,0,0,0,Thursday
2020-04-09,Lok Ma Chau Spur Line,0,0,0,0,0,0,0,0,Thursday
2020-04-09,Hong Kong-Zhuhai-Macao Bridge,33,8,0,41,16,7,2,25,Thursday
2020-04-09,Lok Ma Chau,0,0,0,0,0,0,0,0,Thursday
2020-04-09,Man Kam To,0,0,0,0,0,0,0,0,Thursday
2020-04-09,Sha Tau Kok,0,0,0,0,0,0,0,0,Thursday
2020-04-09,Shenzhen Bay,584,85,1,670,349,122,3,474,Thursday
2020-04-09,China Ferry Terminal,0,0,0,0,0,0,0,0,Thursday
2020-04-09,Harbour Control,0,0,0,0,0,0,0,0,Thursday
2020-04-09,Kai Tak Cruise Terminal,0,0,0,0,0,0,0,0,Thursday
2020-04-09,Macau Ferry Terminal,0,0,0,0,0,0,0,0,Thursday
2020-04-09,Tuen Mun Ferry Terminal,0,0,0,0,0,0,0,0,Thursday
2020-04-09,Total,1056,93,18,1167,554,132,44,730,Thursday
2020-04-10,Airport,811,9,39,859,503,20,74,597,Friday
2020-04-10,Hung Hom,0,0,0,0,0,0,0,0,Friday
2020-04-10,Lo Wu,0,0,0,0,0,0,0,0,Friday
2020-04-10,Lok Ma Chau Spur Line,0,0,0,0,0,0,0,0,Friday
2020-04-10,Hong Kong-Zhuhai-Macao Bridge,36,6,0,42,16,3,3,22,Friday
2020-04-10,Lok Ma Chau,0,0,0,0,0,0,0,0,Friday
2020-04-10,Man Kam To,0,0,0,0,0,0,0,0,Friday
2020-04-10,Sha Tau Kok,0,0,0,0,0,0,0,0,Friday
2020-04-10,Shenzhen Bay,613,131,1,745,397,129,1,527,Friday
2020-04-10,China Ferry Terminal,0,0,0,0,0,0,0,0,Friday
2020-04-10,Harbour Control,0,0,0,0,0,0,0,0,Friday
2020-04-10,Kai Tak Cruise Terminal,0,0,0,0,0,0,0,0,Friday
2020-04-10,Macau Ferry Terminal,0,0,0,0,0,0,0,0,Friday
2020-04-10,Tuen Mun Ferry Terminal,0,0,0,0,0,0,0,0,Friday
2020-04-10,Total,1460,146,40,1646,916,152,78,1146,Friday
2020-04-11,Airport,220,0,8,228,195,4,33,232,Saturday
2020-04-11,Express Rail Link West Kowloon,0,0,0,0,0,0,0,0,Saturday
2020-04-11,Hung Hom,0,0,0,0,0,0,0,0,Saturday
2020-04-11,Lo Wu,0,0,0,0,0,0,0,0,Saturday
2020-04-11,Lok Ma Chau Spur Line,0,0,0,0,0,0,0,0,Saturday
2020-04-11,Hong Kong-Zhuhai-Macao Bridge,22,9,4,35,23,2,2,27,Saturday
2020-04-11,Lok Ma Chau,0,0,0,0,0,0,0,0,Saturday
2020-04-11,Man Kam To,0,0,0,0,0,0,0,0,Saturday
2020-04-11,Sha Tau Kok,0,0,0,0,0,0,0,0,Saturday
2020-04-11,Shenzhen Bay,590,102,5,697,306,58,2,366,Saturday
2020-04-11,China Ferry Terminal,0,0,0,0,0,0,0,0,Saturday
2020-04-11,Harbour Control,0,0,0,0,0,0,0,0,Saturday
2020-04-11,Macau Ferry Terminal,0,0,0,0,0,0,0,0,Saturday
2020-04-11,Tuen Mun Ferry Terminal,0,0,0,0,0,0,0,0,Saturday
2020-04-11,Total,832,111,17,960,524,64,37,625,Saturday
2020-04-12,Airport,544,4,24,572,352,30,54,436,Sunday
2020-04-12,Express Rail Link West Kowloon,0,0,0,0,0,0,0,0,Sunday
2020-04-12,Hung Hom,0,0,0,0,0,0,0,0,Sunday
2020-04-12,Lo Wu,0,0,0,0,0,0,0,0,Sunday
2020-04-12,Lok Ma Chau Spur Line,0,0,0,0,0,0,0,0,Sunday
2020-04-12,Hong Kong-Zhuhai-Macao Bridge,49,4,1,54,10,0,0,10,Sunday
2020-04-12,Lok Ma Chau,0,0,0,0,0,0,0,0,Sunday
2020-04-12,Man Kam To,0,0,0,0,0,0,0,0,Sunday
2020-04-12,Sha Tau Kok,0,0,0,0,0,0,0,0,Sunday
2020-04-12,Shenzhen Bay,455,99,1,555,258,57,1,316,Sunday
2020-04-12,China Ferry Terminal,0,0,0,0,0,0,0,0,Sunday
2020-04-12,Harbour Control,0,0,0,0,0,0,0,0,Sunday
2020-04-12,Kai Tak Cruise Terminal,0,0,0,0,0,0,0,0,Sunday
2020-04-12,Macau Ferry Terminal,0,0,0,0,0,0,0,0,Sunday
2020-04-12,Tuen Mun Ferry Terminal,0,0,0,0,0,0,0,0,Sunday
2020-04-12,Total,1048,107,26,1181,620,87,55,762,Sunday
2020-04-13,Airport,395,1,18,414,71,6,28,105,Monday
2020-04-13,Hung Hom,0,0,0,0,0,0,0,0,Monday
2020-04-13,Lo Wu,0,0,0,0,0,0,0,0,Monday
2020-04-13,Lok Ma Chau Spur Line,0,0,0,0,0,0,0,0,Monday
2020-04-13,Hong Kong-Zhuhai-Macao Bridge,51,3,0,54,17,1,1,19,Monday
2020-04-13,Lok Ma Chau,0,0,0,0,0,0,0,0,Monday
2020-04-13,Man Kam To,0,0,0,0,0,0,0,0,Monday
2020-04-13,Sha Tau Kok,0,0,0,0,0,0,0,0,Monday
2020-04-13,Shenzhen Bay,511,98,5,614,273,72,4,349,Monday
2020-04-13,China Ferry Terminal,0,0,0,0,0,0,0,0,Monday
2020-04-13,Harbour Control,0,0,0,0,0,0,0,0,Monday
2020-04-13,Kai Tak Cruise Terminal,0,0,0,0,0,0,0,0,Monday
2020-04-13,Tuen Mun Ferry Terminal,0,0,0,0,0,0,0,0,Monday
2020-04-13,Total,957,102,23,1082,361,79,33,473,Monday
2020-04-14,Airport,430,7,10,447,150,10,50,210,Tuesday
2020-04-14,Hung Hom,0,0,0,0,0,0,0,0,Tuesday
2020-04-14,Lo Wu,0,0,0,0,0,0,0,0,Tuesday
2020-04-14,Lok Ma Chau Spur Line,0,0,0,0,0,0,0,0,Tuesday
2020-04-14,Hong Kong-Zhuhai-Macao Bridge,36,4,1,41,21,5,3,29,Tuesday
2020-04-14,Lok Ma Chau,0,0,0,0,0,0,0,0,Tuesday
2020-04-14,Man Kam To,0,0,0,0,0,0,0,0,Tuesday
2020-04-14,Sha Tau Kok,0,0,0,0,0,0,0,0,Tuesday
2020-04-14,Shenzhen Bay,588,70,0,658,275,64,1,340,Tuesday
2020-04-14,China Ferry Terminal,0,0,0,0,0,0,0,0,Tuesday
2020-04-14,Harbour Control,0,0,0,0,0,0,0,0,Tuesday
2020-04-14,Kai Tak Cruise Terminal,0,0,0,0,0,0,0,0,Tuesday
2020-04-14,Macau Ferry Terminal,0,0,0,0,0,0,0,0,Tuesday
2020-04-14,Tuen Mun Ferry Terminal,0,0,0,0,0,0,0,0,Tuesday
2020-04-14,Total,1054,81,11,1146,446,79,54,579,Tuesday
2020-04-15,Airport,481,2,16,499,331,12,60,403,Wednesday
2020-04-15,Express Rail Link West Kowloon,0,0,0,0,0,0,0,0,Wednesday
2020-04-15,Hung Hom,0,0,0,0,0,0,0,0,Wednesday
2020-04-15,Lo Wu,0,0,0,0,0,0,0,0,Wednesday
2020-04-15,Lok Ma Chau Spur Line,0,0,0,0,0,0,0,0,Wednesday
2020-04-15,Hong Kong-Zhuhai-Macao Bridge,33,4,1,38,17,3,0,20,Wednesday
2020-04-15,Lok Ma Chau,0,0,0,0,0,0,0,0,Wednesday
2020-04-15,Man Kam To,0,0,0,0,0,0,0,0,Wednesday
2020-04-15,Sha Tau Kok,0,0,0,0,0,0,0,0,Wednesday
2020-04-15,Shenzhen Bay,613,93,1,707,240,69,2,311,Wednesday
2020-04-15,China Ferry Terminal,0,0,0,0,0,0,0,0,Wednesday
2020-04-15,Harbour Control,0,0,0,0,0,0,0,0,Wednesday
2020-04-15,Macau Ferry Terminal,0,0,0,0,0,0,0,0,Wednesday
2020-04-15,Tuen Mun Ferry Terminal,0,0,0,0,0,0,0,0,Wednesday
2020-04-15,Total,1127,99,18,1244,588,84,62,734,Wednesday
2020-04-16,Airport,397,1,19,417,147,15,24,186,Thursday
2020-04-16,Express Rail Link West Kowloon,0,0,0,0,0,0,0,0,Thursday
2020-04-16,Hung Hom,0,0,0,0,0,0,0,0,Thursday
2020-04-16,Lo Wu,0,0,0,0,0,0,0,0,Thursday
2020-04-16,Lok Ma Chau Spur Line,0,0,0,0,0,0,0,0,Thursday
2020-04-16,Hong Kong-Zhuhai-Macao Bridge,26,2,0,28,11,0,1,12,Thursday
2020-04-16,Lok Ma Chau,0,0,0,0,0,0,0,0,Thursday
2020-04-16,Man Kam To,0,0,0,0,0,0,0,0,Thursday
2020-04-16,Sha Tau Kok,0,0,0,0,0,0,0,0,Thursday
2020-04-16,Shenzhen Bay,527,81,3,611,223,56,0,279,Thursday
2020-04-16,China Ferry Terminal,0,0,0,0,0,0,0,0,Thursday
2020-04-16,Harbour Control,0,0,0,0,0,0,0,0,Thursday
2020-04-16,Kai Tak Cruise Terminal,0,0,0,0,0,0,0,0,Thursday
2020-04-16,Macau Ferry Terminal,0,0,0,0,0,0,0,0,Thursday
2020-04-16,Tuen Mun Ferry Terminal,0,0,0,0,0,0,0,0,Thursday
2020-04-16,Total,950,84,22,1056,381,71,25,477,Thursday
2020-04-17,Airport,820,6,20,846,507,15,80,602,Friday
2020-04-17,Express Rail Link West Kowloon,0,0,0,0,0,0,0,0,Friday
2020-04-17,Hung Hom,0,0,0,0,0,0,0,0,Friday
2020-04-17,Lo Wu,0,0,0,0,0,0,0,0,Friday
2020-04-17,Lok Ma Chau Spur Line,0,0,0,0,0,0,0,0,Friday
2020-04-17,Lok Ma Chau,0,0,0,0,0,0,0,0,Friday
2020-04-17,Man Kam To,0,0,0,0,0,0,0,0,Friday
2020-04-17,Sha Tau Kok,0,0,0,0,0,0,0,0,Friday
2020-04-17,Shenzhen Bay,519,77,4,600,180,54,4,238,Friday
2020-04-17,China Ferry Terminal,0,0,0,0,0,0,0,0,Friday
2020-04-17,Harbour Control,0,0,0,0,0,0,0,0,Friday
2020-04-17,Kai Tak Cruise Terminal,0,0,0,0,0,0,0,0,Friday
2020-04-17,Macau Ferry Terminal,0,0,0,0,0,0,0,0,Friday
2020-04-17,Tuen Mun Ferry Terminal,0,0,0,0,0,0,0,0,Friday
2020-04-17,Total,1363,87,26,1476,714,71,86,871,Friday
2020-04-18,Airport,373,9,14,396,336,19,67,422,Saturday
2020-04-18,Express Rail Link West Kowloon,0,0,0,0,0,0,0,0,Saturday
2020-04-18,Hung Hom,0,0,0,0,0,0,0,0,Saturday
2020-04-18,Lo Wu,0,0,0,0,0,0,0,0,Saturday
2020-04-18,Lok Ma Chau Spur Line,0,0,0,0,0,0,0,0,Saturday
2020-04-18,Hong Kong-Zhuhai-Macao Bridge,33,8,1,42,11,4,6,21,Saturday
2020-04-18,Lok Ma Chau,0,0,0,0,0,0,0,0,Saturday
2020-04-18,Man Kam To,0,0,0,0,0,0,0,0,Saturday
2020-04-18,Sha Tau Kok,0,0,0,0,0,0,0,0,Saturday
2020-04-18,Shenzhen Bay,456,86,0,542,194,65,4,263,Saturday
2020-04-18,China Ferry Terminal,0,0,0,0,0,0,0,0,Saturday
2020-04-18,Harbour Control,0,0,0,0,0,0,0,0,Saturday
2020-04-18,Kai Tak Cruise Terminal,0,0,0,0,0,0,0,0,Saturday
2020-04-18,Macau Ferry Terminal,0,0,0,0,0,0,0,0,Saturday
2020-04-18,Tuen Mun Ferry Terminal,0,0,0,0,0,0,0,0,Saturday
2020-04-18,Total,862,103,15,980,541,88,77,706,Saturday
2020-04-19,Airport,452,2,13,467,273,2,44,319,Sunday
2020-04-19,Hung Hom,0,0,0,0,0,0,0,0,Sunday
2020-04-19,Lo Wu,0,0,0,0,0,0,0,0,Sunday
2020-04-19,Lok Ma Chau Spur Line,0,0,0,0,0,0,0,0,Sunday
2020-04-19,Hong Kong-Zhuhai-Macao Bridge,21,1,0,22,7,0,0,7,Sunday
2020-04-19,Lok Ma Chau,0,0,0,0,0,0,0,0,Sunday
2020-04-19,Man Kam To,0,0,0,0,0,0,0,0,Sunday
2020-04-19,Sha Tau Kok,0,0,0,0,0,0,0,0,Sunday
2020-04-19,Shenzhen Bay,543,96,3,642,168,53,0,221,Sunday
2020-04-19,Harbour Control,0,0,0,0,0,0,0,0,Sunday
2020-04-19,Kai Tak Cruise Terminal,0,0,0,0,0,0,0,0,Sunday
2020-04-19,Macau Ferry Terminal,0,0,0,0,0,0,0,0,Sunday
2020-04-19,Tuen Mun Ferry Terminal,0,0,0,0,0,0,0,0,Sunday
2020-04-19,Total,1016,99,16,1131,448,55,44,547,Sunday
2020-04-20,Airport,460,6,20,486,190,26,25,241,Monday
2020-04-20,Express Rail Link West Kowloon,0,0,0,0,0,0,0,0,Monday
2020-04-20,Hung Hom,0,0,0,0,0,0,0,0,Monday
2020-04-20,Lo Wu,0,0,0,0,0,0,0,0,Monday
2020-04-20,Lok Ma Chau Spur Line,0,0,0,0,0,0,0,0,Monday
2020-04-20,Lok Ma Chau,0,0,0,0,0,0,0,0,Monday
2020-04-20,Man Kam To,0,0,0,0,0,0,0,0,Monday
2020-04-20,Sha Tau Kok,0,0,0,0,0,0,0,0,Monday
2020-04-20,Shenzhen Bay,663,80,2,745,306,73,7,386,Monday
2020-04-20,China Ferry Terminal,0,0,0,0,0,0,0,0,Monday
2020-04-20,Harbour Control,0,0,0,0,0,0,0,0,Monday
2020-04-20,Kai Tak Cruise Terminal,0,0,0,0,0,0,0,0,Monday
2020-04-20,Macau Ferry Terminal,0,0,0,0,0,0,0,0,Monday
2020-04-20,Tuen Mun Ferry Terminal,0,0,0,0,0,0,0,0,Monday
2020-04-20,Total,1163,86,23,1272,508,100,32,640,Monday
2020-04-21,Airport,324,3,22,349,86,3,28,117,Tuesday
2020-04-21,Express Rail Link West Kowloon,0,0,0,0,0,0,0,0,Tuesday
2020-04-21,Hung Hom,0,0,0,0,0,0,0,0,Tuesday
2020-04-21,Lo Wu,0,0,0,0,0,0,0,0,Tuesday
2020-04-21,Lok Ma Chau Spur Line,0,0,0,0,0,0,0,0,Tuesday
2020-04-21,Hong Kong-Zhuhai-Macao Bridge,24,4,0,28,24,5,2,31,Tuesday
2020-04-21,Lok Ma Chau,0,0,0,0,0,0,0,0,Tuesday
2020-04-21,Man Kam To,0,0,0,0,0,0,0,0,Tuesday
2020-04-21,Sha Tau Kok,0,0,0,0,0,0,0,0,Tuesday
2020-04-21,Shenzhen Bay,438,66,1,505,213,37,1,251,Tuesday
2020-04-21,China Ferry Terminal,0,0,0,0,0,0,0,0,Tuesday
2020-04-21,Harbour Control,0,0,0,0,0,0,0,0,Tuesday
2020-04-21,Kai Tak Cruise Terminal,0,0,0,0,0,0,0,0,Tuesday
2020-04-21,Macau Ferry Terminal,0,0,0,0,0,0,0,0,Tuesday
2020-04-21,Tuen Mun Ferry Terminal,0,0,0,0,0,0,0,0,Tuesday
2020-04-21,Total,786,73,23,882,323,45,31,399,Tuesday
2020-04-22,Airport,561,2,29,592,243,6,57,306,Wednesday
2020-04-22,Express Rail Link West Kowloon,0,0,0,0,0,0,0,0,Wednesday
2020-04-22,Hung Hom,0,0,0,0,0,0,0,0,Wednesday
2020-04-22,Lo Wu,0,0,0,0,0,0,0,0,Wednesday
2020-04-22,Lok Ma Chau Spur Line,0,0,0,0,0,0,0,0,Wednesday
2020-04-22,Lok Ma Chau,0,0,0,0,0,0,0,0,Wednesday
2020-04-22,Man Kam To,0,0,0,0,0,0,0,0,Wednesday
2020-04-22,Sha Tau Kok,0,0,0,0,0,0,0,0,Wednesday
2020-04-22,Shenzhen Bay,384,60,3,447,242,44,0,286,Wednesday
2020-04-22,China Ferry Terminal,0,0,0,0,0,0,0,0,Wednesday
2020-04-22,Harbour Control,0,0,0,0,0,0,0,0,Wednesday
2020-04-22,Kai Tak Cruise Terminal,0,0,0,0,0,0,0,0,Wednesday
2020-04-22,Macau Ferry Terminal,0,0,0,0,0,0,0,0,Wednesday
2020-04-22,Tuen Mun Ferry Terminal,0,0,0,0,0,0,0,0,Wednesday
2020-04-22,Total,992,65,33,1090,496,54,58,608,Wednesday
2020-04-23,Airport,241,2,19,262,179,13,59,251,Thursday
2020-04-23,Express Rail Link West Kowloon,0,0,0,0,0,0,0,0,Thursday
2020-04-23,Hung Hom,0,0,0,0,0,0,0,0,Thursday
2020-04-23,Lo Wu,0,0,0,0,0,0,0,0,Thursday
2020-04-23,Lok Ma Chau Spur Line,0,0,0,0,0,0,0,0,Thursday
2020-04-23,Hong Kong-Zhuhai-Macao Bridge,24,1,1,26,8,1,2,11,Thursday
2020-04-23,Lok Ma Chau,0,0,0,0,0,0,0,0,Thursday
2020-04-23,Man Kam To,0,0,0,0,0,0,0,0,Thursday
2020-04-23,Sha Tau Kok,0,0,0,0,0,0,0,0,Thursday
2020-04-23,Shenzhen Bay,351,56,1,408,210,64,1,275,Thursday
2020-04-23,China Ferry Terminal,0,0,0,0,0,0,0,0,Thursday
2020-04-23,Harbour Control,0,0,0,0,0,0,0,0,Thursday
2020-04-23,Kai Tak Cruise Terminal,0,0,0,0,0,0,0,0,Thursday
2020-04-23,Macau Ferry Terminal,0,0,0,0,0,0,0,0,Thursday
2020-04-23,Tuen Mun Ferry Terminal,0,0,0,0,0,0,0,0,Thursday
2020-04-23,Total,616,59,21,696,397,78,62,537,Thursday
2020-04-24,Airport,817,0,26,843,374,5,63,442,Friday
2020-04-24,Hung Hom,0,0,0,0,0,0,0,0,Friday
2020-04-24,Lo Wu,0,0,0,0,0,0,0,0,Friday
2020-04-24,Lok Ma Chau Spur Line,0,0,0,0,0,0,0,0,Friday
2020-04-24,Hong Kong-Zhuhai-Macao Bridge,36,2,0,38,13,2,0,15,Friday
2020-04-24,Lok Ma Chau,0,0,0,0,0,0,0,0,Friday
2020-04-24,Man Kam To,0,0,0,0,0,0,0,0,Friday
2020-04-24,Sha Tau Kok,0,0,0,0,0,0,0,0,Friday
2020-04-24,Shenzhen Bay,397,38,0,435,214,36,2,252,Friday
2020-04-24,China Ferry Terminal,0,0,0,0,0,0,0,0,Friday
2020-04-24,Harbour Control,0,0,0,0,0,0,0,0,Friday
2020-04-24,Kai Tak Cruise Terminal,0,0,0,0,0,0,0,0,Friday
2020-04-24,Macau Ferry Terminal,0,0,0,0,0,0,0,0,Friday
2020-04-24,Tuen Mun Ferry Terminal,0,0,0,0,0,0,0,0,Friday
2020-04-24,Total,1250,40,26,1316,601,43,65,709,Friday
2020-04-25,Airport,378,7,20,405,241,13,41,295,Saturday
2020-04-25,Express Rail Link West Kowloon,0,0,0,0,0,0,0,0,Saturday
2020-04-25,Hung Hom,0,0,0,0,0,0,0,0,Saturday
2020-04-25,Lo Wu,0,0,0,0,0,0,0,0,Saturday
2020-04-25,Lok Ma Chau Spur Line,0,0,0,0,0,0,0,0,Saturday
2020-04-25,Hong Kong-Zhuhai-Macao Bridge,26,1,0,27,19,0,0,19,Saturday
2020-04-25,Man Kam To,0,0,0,0,0,0,0,0,Saturday
2020-04-25,Sha Tau Kok,0,0,0,0,0,0,0,0,Saturday
2020-04-25,Shenzhen Bay,429,67,4,500,208,37,0,245,Saturday
2020-04-25,Harbour Control,0,0,0,0,0,0,0,0,Saturday
2020-04-25,Kai Tak Cruise Terminal,0,0,0,0,0,0,0,0,Saturday
2020-04-25,Macau Ferry Terminal,0,0,0,0,0,0,0,0,Saturday
2020-04-25,Tuen Mun Ferry Terminal,0,0,0,0,0,0,0,0,Saturday
2020-04-25,Total,833,75,24,932,468,50,41,559,Saturday
2020-04-26,Airport,421,1,20,442,333,18,35,386,Sunday
2020-04-26,Express Rail Link West Kowloon,0,0,0,0,0,0,0,0,Sunday
2020-04-26,Hung Hom,0,0,0,0,0,0,0,0,Sunday
2020-04-26,Lo Wu,0,0,0,0,0,0,0,0,Sunday
2020-04-26,Lok Ma Chau Spur Line,0,0,0,0,0,0,0,0,Sunday
2020-04-26,Hong Kong-Zhuhai-Macao Bridge,21,1,0,22,8,1,0,9,Sunday
2020-04-26,Lok Ma Chau,0,0,0,0,0,0,0,0,Sunday
2020-04-26,Man Kam To,0,0,0,0,0,0,0,0,Sunday
2020-04-26,Sha Tau Kok,0,0,0,0,0,0,0,0,Sunday
2020-04-26,Shenzhen Bay,407,80,4,491,184,59,2,245,Sunday
2020-04-26,China Ferry Terminal,0,0,0,0,0,0,0,0,Sunday
2020-04-26,Harbour Control,0,0,0,0,0,0,0,0,Sunday
2020-04-26,Kai Tak Cruise Terminal,0,0,0,0,0,0,0,0,Sunday
2020-04-26,Macau Ferry Terminal,0,0,0,0,0,0,0,0,Sunday
2020-04-26,Tuen Mun Ferry Terminal,0,0,0,0,0,0,0,0,Sunday
2020-04-26,Total,849,82,24,955,525,78,37,640,Sunday
2020-04-27,Airport,411,2,10,423,125,1,22,148,Monday
2020-04-27,Hung Hom,0,0,0,0,0,0,0,0,Monday
2020-04-27,Lo Wu,0,0,0,0,0,0,0,0,Monday
2020-04-27,Lok Ma Chau Spur Line,0,0,0,0,0,0,0,0,Monday
2020-04-27,Hong Kong-Zhuhai-Macao Bridge,33,2,1,36,36,1,3,40,Monday
2020-04-27,Lok Ma Chau,0,0,0,0,0,0,0,0,Monday
2020-04-27,Man Kam To,0,0,0,0,0,0,0,0,Monday
2020-04-27,Sha Tau Kok,0,0,0,0,0,0,0,0,Monday
2020-04-27,Shenzhen Bay,454,70,1,525,577,146,7,730,Monday
2020-04-27,China Ferry Terminal,0,0,0,0,0,0,0,0,Monday
2020-04-27,Harbour Control,0,0,0,0,0,0,0,0,Monday
2020-04-27,Kai Tak Cruise Terminal,0,0,0,0,0,0,0,0,Monday
2020-04-27,Macau Ferry Terminal,0,0,0,0,0,0,0,0,Monday
2020-04-27,Tuen Mun Ferry Terminal,0,0,0,0,0,0,0,0,Monday
2020-04-27,Total,898,74,12,984,738,148,32,918,Monday
2020-04-28,Airport,464,0,64,528,160,1,50,211,Tuesday
2020-04-28,Express Rail Link West Kowloon,0,0,0,0,0,0,0,0,Tuesday
2020-04-28,Hung Hom,0,0,0,0,0,0,0,0,Tuesday
2020-04-28,Lo Wu,0,0,0,0,0,0,0,0,Tuesday
2020-04-28,Lok Ma Chau Spur Line,0,0,0,0,0,0,0,0,Tuesday
2020-04-28,Hong Kong-Zhuhai-Macao Bridge,22,2,1,25,19,1,3,23,Tuesday
2020-04-28,Lok Ma Chau,0,0,0,0,0,0,0,0,Tuesday
2020-04-28,Man Kam To,0,0,0,0,0,0,0,0,Tuesday
2020-04-28,Sha Tau Kok,0,0,0,0,0,0,0,0,Tuesday
2020-04-28,Shenzhen Bay,341,49,1,391,176,25,3,204,Tuesday
2020-04-28,China Ferry Terminal,0,0,0,0,0,0,0,0,Tuesday
2020-04-28,Harbour Control,0,0,0,0,0,0,0,0,Tuesday
2020-04-28,Kai Tak Cruise Terminal,0,0,0,0,0,0,0,0,Tuesday
2020-04-28,Macau Ferry Terminal,0,0,0,0,0,0,0,0,Tuesday
2020-04-28,Total,827,51,66,944,355,27,56,438,Tuesday
2020-04-29,Airport,814,4,15,833,341,6,44,391,Wednesday
2020-04-29,Express Rail Link West Kowloon,0,0,0,0,0,0,0,0,Wednesday
2020-04-29,Hung Hom,0,0,0,0,0,0,0,0,Wednesday
2020-04-29,Lo Wu,0,0,0,0,0,0,0,0,Wednesday
2020-04-29,Lok Ma Chau Spur Line,0,0,0,0,0,0,0,0,Wednesday
2020-04-29,Hong Kong-Zhuhai-Macao Bridge,24,2,0,26,18,1,1,20,Wednesday
2020-04-29,Lok Ma Chau,0,0,0,0,0,0,0,0,Wednesday
2020-04-29,Man Kam To,0,0,0,0,0,0,0,0,Wednesday
2020-04-29,Sha Tau Kok,0,0,0,0,0,0,0,0,Wednesday
2020-04-29,Shenzhen Bay,455,70,2,527,242,23,5,270,Wednesday
2020-04-29,China Ferry Terminal,0,0,0,0,0,0,0,0,Wednesday
2020-04-29,Harbour Control,0,0,0,0,0,0,0,0,Wednesday
2020-04-29,Kai Tak Cruise Terminal,0,0,0,0,0,0,0,0,Wednesday
2020-04-29,Macau Ferry Terminal,0,0,0,0,0,0,0,0,Wednesday
2020-04-29,Tuen Mun Ferry Terminal,0,0,0,0,0,0,0,0,Wednesday
2020-04-29,Total,1293,76,17,1386,601,30,50,681,Wednesday
2020-04-30,Airport,747,5,48,800,254,17,31,302,Thursday
2020-04-30,Express Rail Link West Kowloon,0,0,0,0,0,0,0,0,Thursday
2020-04-30,Hung Hom,0,0,0,0,0,0,0,0,Thursday
2020-04-30,Lo Wu,0,0,0,0,0,0,0,0,Thursday
2020-04-30,Lok Ma Chau Spur Line,0,0,0,0,0,0,0,0,Thursday
2020-04-30,Lok Ma Chau,0,0,0,0,0,0,0,0,Thursday
2020-04-30,Man Kam To,0,0,0,0,0,0,0,0,Thursday
2020-04-30,Sha Tau Kok,0,0,0,0,0,0,0,0,Thursday
2020-04-30,Shenzhen Bay,827,114,2,943,348,70,4,422,Thursday
2020-04-30,China Ferry Terminal,0,0,0,0,0,0,0,0,Thursday
2020-04-30,Harbour Control,0,0,0,0,0,0,0,0,Thursday
2020-04-30,Kai Tak Cruise Terminal,0,0,0,0,0,0,0,0,Thursday
2020-04-30,Macau Ferry Terminal,0,0,0,0,0,0,0,0,Thursday
2020-04-30,Tuen Mun Ferry Terminal,0,0,0,0,0,0,0,0,Thursday
2020-04-30,Total,1611,125,52,1788,633,89,38,760,Thursday
2020-05-01,Airport,837,4,24,865,533,6,98,637,Friday
2020-05-01,Express Rail Link West Kowloon,0,0,0,0,0,0,0,0,Friday
2020-05-01,Hung Hom,0,0,0,0,0,0,0,0,Friday
2020-05-01,Hong Kong-Zhuhai-Macao Bridge,35,5,1,41,17,1,1,19,Friday
2020-05-01,Lok Ma Chau,0,0,0,0,0,0,0,0,Friday
2020-05-01,Man Kam To,0,0,0,0,0,0,0,0,Friday
2020-05-01,Sha Tau Kok,0,0,0,0,0,0,0,0,Friday
2020-05-01,Shenzhen Bay,507,110,5,622,265,56,1,322,Friday
2020-05-01,China Ferry Terminal,0,0,0,0,0,0,0,0,Friday
2020-05-01,Harbour Control,0,0,0,0,0,0,0,0,Friday
2020-05-01,Macau Ferry Terminal,0,0,0,0,0,0,0,0,Friday
2020-05-01,Tuen Mun Ferry Terminal,0,0,0,0,0,0,0,0,Friday
2020-05-01,Total,1379,119,30,1528,815,63,100,978,Friday
2020-05-02,Airport,452,6,39,497,352,4,72,428,Saturday
2020-05-02,Express Rail Link West Kowloon,0,0,0,0,0,0,0,0,Saturday
2020-05-02,Hung Hom,0,0,0,0,0,0,0,0,Saturday
2020-05-02,Lo Wu,0,0,0,0,0,0,0,0,Saturday
2020-05-02,Lok Ma Chau Spur Line,0,0,0,0,0,0,0,0,Saturday
2020-05-02,Hong Kong-Zhuhai-Macao Bridge,34,5,0,39,24,0,0,24,Saturday
2020-05-02,Lok Ma Chau,0,0,0,0,0,0,0,0,Saturday
2020-05-02,Man Kam To,0,0,0,0,0,0,0,0,Saturday
2020-05-02,Sha Tau Kok,0,0,0,0,0,0,0,0,Saturday
2020-05-02,Shenzhen Bay,534,89,0,623,220,27,3,250,Saturday
2020-05-02,China Ferry Terminal,0,0,0,0,0,0,0,0,Saturday
2020-05-02,Harbour Control,0,0,0,0,0,0,0,0,Saturday
2020-05-02,Kai Tak Cruise Terminal,0,0,0,0,0,0,0,0,Saturday
2020-05-02,Macau Ferry Terminal,0,0,0,0,0,0,0,0,Saturday
2020-05-02,Tuen Mun Ferry Terminal,0,0,0,0,0,0,0,0,Saturday
2020-05-02,Total,1020,100,39,1159,596,31,75,702,Saturday
2020-05-03,Airport,713,1,26,740,212,6,44,262,Sunday
2020-05-03,Hung Hom,0,0,0,0,0,0,0,0,Sunday
2020-05-03,Lo Wu,0,0,0,0,0,0,0,0,Sunday
2020-05-03,Lok Ma Chau Spur Line,0,0,0,0,0,0,0,0,Sunday
2020-05-03,Hong Kong-Zhuhai-Macao Bridge,38,1,7,46,10,2,4,16,Sunday
2020-05-03,Lok Ma Chau,0,0,0,0,0,0,0,0,Sunday
2020-05-03,Man Kam To,0,0,0,0,0,0,0,0,Sunday
2020-05-03,Sha Tau Kok,0,0,0,0,0,0,0,0,Sunday
2020-05-03,Shenzhen Bay,719,140,2,861,211,40,2,253,Sunday
2020-05-03,China Ferry Terminal,0,0,0,0,0,0,0,0,Sunday
2020-05-03,Harbour Control,0,0,0,0,0,0,0,0,Sunday
2020-05-03,Kai Tak Cruise Terminal,0,0,0,0,0,0,0,0,Sunday
2020-05-03,Macau Ferry Terminal,0,0,0,0,0,0,0,0,Sunday
2020-05-03,Tuen Mun Ferry Terminal,0,0,0,0,0,0,0,0,Sunday
2020-05-03,Total,1470,142,35,1647,433,48,50,531,Sunday
2020-05-04,Airport,770,10,19,799,251,4,161,416,Monday
2020-05-04,Express Rail Link West Kowloon,0,0,0,0,0,0,0,0,Monday
2020-05-04,Hung Hom,0,0,0,0,0,0,0,0,Monday
2020-05-04,Lo Wu,0,0,0,0,0,0,0,0,Monday
2020-05-04,Lok Ma Chau Spur Line,0,0,0,0,0,0,0,0,Monday
2020-05-04,Hong Kong-Zhuhai-Macao Bridge,50,5,11,66,19,1,0,20,Monday
2020-05-04,Lok Ma Chau,0,0,0,0,0,0,0,0,Monday
2020-05-04,Man Kam To,0,0,0,0,0,0,0,0,Monday
2020-05-04,Sha Tau Kok,0,0,0,0,0,0,0,0,Monday
2020-05-04,Shenzhen Bay,629,79,4,712,288,33,6,327,Monday
2020-05-04,China Ferry Terminal,0,0,0,0,0,0,0,0,Monday
2020-05-04,Harbour Control,0,0,0,0,0,0,0,0,Monday
2020-05-04,Kai Tak Cruise Terminal,0,0,0,0,0,0,0,0,Monday
2020-05-04,Macau Ferry Terminal,0,0,0,0,0,0,0,0,Monday
2020-05-04,Tuen Mun Ferry Terminal,0,0,0,0,0,0,0,0,Monday
2020-05-04,Total,1449,94,34,1577,558,38,167,763,Monday
2020-05-05,Airport,372,3,11,386,138,2,24,164,Tuesday
2020-05-05,Hung Hom,0,0,0,0,0,0,0,0,Tuesday
2020-05-05,Lo Wu,0,0,0,0,0,0,0,0,Tuesday
2020-05-05,Lok Ma Chau Spur Line,0,0,0,0,0,0,0,0,Tuesday
2020-05-05,Hong Kong-Zhuhai-Macao Bridge,49,6,2,57,29,0,2,31,Tuesday
2020-05-05,Lok Ma Chau,0,0,0,0,0,0,0,0,Tuesday
2020-05-05,Man Kam To,0,0,0,0,0,0,0,0,Tuesday
2020-05-05,Sha Tau Kok,0,0,0,0,0,0,0,0,Tuesday
2020-05-05,Shenzhen Bay,587,75,1,663,257,36,12,305,Tuesday
2020-05-05,China Ferry Terminal,0,0,0,0,0,0,0,0,Tuesday
2020-05-05,Harbour Control,0,0,0,0,0,0,0,0,Tuesday
2020-05-05,Kai Tak Cruise Terminal,0,0,0,0,0,0,0,0,Tuesday
2020-05-05,Macau Ferry Terminal,0,0,0,0,0,0,0,0,Tuesday
2020-05-05,Tuen Mun Ferry Terminal,0,0,0,0,0,0,0,0,Tuesday
2020-05-05,Total,1008,84,14,1106,424,38,38,500,Tuesday
2020-05-06,Airport,496,4,13,513,313,9,30,352,Wednesday
2020-05-06,Express Rail Link West Kowloon,0,0,0,0,0,0,0,0,Wednesday
2020-05-06,Hung Hom,0,0,0,0,0,0,0,0,Wednesday
2020-05-06,Lo Wu,0,0,0,0,0,0,0,0,Wednesday
2020-05-06,Lok Ma Chau Spur Line,0,0,0,0,0,0,0,0,Wednesday
2020-05-06,Hong Kong-Zhuhai-Macao Bridge,53,4,6,63,13,2,3,18,Wednesday
2020-05-06,Lok Ma Chau,0,0,0,0,0,0,0,0,Wednesday
2020-05-06,Man Kam To,0,0,0,0,0,0,0,0,Wednesday
2020-05-06,Sha Tau Kok,0,0,0,0,0,0,0,0,Wednesday
2020-05-06,Shenzhen Bay,754,79,1,834,287,43,7,337,Wednesday
2020-05-06,China Ferry Terminal,0,0,0,0,0,0,0,0,Wednesday
2020-05-06,Harbour Control,0,0,0,0,0,0,0,0,Wednesday
2020-05-06,Macau Ferry Terminal,0,0,0,0,0,0,0,0,Wednesday
2020-05-06,Tuen Mun Ferry Terminal,0,0,0,0,0,0,0,0,Wednesday
2020-05-06,Total,1303,87,20,1410,613,54,40,707,Wednesday
2020-05-07,Airport,301,5,5,311,143,3,8,154,Thursday
2020-05-07,Hung Hom,0,0,0,0,0,0,0,0,Thursday
2020-05-07,Lo Wu,0,0,0,0,0,0,0,0,Thursday
2020-05-07,Lok Ma Chau Spur Line,0,0,0,0,0,0,0,0,Thursday
2020-05-07,Hong Kong-Zhuhai-Macao Bridge,52,0,2,54,21,3,0,24,Thursday
2020-05-07,Lok Ma Chau,0,0,0,0,0,0,0,0,Thursday
2020-05-07,Man Kam To,0,0,0,0,0,0,0,0,Thursday
2020-05-07,Sha Tau Kok,0,0,0,0,0,0,0,0,Thursday
2020-05-07,Shenzhen Bay,761,103,2,866,298,69,0,367,Thursday
2020-05-07,China Ferry Terminal,0,0,0,0,0,0,0,0,Thursday
2020-05-07,Harbour Control,0,0,0,0,0,0,0,0,Thursday
2020-05-07,Kai Tak Cruise Terminal,0,0,0,0,0,0,0,0,Thursday
2020-05-07,Macau Ferry Terminal,0,0,0,0,0,0,0,0,Thursday
2020-05-07,Tuen Mun Ferry Terminal,0,0,0,0,0,0,0,0,Thursday
2020-05-07,Total,1114,108,9,1231,462,75,8,545,Thursday
2020-05-08,Airport,1249,13,35,1297,371,9,49,429,Friday
2020-05-08,Hung Hom,0,0,0,0,0,0,0,0,Friday
2020-05-08,Lo Wu,0,0,0,0,0,0,0,0,Friday
2020-05-08,Lok Ma Chau Spur Line,0,0,0,0,0,0,0,0,Friday
2020-05-08,Hong Kong-Zhuhai-Macao Bridge,153,7,9,169,46,1,6,53,Friday
2020-05-08,Lok Ma Chau,0,0,0,0,0,0,0,0,Friday
2020-05-08,Man Kam To,0,0,0,0,0,0,0,0,Friday
2020-05-08,Sha Tau Kok,0,0,0,0,0,0,0,0,Friday
2020-05-08,Shenzhen Bay,1045,137,4,1186,348,67,2,417,Friday
2020-05-08,China Ferry Terminal,0,0,0,0,0,0,0,0,Friday
2020-05-08,Harbour Control,0,0,0,0,0,0,0,0,Friday
2020-05-08,Kai Tak Cruise Terminal,0,0,0,0,0,0,0,0,Friday
2020-05-08,Macau Ferry Terminal,0,0,0,0,0,0,0,0,Friday
2020-05-08,Tuen Mun Ferry Terminal,0,0,0,0,0,0,0,0,Friday
2020-05-08,Total,2447,157,48,2652,765,77,57,899,Friday
2020-05-09,Airport,560,6,63,629,260,14,28,302,Saturday
2020-05-09,Express Rail Link West Kowloon,0,0,0,0,0,0,0,0,Saturday
2020-05-09,Hung Hom,0,0,0,0,0,0,0,0,Saturday
2020-05-09,Lo Wu,0,0,0,0,0,0,0,0,Saturday
2020-05-09,Lok Ma Chau Spur Line,0,0,0,0,0,0,0,0,Saturday
2020-05-09,Hong Kong-Zhuhai-Macao Bridge,144,7,4,155,43,5,1,49,Saturday
2020-05-09,Lok Ma Chau,0,0,0,0,0,0,0,0,Saturday
2020-05-09,Man Kam To,0,0,0,0,0,0,0,0,Saturday
2020-05-09,Sha Tau Kok,0,0,0,0,0,0,0,0,Saturday
2020-05-09,Shenzhen Bay,1056,156,5,1217,237,38,3,278,Saturday
2020-05-09,China Ferry Terminal,0,0,0,0,0,0,0,0,Saturday
2020-05-09,Harbour Control,0,0,0,0,0,0,0,0,Saturday
2020-05-09,Kai Tak Cruise Terminal,0,0,0,0,0,0,0,0,Saturday
2020-05-09,Macau Ferry Terminal,0,0,0,0,0,0,0,0,Saturday
2020-05-09,Tuen Mun Ferry Terminal,0,0,0,0,0,0,0,0,Saturday
2020-05-09,Total,1760,169,72,2001,540,57,32,629,Saturday
2020-05-10,Airport,923,7,41,971,254,7,42,303,Sunday
2020-05-10,Hung Hom,0,0,0,0,0,0,0,0,Sunday
2020-05-10,Lo Wu,0,0,0,0,0,0,0,0,Sunday
2020-05-10,Lok Ma Chau Spur Line,0,0,0,0,0,0,0,0,Sunday
2020-05-10,Hong Kong-Zhuhai-Macao Bridge,126,6,5,137,33,1,3,37,Sunday
2020-05-10,Lok Ma Chau,0,0,0,0,0,0,0,0,Sunday
2020-05-10,Man Kam To,0,0,0,0,0,0,0,0,Sunday
2020-05-10,Sha Tau Kok,0,0,0,0,0,0,0,0,Sunday
2020-05-10,Shenzhen Bay,1783,201,4,1988,233,43,5,281,Sunday
2020-05-10,China Ferry Terminal,0,0,0,0,0,0,0,0,Sunday
2020-05-10,Harbour Control,0,0,0,0,0,0,0,0,Sunday
2020-05-10,Kai Tak Cruise Terminal,0,0,0,0,0,0,0,0,Sunday
2020-05-10,Macau Ferry Terminal,0,0,0,0,0,0,0,0,Sunday
2020-05-10,Tuen Mun Ferry Terminal,0,0,0,0,0,0,0,0,Sunday
2020-05-10,Total,2832,214,50,3096,520,51,50,621,Sunday
2020-05-11,Airport,797,7,30,834,195,8,25,228,Monday
2020-05-11,Express Rail Link West Kowloon,0,0,0,0,0,0,0,0,Monday
2020-05-11,Hung Hom,0,0,0,0,0,0,0,0,Monday
2020-05-11,Lo Wu,0,0,0,0,0,0,0,0,Monday
2020-05-11,Lok Ma Chau Spur Line,0,0,0,0,0,0,0,0,Monday
2020-05-11,Hong Kong-Zhuhai-Macao Bridge,167,3,7,177,34,3,5,42,Monday
2020-05-11,Lok Ma Chau,0,0,0,0,0,0,0,0,Monday
2020-05-11,Man Kam To,0,0,0,0,0,0,0,0,Monday
2020-05-11,Sha Tau Kok,0,0,0,0,0,0,0,0,Monday
2020-05-11,Shenzhen Bay,1886,175,6,2067,454,52,2,508,Monday
2020-05-11,China Ferry Terminal,0,0,0,0,0,0,0,0,Monday
2020-05-11,Harbour Control,0,0,0,0,0,0,0,0,Monday
2020-05-11,Kai Tak Cruise Terminal,0,0,0,0,0,0,0,0,Monday
2020-05-11,Macau Ferry Terminal,0,0,0,0,0,0,0,0,Monday
2020-05-11,Total,2850,185,43,3078,683,63,32,778,Monday
2020-05-12,Airport,452,5,33,490,146,7,34,187,Tuesday
2020-05-12,Express Rail Link West Kowloon,0,0,0,0,0,0,0,0,Tuesday
2020-05-12,Hung Hom,0,0,0,0,0,0,0,0,Tuesday
2020-05-12,Lo Wu,0,0,0,0,0,0,0,0,Tuesday
2020-05-12,Lok Ma Chau Spur Line,0,0,0,0,0,0,0,0,Tuesday
2020-05-12,Hong Kong-Zhuhai-Macao Bridge,180,6,6,192,28,0,0,28,Tuesday
2020-05-12,Lok Ma Chau,0,0,0,0,0,0,0,0,Tuesday
2020-05-12,Man Kam To,0,0,0,0,0,0,0,0,Tuesday
2020-05-12,Sha Tau Kok,0,0,0,0,0,0,0,0,Tuesday
2020-05-12,Shenzhen Bay,1906,184,6,2096,278,36,9,323,Tuesday
2020-05-12,China Ferry Terminal,0,0,0,0,0,0,0,0,Tuesday
2020-05-12,Harbour Control,0,0,0,0,0,0,0,0,Tuesday
2020-05-12,Kai Tak Cruise Terminal,0,0,0,0,0,0,0,0,Tuesday
2020-05-12,Macau Ferry Terminal,0,0,0,0,0,0,0,0,Tuesday
2020-05-12,Total,2538,195,45,2778,452,43,43,538,Tuesday
2020-05-13,Airport,600,13,24,637,368,10,77,455,Wednesday
2020-05-13,Express Rail Link West Kowloon,0,0,0,0,0,0,0,0,Wednesday
2020-05-13,Hung Hom,0,0,0,0,0,0,0,0,Wednesday
2020-05-13,Lo Wu,0,0,0,0,0,0,0,0,Wednesday
2020-05-13,Lok Ma Chau Spur Line,0,0,0,0,0,0,0,0,Wednesday
2020-05-13,Hong Kong-Zhuhai-Macao Bridge,118,5,1,124,35,0,4,39,Wednesday
2020-05-13,Lok Ma Chau,0,0,0,0,0,0,0,0,Wednesday
2020-05-13,Man Kam To,0,0,0,0,0,0,0,0,Wednesday
2020-05-13,Sha Tau Kok,0,0,0,0,0,0,0,0,Wednesday
2020-05-13,Shenzhen Bay,1149,112,8,1269,265,66,1,332,Wednesday
2020-05-13,Harbour Control,0,0,0,0,0,0,0,0,Wednesday
2020-05-13,Kai Tak Cruise Terminal,0,0,0,0,0,0,0,0,Wednesday
2020-05-13,Macau Ferry Terminal,0,0,0,0,0,0,0,0,Wednesday
2020-05-13,Tuen Mun Ferry Terminal,0,0,0,0,0,0,0,0,Wednesday
2020-05-13,Total,1867,130,33,2030,668,76,82,826,Wednesday
2020-05-14,Airport,597,3,32,632,187,2,41,230,Thursday
2020-05-14,Express Rail Link West Kowloon,0,0,0,0,0,0,0,0,Thursday
2020-05-14,Hung Hom,0,0,0,0,0,0,0,0,Thursday
2020-05-14,Lo Wu,0,0,0,0,0,0,0,0,Thursday
2020-05-14,Lok Ma Chau Spur Line,0,0,0,0,0,0,0,0,Thursday
2020-05-14,Hong Kong-Zhuhai-Macao Bridge,119,5,11,135,41,0,5,46,Thursday
2020-05-14,Lok Ma Chau,0,0,0,0,0,0,0,0,Thursday
2020-05-14,Man Kam To,0,0,0,0,0,0,0,0,Thursday
2020-05-14,Sha Tau Kok,0,0,0,0,0,0,0,0,Thursday
2020-05-14,Shenzhen Bay,777,122,4,903,298,41,29,368,Thursday
2020-05-14,China Ferry Terminal,0,0,0,0,0,0,0,0,Thursday
2020-05-14,Harbour Control,0,0,0,0,0,0,0,0,Thursday
2020-05-14,Kai Tak Cruise Terminal,0,0,0,0,0,0,0,0,Thursday
2020-05-14,Macau Ferry Terminal,0,0,0,0,0,0,0,0,Thursday
2020-05-14,Tuen Mun Ferry Terminal,0,0,0,0,0,0,0,0,Thursday
2020-05-14,Total,1493,130,47,1670,526,43,75,644,Thursday
2020-05-15,Airport,939,3,31,973,251,3,60,314,Friday
2020-05-15,Hung Hom,0,0,0,0,0,0,0,0,Friday
2020-05-15,Lo Wu,0,0,0,0,0,0,0,0,Friday
2020-05-15,Lok Ma Chau Spur Line,0,0,0,0,0,0,0,0,Friday
2020-05-15,Hong Kong-Zhuhai-Macao Bridge,102,9,8,119,51,5,9,65,Friday
2020-05-15,Lok Ma Chau,0,0,0,0,0,0,0,0,Friday
2020-05-15,Man Kam To,0,0,0,0,0,0,0,0,Friday
2020-05-15,Sha Tau Kok,0,0,0,0,0,0,0,0,Friday
2020-05-15,Shenzhen Bay,885,133,5,1023,293,55,1,349,Friday
2020-05-15,China Ferry Terminal,0,0,0,0,0,0,0,0,Friday
2020-05-15,Harbour Control,0,0,0,0,0,0,0,0,Friday
2020-05-15,Kai Tak Cruise Terminal,0,0,0,0,0,0,0,0,Friday
2020-05-15,Macau Ferry Terminal,0,0,0,0,0,0,0,0,Friday
2020-05-15,Tuen Mun Ferry Terminal,0,0,0,0,0,0,0,0,Friday
2020-05-15,Total,1926,145,44,2115,595,63,70,728,Friday
2020-05-16,Airport,891,13,149,1053,337,5,77,419,Saturday
2020-05-16,Express Rail Link West Kowloon,0,0,0,0,0,0,0,0,Saturday
2020-05-16,Hung Hom,0,0,0,0,0,0,0,0,Saturday
2020-05-16,Lo Wu,0,0,0,0,0,0,0,0,Saturday
2020-05-16,Lok Ma Chau Spur Line,0,0,0,0,0,0,0,0,Saturday
2020-05-16,Hong Kong-Zhuhai-Macao Bridge,80,6,7,93,46,3,3,52,Saturday
2020-05-16,Lok Ma Chau,0,0,0,0,0,0,0,0,Saturday
2020-05-16,Man Kam To,0,0,0,0,0,0,0,0,Saturday
2020-05-16,Sha Tau Kok,0,0,0,0,0,0,0,0,Saturday
2020-05-16,Shenzhen Bay,950,155,9,1114,311,45,3,359,Saturday
2020-05-16,China Ferry Terminal,0,0,0,0,0,0,0,0,Saturday
2020-05-16,Harbour Control,0,0,0,0,0,0,0,0,Saturday
2020-05-16,Kai Tak Cruise Terminal,0,0,0,0,0,0,0,0,Saturday
2020-05-16,Macau Ferry Terminal,0,0,0,0,0,0,0,0,Saturday
2020-05-16,Tuen Mun Ferry Terminal,0,0,0,0,0,0,0,0,Saturday
2020-05-16,Total,1921,174,165,2260,694,53,83,830,Saturday
2020-05-17,Airport,873,6,55,934,221,7,61,289,Sunday
2020-05-17,Hung Hom,0,0,0,0,0,0,0,0,Sunday
2020-05-17,Lo Wu,0,0,0,0,0,0,0,0,Sunday
2020-05-17,Lok Ma Chau Spur Line,0,0,0,0,0,0,0,0,Sunday
2020-05-17,Hong Kong-Zhuhai-Macao Bridge,110,5,3,118,30,4,1,35,Sunday
2020-05-17,Lok Ma Chau,0,0,0,0,0,0,0,0,Sunday
2020-05-17,Man Kam To,0,0,0,0,0,0,0,0,Sunday
2020-05-17,Sha Tau Kok,0,0,0,0,0,0,0,0,Sunday
2020-05-17,Shenzhen Bay,1169,182,10,1361,195,40,1,236,Sunday
2020-05-17,China Ferry Terminal,0,0,0,0,0,0,0,0,Sunday
2020-05-17,Harbour Control,0,0,0,0,0,0,0,0,Sunday
2020-05-17,Kai Tak Cruise Terminal,0,0,0,0,0,0,0,0,Sunday
2020-05-17,Macau Ferry Terminal,0,0,0,0,0,0,0,0,Sunday
2020-05-17,Tuen Mun Ferry Terminal,0,0,0,0,0,0,0,0,Sunday
2020-05-17,Total,2152,193,68,2413,446,51,63,560,Sunday
2020-05-18,Airport,997,6,39,1042,261,9,62,332,Monday
2020-05-18,Express Rail Link West Kowloon,0,0,0,0,0,0,0,0,Monday
2020-05-18,Hung Hom,0,0,0,0,0,0,0,0,Monday
2020-05-18,Lo Wu,0,0,0,0,0,0,0,0,Monday
2020-05-18,Lok Ma Chau Spur Line,0,0,0,0,0,0,0,0,Monday
2020-05-18,Hong Kong-Zhuhai-Macao Bridge,84,6,14,104,26,0,2,28,Monday
2020-05-18,Lok Ma Chau,0,0,0,0,0,0,0,0,Monday
2020-05-18,Man Kam To,0,0,0,0,0,0,0,0,Monday
2020-05-18,Sha Tau Kok,0,0,0,0,0,0,0,0,Monday
2020-05-18,Shenzhen Bay,938,125,13,1076,348,39,2,389,Monday
2020-05-18,China Ferry Terminal,0,0,0,0,0,0,0,0,Monday
2020-05-18,Kai Tak Cruise Terminal,0,0,0,0,0,0,0,0,Monday
2020-05-18,Macau Ferry Terminal,0,0,0,0,0,0,0,0,Monday
2020-05-18,Tuen Mun Ferry Terminal,0,0,0,0,0,0,0,0,Monday
2020-05-18,Total,2019,137,66,2222,635,48,66,749,Monday
2020-05-19,Airport,385,0,14,399,144,2,18,164,Tuesday
2020-05-19,Express Rail Link West Kowloon,0,0,0,0,0,0,0,0,Tuesday
2020-05-19,Hung Hom,0,0,0,0,0,0,0,0,Tuesday
2020-05-19,Lo Wu,0,0,0,0,0,0,0,0,Tuesday
2020-05-19,Lok Ma Chau Spur Line,0,0,0,0,0,0,0,0,Tuesday
2020-05-19,Lok Ma Chau,0,0,0,0,0,0,0,0,Tuesday
2020-05-19,Man Kam To,0,0,0,0,0,0,0,0,Tuesday
2020-05-19,Sha Tau Kok,0,0,0,0,0,0,0,0,Tuesday
2020-05-19,Shenzhen Bay,889,115,8,1012,454,37,5,496,Tuesday
2020-05-19,China Ferry Terminal,0,0,0,0,0,0,0,0,Tuesday
2020-05-19,Harbour Control,0,0,0,0,0,0,0,0,Tuesday
2020-05-19,Kai Tak Cruise Terminal,0,0,0,0,0,0,0,0,Tuesday
2020-05-19,Macau Ferry Terminal,0,0,0,0,0,0,0,0,Tuesday
2020-05-19,Tuen Mun Ferry Terminal,0,0,0,0,0,0,0,0,Tuesday
2020-05-19,Total,1342,120,32,1494,618,40,24,682,Tuesday
2020-05-20,Airport,787,5,20,812,230,8,26,264,Wednesday
2020-05-20,Express Rail Link West Kowloon,0,0,0,0,0,0,0,0,Wednesday
2020-05-20,Hung Hom,0,0,0,0,0,0,0,0,Wednesday
2020-05-20,Lo Wu,0,0,0,0,0,0,0,0,Wednesday
2020-05-20,Lok Ma Chau Spur Line,0,0,0,0,0,0,0,0,Wednesday
2020-05-20,Hong Kong-Zhuhai-Macao Bridge,70,9,6,85,22,3,1,26,Wednesday
2020-05-20,Lok Ma Chau,0,0,0,0,0,0,0,0,Wednesday
2020-05-20,Man Kam To,0,0,0,0,0,0,0,0,Wednesday
2020-05-20,Sha Tau Kok,0,0,0,0,0,0,0,0,Wednesday
2020-05-20,Shenzhen Bay,1019,135,13,1167,262,41,1,304,Wednesday
2020-05-20,China Ferry Terminal,0,0,0,0,0,0,0,0,Wednesday
2020-05-20,Harbour Control,0,0,0,0,0,0,0,0,Wednesday
2020-05-20,Kai Tak Cruise Terminal,0,0,0,0,0,0,0,0,Wednesday
2020-05-20,Macau Ferry Terminal,0,0,0,0,0,0,0,0,Wednesday
2020-05-20,Tuen Mun Ferry Terminal,0,0,0,0,0,0,0,0,Wednesday
2020-05-20,Total,1876,149,39,2064,514,52,28,594,Wednesday
2020-05-21,Airport,474,8,30,512,147,8,32,187,Thursday
2020-05-21,Hung Hom,0,0,0,0,0,0,0,0,Thursday
2020-05-21,Lo Wu,0,0,0,0,0,0,0,0,Thursday
2020-05-21,Lok Ma Chau Spur Line,0,0,0,0,0,0,0,0,Thursday
2020-05-21,Hong Kong-Zhuhai-Macao Bridge,106,4,5,115,23,1,2,26,Thursday
2020-05-21,Lok Ma Chau,0,0,0,0,0,0,0,0,Thursday
2020-05-21,Man Kam To,0,0,0,0,0,0,0,0,Thursday
2020-05-21,Sha Tau Kok,0,0,0,0,0,0,0,0,Thursday
2020-05-21,Shenzhen Bay,1121,127,9,1257,256,79,1,336,Thursday
2020-05-21,China Ferry Terminal,0,0,0,0,0,0,0,0,Thursday
2020-05-21,Harbour Control,0,0,0,0,0,0,0,0,Thursday
2020-05-21,Kai Tak Cruise Terminal,0,0,0,0,0,0,0,0,Thursday
2020-05-21,Macau Ferry Terminal,0,0,0,0,0,0,0,0,Thursday
2020-05-21,Tuen Mun Ferry Terminal,0,0,0,0,0,0,0,0,Thursday
2020-05-21,Total,1701,139,44,1884,426,88,35,549,Thursday
2020-05-22,Airport,1089,7,31,1127,336,4,55,395,Friday
2020-05-22,Express Rail Link West Kowloon,0,0,0,0,0,0,0,0,Friday
2020-05-22,Hung Hom,0,0,0,0,0,0,0,0,Friday
2020-05-22,Lo Wu,0,0,0,0,0,0,0,0,Friday
2020-05-22,Lok Ma Chau Spur Line,0,0,0,0,0,0,0,0,Friday
2020-05-22,Hong Kong-Zhuhai-Macao Bridge,69,4,4,77,31,1,1,33,Friday
2020-05-22,Lok Ma Chau,0,0,0,0,0,0,0,0,Friday
2020-05-22,Man Kam To,0,0,0,0,0,0,0,0,Friday
2020-05-22,Sha Tau Kok,0,0,0,0,0,0,0,0,Friday
2020-05-22,Shenzhen Bay,1121,154,17,1292,300,70,1,371,Friday
2020-05-22,China Ferry Terminal,0,0,0,0,0,0,0,0,Friday
2020-05-22,Harbour Control,0,0,0,0,0,0,0,0,Friday
2020-05-22,Kai Tak Cruise Terminal,0,0,0,0,0,0,0,0,Friday
2020-05-22,Macau Ferry Terminal,0,0,0,0,0,0,0,0,Friday
2020-05-22,Tuen Mun Ferry Terminal,0,0,0,0,0,0,0,0,Friday
2020-05-22,Total,2279,165,52,2496,667,75,57,799,Friday
2020-05-23,Airport,534,5,102,641,202,12,35,249,Saturday
2020-05-23,Hung Hom,0,0,0,0,0,0,0,0,Saturday
2020-05-23,Lo Wu,0,0,0,0,0,0,0,0,Saturday
2020-05-23,Lok Ma Chau Spur Line,0,0,0,0,0,0,0,0,Saturday
2020-05-23,Hong Kong-Zhuhai-Macao Bridge,118,12,3,133,10,1,6,17,Saturday
2020-05-23,Lok Ma Chau,0,0,0,0,0,0,0,0,Saturday
2020-05-23,Man Kam To,0,0,0,0,0,0,0,0,Saturday
2020-05-23,Sha Tau Kok,0,0,0,0,0,0,0,0,Saturday
2020-05-23,Shenzhen Bay,1802,270,11,2083,210,39,11,260,Saturday
2020-05-23,China Ferry Terminal,0,0,0,0,0,0,0,0,Saturday
2020-05-23,Harbour Control,0,0,0,0,0,0,0,0,Saturday
2020-05-23,Kai Tak Cruise Terminal,0,0,0,0,0,0,0,0,Saturday
2020-05-23,Macau Ferry Terminal,0,0,0,0,0,0,0,0,Saturday
2020-05-23,Tuen Mun Ferry Terminal,0,0,0,0,0,0,0,0,Saturday
2020-05-23,Total,2454,287,116,2857,422,52,52,526,Saturday
2020-05-24,Airport,1048,10,38,1096,237,9,40,286,Sunday
2020-05-24,Express Rail Link West Kowloon,0,0,0,0,0,0,0,0,Sunday
2020-05-24,Hung Hom,0,0,0,0,0,0,0,0,Sunday
2020-05-24,Lo Wu,0,0,0,0,0,0,0,0,Sunday
2020-05-24,Lok Ma Chau Spur Line,0,0,0,0,0,0,0,0,Sunday
2020-05-24,Hong Kong-Zhuhai-Macao Bridge,123,15,2,140,27,0,2,29,Sunday
2020-05-24,Lok Ma Chau,0,0,0,0,0,0,0,0,Sunday
2020-05-24,Sha Tau Kok,0,0,0,0,0,0,0,0,Sunday
2020-05-24,Shenzhen Bay,2458,439,14,2911,210,35,3,248,Sunday
2020-05-24,China Ferry Terminal,0,0,0,0,0,0,0,0,Sunday
2020-05-24,Harbour Control,0,0,0,0,0,0,0,0,Sunday
2020-05-24,Kai Tak Cruise Terminal,0,0,0,0,0,0,0,0,Sunday
2020-05-24,Macau Ferry Terminal,0,0,0,0,0,0,0,0,Sunday
2020-05-24,Tuen Mun Ferry Terminal,0,0,0,0,0,0,0,0,Sunday
2020-05-24,Total,3629,464,54,4147,474,44,45,563,Sunday
2020-05-25,Airport,673,6,46,725,156,4,23,183,Monday
2020-05-25,Hung Hom,0,0,0,0,0,0,0,0,Monday
2020-05-25,Lo Wu,0,0,0,0,0,0,0,0,Monday
2020-05-25,Lok Ma Chau Spur Line,0,0,0,0,0,0,0,0,Monday
2020-05-25,Hong Kong-Zhuhai-Macao Bridge,99,8,8,115,48,0,3,51,Monday
2020-05-25,Lok Ma Chau,0,0,0,0,0,0,0,0,Monday
2020-05-25,Man Kam To,0,0,0,0,0,0,0,0,Monday
2020-05-25,Sha Tau Kok,0,0,0,0,0,0,0,0,Monday
2020-05-25,Shenzhen Bay,1469,255,6,1730,376,18,6,400,Monday
2020-05-25,China Ferry Terminal,0,0,0,0,0,0,0,0,Monday
2020-05-25,Harbour Control,0,0,0,0,0,0,0,0,Monday
2020-05-25,Kai Tak Cruise Terminal,0,0,0,0,0,0,0,0,Monday
2020-05-25,Macau Ferry Terminal,0,0,0,0,0,0,0,0,Monday
2020-05-25,Tuen Mun Ferry Terminal,0,0,0,0,0,0,0,0,Monday
2020-05-25,Total,2241,269,60,2570,580,22,32,634,Monday
2020-05-26,Airport,543,2,37,582,252,3,53,308,Tuesday
2020-05-26,Express Rail Link West Kowloon,0,0,0,0,0,0,0,0,Tuesday
2020-05-26,Hung Hom,0,0,0,0,0,0,0,0,Tuesday
2020-05-26,Lo Wu,0,0,0,0,0,0,0,0,Tuesday
2020-05-26,Lok Ma Chau Spur Line,0,0,0,0,0,0,0,0,Tuesday
2020-05-26,Hong Kong-Zhuhai-Macao Bridge,60,11,8,79,23,0,2,25,Tuesday
2020-05-26,Lok Ma Chau,0,0,0,0,0,0,0,0,Tuesday
2020-05-26,Man Kam To,0,0,0,0,0,0,0,0,Tuesday
2020-05-26,Sha Tau Kok,0,0,0,0,0,0,0,0,Tuesday
2020-05-26,Shenzhen Bay,790,142,12,944,213,31,2,246,Tuesday
2020-05-26,China Ferry Terminal,0,0,0,0,0,0,0,0,Tuesday
2020-05-26,Harbour Control,0,0,0,0,0,0,0,0,Tuesday
2020-05-26,Macau Ferry Terminal,0,0,0,0,0,0,0,0,Tuesday
2020-05-26,Tuen Mun Ferry Terminal,0,0,0,0,0,0,0,0,Tuesday
2020-05-26,Total,1393,155,57,1605,488,34,57,579,Tuesday
2020-05-27,Airport,485,4,21,510,331,9,149,489,Wednesday
2020-05-27,Express Rail Link West Kowloon,0,0,0,0,0,0,0,0,Wednesday
2020-05-27,Hung Hom,0,0,0,0,0,0,0,0,Wednesday
2020-05-27,Lo Wu,0,0,0,0,0,0,0,0,Wednesday
2020-05-27,Lok Ma Chau Spur Line,0,0,0,0,0,0,0,0,Wednesday
2020-05-27,Hong Kong-Zhuhai-Macao Bridge,51,9,5,65,17,0,0,17,Wednesday
2020-05-27,Lok Ma Chau,0,0,0,0,0,0,0,0,Wednesday
2020-05-27,Man Kam To,0,0,0,0,0,0,0,0,Wednesday
2020-05-27,Sha Tau Kok,0,0,0,0,0,0,0,0,Wednesday
2020-05-27,Shenzhen Bay,694,107,4,805,247,34,0,281,Wednesday
2020-05-27,China Ferry Terminal,0,0,0,0,0,0,0,0,Wednesday
2020-05-27,Harbour Control,0,0,0,0,0,0,0,0,Wednesday
2020-05-27,Kai Tak Cruise Terminal,0,0,0,0,0,0,0,0,Wednesday
2020-05-27,Macau Ferry Terminal,0,0,0,0,0,0,0,0,Wednesday
2020-05-27,Tuen Mun Ferry Terminal,0,0,0,0,0,0,0,0,Wednesday
2020-05-27,Total,1230,120,30,1380,595,43,149,787,Wednesday
2020-05-28,Airport,661,2,29,692,195,7,71,273,Thursday
2020-05-28,Hung Hom,0,0,0,0,0,0,0,0,Thursday
2020-05-28,Lo Wu,0,0,0,0,0,0,0,0,Thursday
2020-05-28,Lok Ma Chau Spur Line,0,0,0,0,0,0,0,0,Thursday
2020-05-28,Hong Kong-Zhuhai-Macao Bridge,39,0,41,80,17,0,0,17,Thursday
2020-05-28,Lok Ma Chau,0,0,0,0,0,0,0,0,Thursday
2020-05-28,Man Kam To,0,0,0,0,0,0,0,0,Thursday
2020-05-28,Sha Tau Kok,0,0,0,0,0,0,0,0,Thursday
2020-05-28,Shenzhen Bay,676,114,10,800,216,27,2,245,Thursday
2020-05-28,China Ferry Terminal,0,0,0,0,0,0,0,0,Thursday
2020-05-28,Harbour Control,0,0,0,0,0,0,0,0,Thursday
2020-05-28,Kai Tak Cruise Terminal,0,0,0,0,0,0,0,0,Thursday
2020-05-28,Macau Ferry Terminal,0,0,0,0,0,0,0,0,Thursday
2020-05-28,Tuen Mun Ferry Terminal,0,0,0,0,0,0,0,0,Thursday
2020-05-28,Total,1376,116,80,1572,428,34,73,535,Thursday
2020-05-29,Airport,923,4,22,949,264,2,65,331,Friday
2020-05-29,Express Rail Link West Kowloon,0,0,0,0,0,0,0,0,Friday
2020-05-29,Hung Hom,0,0,0,0,0,0,0,0,Friday
2020-05-29,Lo Wu,0,0,0,0,0,0,0,0,Friday
2020-05-29,Lok Ma Chau Spur Line,0,0,0,0,0,0,0,0,Friday
2020-05-29,Hong Kong-Zhuhai-Macao Bridge,71,4,15,90,13,0,3,16,Friday
2020-05-29,Lok Ma Chau,0,0,0,0,0,0,0,0,Friday
2020-05-29,Man Kam To,0,0,0,0,0,0,0,0,Friday
2020-05-29,Sha Tau Kok,0,0,0,0,0,0,0,0,Friday
2020-05-29,Shenzhen Bay,695,106,8,809,209,24,53,286,Friday
2020-05-29,China Ferry Terminal,0,0,0,0,0,0,0,0,Friday
2020-05-29,Harbour Control,0,0,0,0,0,0,0,0,Friday
2020-05-29,Kai Tak Cruise Terminal,0,0,0,0,0,0,0,0,Friday
2020-05-29,Macau Ferry Terminal,0,0,0,0,0,0,0,0,Friday
2020-05-29,Tuen Mun Ferry Terminal,0,0,0,0,0,0,0,0,Friday
2020-05-29,Total,1689,114,45,1848,486,26,121,633,Friday
2020-05-30,Airport,599,7,35,641,414,7,48,469,Saturday
2020-05-30,Hung Hom,0,0,0,0,0,0,0,0,Saturday
2020-05-30,Lo Wu,0,0,0,0,0,0,0,0,Saturday
2020-05-30,Hong Kong-Zhuhai-Macao Bridge,57,5,2,64,16,1,1,18,Saturday
2020-05-30,Lok Ma Chau,0,0,0,0,0,0,0,0,Saturday
2020-05-30,Man Kam To,0,0,0,0,0,0,0,0,Saturday
2020-05-30,Sha Tau Kok,0,0,0,0,0,0,0,0,Saturday
2020-05-30,Shenzhen Bay,985,149,12,1146,133,37,45,215,Saturday
2020-05-30,China Ferry Terminal,0,0,0,0,0,0,0,0,Saturday
2020-05-30,Harbour Control,0,0,0,0,0,0,0,0,Saturday
2020-05-30,Kai Tak Cruise Terminal,0,0,0,0,0,0,0,0,Saturday
2020-05-30,Macau Ferry Terminal,0,0,0,0,0,0,0,0,Saturday
2020-05-30,Tuen Mun Ferry Terminal,0,0,0,0,0,0,0,0,Saturday
2020-05-30,Total,1641,161,49,1851,563,45,94,702,Saturday
2020-05-31,Airport,839,8,41,888,191,4,38,233,Sunday
2020-05-31,Hung Hom,0,0,0,0,0,0,0,0,Sunday
2020-05-31,Lo Wu,0,0,0,0,0,0,0,0,Sunday
2020-05-31,Lok Ma Chau Spur Line,0,0,0,0,0,0,0,0,Sunday
2020-05-31,Hong Kong-Zhuhai-Macao Bridge,83,11,6,100,17,0,0,17,Sunday
2020-05-31,Lok Ma Chau,0,0,0,0,0,0,0,0,Sunday
2020-05-31,Man Kam To,0,0,0,0,0,0,0,0,Sunday
2020-05-31,Sha Tau Kok,0,0,0,0,0,0,0,0,Sunday
2020-05-31,Shenzhen Bay,1304,278,11,1593,156,21,17,194,Sunday
2020-05-31,China Ferry Terminal,0,0,0,0,0,0,0,0,Sunday
2020-05-31,Harbour Control,0,0,0,0,0,0,0,0,Sunday
2020-05-31,Kai Tak Cruise Terminal,0,0,0,0,0,0,0,0,Sunday
2020-05-31,Macau Ferry Terminal,0,0,0,0,0,0,0,0,Sunday
2020-05-31,Tuen Mun Ferry Terminal,0,0,0,0,0,0,0,0,Sunday
2020-05-31,Total,2226,297,58,2581,364,25,55,444,Sunday
2020-06-01,Airport,760,9,61,830,253,1,40,294,Monday
2020-06-01,Express Rail Link West Kowloon,0,0,0,0,0,0,0,0,Monday
2020-06-01,Hung Hom,0,0,0,0,0,0,0,0,Monday
2020-06-01,Lo Wu,0,0,0,0,0,0,0,0,Monday
2020-06-01,Lok Ma Chau Spur Line,0,0,0,0,0,0,0,0,Monday
2020-06-01,Hong Kong-Zhuhai-Macao Bridge,86,10,4,100,40,3,3,46,Monday
2020-06-01,Lok Ma Chau,0,0,0,0,0,0,0,0,Monday
2020-06-01,Man Kam To,0,0,0,0,0,0,0,0,Monday
2020-06-01,Sha Tau Kok,0,0,0,0,0,0,0,0,Monday
2020-06-01,Shenzhen Bay,984,166,15,1165,357,25,9,391,Monday
2020-06-01,China Ferry Terminal,0,0,0,0,0,0,0,0,Monday
2020-06-01,Harbour Control,0,0,0,0,0,0,0,0,Monday
2020-06-01,Kai Tak Cruise Terminal,0,0,0,0,0,0,0,0,Monday
2020-06-01,Macau Ferry Terminal,0,0,0,0,0,0,0,0,Monday
2020-06-01,Tuen Mun Ferry Terminal,0,0,0,0,0,0,0,0,Monday
2020-06-01,Total,1830,185,80,2095,650,29,52,731,Monday
2020-06-02,Airport,1150,4,52,1206,367,2,110,479,Tuesday
2020-06-02,Hung Hom,0,0,0,0,0,0,0,0,Tuesday
2020-06-02,Lo Wu,0,0,0,0,0,0,0,0,Tuesday
2020-06-02,Lok Ma Chau Spur Line,0,0,0,0,0,0,0,0,Tuesday
2020-06-02,Hong Kong-Zhuhai-Macao Bridge,70,4,4,78,32,1,3,36,Tuesday
2020-06-02,Lok Ma Chau,0,0,0,0,0,0,0,0,Tuesday
2020-06-02,Man Kam To,0,0,0,0,0,0,0,0,Tuesday
2020-06-02,Sha Tau Kok,0,0,0,0,0,0,0,0,Tuesday
2020-06-02,Shenzhen Bay,576,108,17,701,267,30,4,301,Tuesday
2020-06-02,China Ferry Terminal,0,0,0,0,0,0,0,0,Tuesday
2020-06-02,Harbour Control,0,0,0,0,0,0,0,0,Tuesday
2020-06-02,Kai Tak Cruise Terminal,0,0,0,0,0,0,0,0,Tuesday
2020-06-02,Macau Ferry Terminal,0,0,0,0,0,0,0,0,Tuesday
2020-06-02,Tuen Mun Ferry Terminal,0,0,0,0,0,0,0,0,Tuesday
2020-06-02,Total,1796,116,73,1985,666,33,117,816,Tuesday
2020-06-03,Airport,918,5,40,963,404,12,120,536,Wednesday
2020-06-03,Express Rail Link West Kowloon,0,0,0,0,0,0,0,0,Wednesday
2020-06-03,Hung Hom,0,0,0,0,0,0,0,0,Wednesday
2020-06-03,Lo Wu,0,0,0,0,0,0,0,0,Wednesday
2020-06-03,Lok Ma Chau Spur Line,0,0,0,0,0,0,0,0,Wednesday
2020-06-03,Hong Kong-Zhuhai-Macao Bridge,97,6,4,107,64,0,2,66,Wednesday
2020-06-03,Lok Ma Chau,0,0,0,0,0,0,0,0,Wednesday
2020-06-03,Man Kam To,0,0,0,0,0,0,0,0,Wednesday
2020-06-03,Sha Tau Kok,0,0,0,0,0,0,0,0,Wednesday
2020-06-03,Shenzhen Bay,1147,196,6,1349,609,88,2,699,Wednesday
2020-06-03,China Ferry Terminal,0,0,0,0,0,0,0,0,Wednesday
2020-06-03,Harbour Control,0,0,0,0,0,0,0,0,Wednesday
2020-06-03,Kai Tak Cruise Terminal,0,0,0,0,0,0,0,0,Wednesday
2020-06-03,Macau Ferry Terminal,0,0,0,0,0,0,0,0,Wednesday
2020-06-03,Total,2162,207,50,2419,1077,100,124,1301,Wednesday
2020-06-04,Airport,952,6,36,994,440,5,80,525,Thursday
2020-06-04,Express Rail Link West Kowloon,0,0,0,0,0,0,0,0,Thursday
2020-06-04,Hung Hom,0,0,0,0,0,0,0,0,Thursday
2020-06-04,Lo Wu,0,0,0,0,0,0,0,0,Thursday
2020-06-04,Lok Ma Chau Spur Line,0,0,0,0,0,0,0,0,Thursday
2020-06-04,Hong Kong-Zhuhai-Macao Bridge,78,11,10,99,74,3,8,85,Thursday
2020-06-04,Lok Ma Chau,0,0,0,0,0,0,0,0,Thursday
2020-06-04,Man Kam To,0,0,0,0,0,0,0,0,Thursday
2020-06-04,Sha Tau Kok,0,0,0,0,0,0,0,0,Thursday
2020-06-04,Shenzhen Bay,1365,205,9,1579,820,111,8,939,Thursday
2020-06-04,China Ferry Terminal,0,0,0,0,0,0,0,0,Thursday
2020-06-04,Harbour Control,0,0,0,0,0,0,0,0,Thursday
2020-06-04,Kai Tak Cruise Terminal,0,0,0,0,0,0,0,0,Thursday
2020-06-04,Macau Ferry Terminal,0,0,0,0,0,0,0,0,Thursday
2020-06-04,Tuen Mun Ferry Terminal,0,0,0,0,0,0,0,0,Thursday
2020-06-04,Total,2395,222,55,2672,1334,119,96,1549,Thursday
2020-06-05,Hung Hom,0,0,0,0,0,0,0,0,Friday
2020-06-05,Lo Wu,0,0,0,0,0,0,0,0,Friday
2020-06-05,Lok Ma Chau Spur Line,0,0,0,0,0,0,0,0,Friday
2020-06-05,Lok Ma Chau,0,0,0,0,0,0,0,0,Friday
2020-06-05,Man Kam To,0,0,0,0,0,0,0,0,Friday
2020-06-05,Sha Tau Kok,0,0,0,0,0,0,0,0,Friday
2020-06-05,Shenzhen Bay,1378,223,13,1614,829,120,14,963,Friday
2020-06-05,China Ferry Terminal,0,0,0,0,0,0,0,0,Friday
2020-06-05,Harbour Control,0,0,0,0,0,0,0,0,Friday
2020-06-05,Kai Tak Cruise Terminal,0,0,0,0,0,0,0,0,Friday
2020-06-05,Macau Ferry Terminal,0,0,0,0,0,0,0,0,Friday
2020-06-05,Tuen Mun Ferry Terminal,0,0,0,0,0,0,0,0,Friday
2020-06-05,Total,2575,234,64,2873,1527,139,95,1761,Friday
2020-06-06,Airport,527,7,46,580,390,22,186,598,Saturday
2020-06-06,Express Rail Link West Kowloon,0,0,0,0,0,0,0,0,Saturday
2020-06-06,Hung Hom,0,0,0,0,0,0,0,0,Saturday
2020-06-06,Lo Wu,0,0,0,0,0,0,0,0,Saturday
2020-06-06,Lok Ma Chau Spur Line,0,0,0,0,0,0,0,0,Saturday
2020-06-06,Hong Kong-Zhuhai-Macao Bridge,115,14,4,133,56,4,8,68,Saturday
2020-06-06,Lok Ma Chau,0,0,0,0,0,0,0,0,Saturday
2020-06-06,Man Kam To,0,0,0,0,0,0,0,0,Saturday
2020-06-06,Sha Tau Kok,0,0,0,0,0,0,0,0,Saturday
2020-06-06,Shenzhen Bay,1368,262,14,1644,718,103,40,861,Saturday
2020-06-06,China Ferry Terminal,0,0,0,0,0,0,0,0,Saturday
2020-06-06,Harbour Control,0,0,0,0,0,0,0,0,Saturday
2020-06-06,Kai Tak Cruise Terminal,0,0,0,0,0,0,0,0,Saturday
2020-06-06,Macau Ferry Terminal,0,0,0,0,0,0,0,0,Saturday
2020-06-06,Tuen Mun Ferry Terminal,0,0,0,0,0,0,0,0,Saturday
2020-06-06,Total,2010,283,64,2357,1164,129,234,1527,Saturday
2020-06-07,Airport,1083,3,44,1130,520,9,120,649,Sunday
2020-06-07,Express Rail Link West Kowloon,0,0,0,0,0,0,0,0,Sunday
2020-06-07,Hung Hom,0,0,0,0,0,0,0,0,Sunday
2020-06-07,Lo Wu,0,0,0,0,0,0,0,0,Sunday
2020-06-07,Lok Ma Chau Spur Line,0,0,0,0,0,0,0,0,Sunday
2020-06-07,Lok Ma Chau,0,0,0,0,0,0,0,0,Sunday
2020-06-07,Man Kam To,0,0,0,0,0,0,0,0,Sunday
2020-06-07,Sha Tau Kok,0,0,0,0,0,0,0,0,Sunday
2020-06-07,Shenzhen Bay,2123,366,16,2505,670,133,3,806,Sunday
2020-06-07,China Ferry Terminal,0,0,0,0,0,0,0,0,Sunday
2020-06-07,Harbour Control,0,0,0,0,0,0,0,0,Sunday
2020-06-07,Kai Tak Cruise Terminal,0,0,0,0,0,0,0,0,Sunday
2020-06-07,Macau Ferry Terminal,0,0,0,0,0,0,0,0,Sunday
2020-06-07,Tuen Mun Ferry Terminal,0,0,0,0,0,0,0,0,Sunday
2020-06-07,Total,3328,376,71,3775,1246,145,127,1518,Sunday
2020-06-08,Airport,786,14,102,902,235,17,44,296,Monday
2020-06-08,Express Rail Link West Kowloon,0,0,0,0,0,0,0,0,Monday
2020-06-08,Hung Hom,0,0,0,0,0,0,0,0,Monday
2020-06-08,Lo Wu,0,0,0,0,0,0,0,0,Monday
2020-06-08,Lok Ma Chau Spur Line,0,0,0,0,0,0,0,0,Monday
2020-06-08,Hong Kong-Zhuhai-Macao Bridge,152,11,10,173,113,11,3,127,Monday
2020-06-08,Lok Ma Chau,0,0,0,0,0,0,0,0,Monday
2020-06-08,Man Kam To,0,0,0,0,0,0,0,0,Monday
2020-06-08,Sha Tau Kok,0,0,0,0,0,0,0,0,Monday
2020-06-08,Shenzhen Bay,2081,287,22,2390,942,107,13,1062,Monday
2020-06-08,China Ferry Terminal,0,0,0,0,0,0,0,0,Monday
2020-06-08,Harbour Control,0,0,0,0,0,0,0,0,Monday
2020-06-08,Kai Tak Cruise Terminal,0,0,0,0,0,0,0,0,Monday
2020-06-08,Macau Ferry Terminal,0,0,0,0,0,0,0,0,Monday
2020-06-08,Tuen Mun Ferry Terminal,0,0,0,0,0,0,0,0,Monday
2020-06-08,Total,3019,312,134,3465,1290,135,60,1485,Monday
2020-06-09,Airport,559,12,30,601,374,22,44,440,Tuesday
2020-06-09,Hung Hom,0,0,0,0,0,0,0,0,Tuesday
2020-06-09,Lo Wu,0,0,0,0,0,0,0,0,Tuesday
2020-06-09,Lok Ma Chau Spur Line,0,0,0,0,0,0,0,0,Tuesday
2020-06-09,Hong Kong-Zhuhai-Macao Bridge,99,6,8,113,64,7,4,75,Tuesday
2020-06-09,Lok Ma Chau,0,0,0,0,0,0,0,0,Tuesday
2020-06-09,Man Kam To,0,0,0,0,0,0,0,0,Tuesday
2020-06-09,Sha Tau Kok,0,0,0,0,0,0,0,0,Tuesday
2020-06-09,Shenzhen Bay,1481,237,19,1737,764,133,5,902,Tuesday
2020-06-09,China Ferry Terminal,0,0,0,0,0,0,0,0,Tuesday
2020-06-09,Harbour Control,0,0,0,0,0,0,0,0,Tuesday
2020-06-09,Kai Tak Cruise Terminal,0,0,0,0,0,0,0,0,Tuesday
2020-06-09,Macau Ferry Terminal,0,0,0,0,0,0,0,0,Tuesday
2020-06-09,Tuen Mun Ferry Terminal,0,0,0,0,0,0,0,0,Tuesday
2020-06-09,Total,2139,255,57,2451,1202,162,53,1417,Tuesday
2020-06-10,Airport,570,3,15,588,330,15,199,544,Wednesday
2020-06-10,Express Rail Link West Kowloon,0,0,0,0,0,0,0,0,Wednesday
2020-06-10,Hung Hom,0,0,0,0,0,0,0,0,Wednesday
2020-06-10,Lo Wu,0,0,0,0,0,0,0,0,Wednesday
2020-06-10,Lok Ma Chau Spur Line,0,0,0,0,0,0,0,0,Wednesday
2020-06-10,Hong Kong-Zhuhai-Macao Bridge,114,12,13,139,61,3,1,65,Wednesday
2020-06-10,Lok Ma Chau,0,0,0,0,0,0,0,0,Wednesday
2020-06-10,Man Kam To,0,0,0,0,0,0,0,0,Wednesday
2020-06-10,Sha Tau Kok,0,0,0,0,0,0,0,0,Wednesday
2020-06-10,Shenzhen Bay,1520,251,18,1789,714,106,4,824,Wednesday
2020-06-10,China Ferry Terminal,0,0,0,0,0,0,0,0,Wednesday
2020-06-10,Harbour Control,0,0,0,0,0,0,0,0,Wednesday
2020-06-10,Kai Tak Cruise Terminal,0,0,0,0,0,0,0,0,Wednesday
2020-06-10,Macau Ferry Terminal,0,0,0,0,0,0,0,0,Wednesday
2020-06-10,Total,2204,266,46,2516,1105,124,204,1433,Wednesday
2020-06-11,Airport,626,4,19,649,341,10,36,387,Thursday
2020-06-11,Hung Hom,0,0,0,0,0,0,0,0,Thursday
2020-06-11,Lo Wu,0,0,0,0,0,0,0,0,Thursday
2020-06-11,Lok Ma Chau Spur Line,0,0,0,0,0,0,0,0,Thursday
2020-06-11,Hong Kong-Zhuhai-Macao Bridge,83,7,5,95,61,3,3,67,Thursday
2020-06-11,Lok Ma Chau,0,0,0,0,0,0,0,0,Thursday
2020-06-11,Man Kam To,0,0,0,0,0,0,0,0,Thursday
2020-06-11,Sha Tau Kok,0,0,0,0,0,0,0,0,Thursday
2020-06-11,Shenzhen Bay,1018,175,8,1201,483,61,8,552,Thursday
2020-06-11,China Ferry Terminal,0,0,0,0,0,0,0,0,Thursday
2020-06-11,Harbour Control,0,0,0,0,0,0,0,0,Thursday
2020-06-11,Kai Tak Cruise Terminal,0,0,0,0,0,0,0,0,Thursday
2020-06-11,Macau Ferry Terminal,0,0,0,0,0,0,0,0,Thursday
2020-06-11,Tuen Mun Ferry Terminal,0,0,0,0,0,0,0,0,Thursday
2020-06-11,Total,1727,186,32,1945,885,74,47,1006,Thursday
2020-06-12,Airport,1082,7,72,1161,482,5,92,579,Friday
2020-06-12,Express Rail Link West Kowloon,0,0,0,0,0,0,0,0,Friday
2020-06-12,Hung Hom,0,0,0,0,0,0,0,0,Friday
2020-06-12,Lo Wu,0,0,0,0,0,0,0,0,Friday
2020-06-12,Lok Ma Chau Spur Line,0,0,0,0,0,0,0,0,Friday
2020-06-12,Hong Kong-Zhuhai-Macao Bridge,68,9,31,108,48,2,4,54,Friday
2020-06-12,Lok Ma Chau,0,0,0,0,0,0,0,0,Friday
2020-06-12,Man Kam To,0,0,0,0,0,0,0,0,Friday
2020-06-12,Sha Tau Kok,0,0,0,0,0,0,0,0,Friday
2020-06-12,Shenzhen Bay,924,166,19,1109,451,63,6,520,Friday
2020-06-12,China Ferry Terminal,0,0,0,0,0,0,0,0,Friday
2020-06-12,Harbour Control,0,0,0,0,0,0,0,0,Friday
2020-06-12,Kai Tak Cruise Terminal,0,0,0,0,0,0,0,0,Friday
2020-06-12,Macau Ferry Terminal,0,0,0,0,0,0,0,0,Friday
2020-06-12,Tuen Mun Ferry Terminal,0,0,0,0,0,0,0,0,Friday
2020-06-12,Total,2074,182,122,2378,981,70,102,1153,Friday
2020-06-13,Airport,732,4,54,790,331,14,62,407,Saturday
2020-06-13,Hung Hom,0,0,0,0,0,0,0,0,Saturday
2020-06-13,Lo Wu,0,0,0,0,0,0,0,0,Saturday
2020-06-13,Lok Ma Chau Spur Line,0,0,0,0,0,0,0,0,Saturday
2020-06-13,Hong Kong-Zhuhai-Macao Bridge,87,7,4,98,50,3,4,57,Saturday
2020-06-13,Lok Ma Chau,0,0,0,0,0,0,0,0,Saturday
2020-06-13,Man Kam To,0,0,0,0,0,0,0,0,Saturday
2020-06-13,Sha Tau Kok,0,0,0,0,0,0,0,0,Saturday
2020-06-13,Shenzhen Bay,863,225,19,1107,398,65,7,470,Saturday
2020-06-13,China Ferry Terminal,0,0,0,0,0,0,0,0,Saturday
2020-06-13,Harbour Control,0,0,0,0,0,0,0,0,Saturday
2020-06-13,Kai Tak Cruise Terminal,0,0,0,0,0,0,0,0,Saturday
2020-06-13,Macau Ferry Terminal,0,0,0,0,0,0,0,0,Saturday
2020-06-13,Tuen Mun Ferry Terminal,0,0,0,0,0,0,0,0,Saturday
2020-06-13,Total,1682,236,77,1995,779,82,73,934,Saturday
2020-06-14,Airport,970,3,50,1023,550,16,80,646,Sunday
2020-06-14,Express Rail Link West Kowloon,0,0,0,0,0,0,0,0,Sunday
2020-06-14,Hung Hom,0,0,0,0,0,0,0,0,Sunday
2020-06-14,Lo Wu,0,0,0,0,0,0,0,0,Sunday
2020-06-14,Lok Ma Chau Spur Line,0,0,0,0,0,0,0,0,Sunday
2020-06-14,Hong Kong-Zhuhai-Macao Bridge,30,4,3,37,28,3,6,37,Sunday
2020-06-14,Lok Ma Chau,0,0,0,0,0,0,0,0,Sunday
2020-06-14,Man Kam To,0,0,0,0,0,0,0,0,Sunday
2020-06-14,Sha Tau Kok,0,0,0,0,0,0,0,0,Sunday
2020-06-14,Shenzhen Bay,651,149,14,814,298,79,6,383,Sunday
2020-06-14,China Ferry Terminal,0,0,0,0,0,0,0,0,Sunday
2020-06-14,Harbour Control,0,0,0,0,0,0,0,0,Sunday
2020-06-14,Kai Tak Cruise Terminal,0,0,0,0,0,0,0,0,Sunday
2020-06-14,Macau Ferry Terminal,0,0,0,0,0,0,0,0,Sunday
2020-06-14,Total,1651,156,67,1874,876,98,92,1066,Sunday
2020-06-15,Airport,877,7,75,959,280,12,58,350,Monday
2020-06-15,Express Rail Link West Kowloon,0,0,0,0,0,0,0,0,Monday
2020-06-15,Hung Hom,0,0,0,0,0,0,0,0,Monday
2020-06-15,Lo Wu,0,0,0,0,0,0,0,0,Monday
2020-06-15,Lok Ma Chau Spur Line,1297,0,0,1297,1297,0,0,1297,Monday
2020-06-15,Hong Kong-Zhuhai-Macao Bridge,51,3,3,57,63,1,5,69,Monday
2020-06-15,Lok Ma Chau,0,0,0,0,0,0,0,0,Monday
2020-06-15,Man Kam To,0,0,0,0,0,0,0,0,Monday
2020-06-15,Sha Tau Kok,0,0,0,0,0,0,0,0,Monday
2020-06-15,Shenzhen Bay,1259,160,18,1437,858,74,23,955,Monday
2020-06-15,China Ferry Terminal,0,0,0,0,0,0,0,0,Monday
2020-06-15,Harbour Control,0,0,0,0,0,0,0,0,Monday
2020-06-15,Kai Tak Cruise Terminal,0,0,0,0,0,0,0,0,Monday
2020-06-15,Macau Ferry Terminal,0,0,0,0,0,0,0,0,Monday
2020-06-15,Tuen Mun Ferry Terminal,0,0,0,0,0,0,0,0,Monday
2020-06-15,Total,3484,170,96,3750,2498,87,86,2671,Monday
2020-06-16,Airport,928,4,42,974,477,19,51,547,Tuesday
2020-06-16,Express Rail Link West Kowloon,0,0,0,0,0,0,0,0,Tuesday
2020-06-16,Hung Hom,0,0,0,0,0,0,0,0,Tuesday
2020-06-16,Lo Wu,0,0,0,0,0,0,0,0,Tuesday
2020-06-16,Lok Ma Chau Spur Line,1249,0,0,1249,1249,0,0,1249,Tuesday
2020-06-16,Lok Ma Chau,0,0,0,0,0,0,0,0,Tuesday
2020-06-16,Man Kam To,0,0,0,0,0,0,0,0,Tuesday
2020-06-16,Sha Tau Kok,0,0,0,0,0,0,0,0,Tuesday
2020-06-16,Shenzhen Bay,1127,159,15,1301,796,77,3,876,Tuesday
2020-06-16,China Ferry Terminal,0,0,0,0,0,0,0,0,Tuesday
2020-06-16,Harbour Control,0,0,0,0,0,0,0,0,Tuesday
2020-06-16,Macau Ferry Terminal,0,0,0,0,0,0,0,0,Tuesday
2020-06-16,Tuen Mun Ferry Terminal,0,0,0,0,0,0,0,0,Tuesday
2020-06-16,Total,3359,164,66,3589,2604,100,65,2769,Tuesday
2020-06-17,Airport,846,11,40,897,243,8,35,286,Wednesday
2020-06-17,Hung Hom,0,0,0,0,0,0,0,0,Wednesday
2020-06-17,Lo Wu,0,0,0,0,0,0,0,0,Wednesday
2020-06-17,Lok Ma Chau Spur Line,1272,0,0,1272,1272,0,0,1272,Wednesday
2020-06-17,Hong Kong-Zhuhai-Macao Bridge,71,0,12,83,75,6,1,82,Wednesday
2020-06-17,Lok Ma Chau,0,0,0,0,0,0,0,0,Wednesday
2020-06-17,Man Kam To,0,0,0,0,0,0,0,0,Wednesday
2020-06-17,Sha Tau Kok,0,0,0,0,0,0,0,0,Wednesday
2020-06-17,Shenzhen Bay,1074,137,17,1228,796,112,2,910,Wednesday
2020-06-17,China Ferry Terminal,0,0,0,0,0,0,0,0,Wednesday
2020-06-17,Harbour Control,0,0,0,0,0,0,0,0,Wednesday
2020-06-17,Kai Tak Cruise Terminal,0,0,0,0,0,0,0,0,Wednesday
2020-06-17,Macau Ferry Terminal,0,0,0,0,0,0,0,0,Wednesday
2020-06-17,Tuen Mun Ferry Terminal,0,0,0,0,0,0,0,0,Wednesday
2020-06-17,Total,3263,148,69,3480,2386,126,38,2550,Wednesday
2020-06-18,Airport,708,0,34,742,438,6,95,539,Thursday
2020-06-18,Express Rail Link West Kowloon,0,0,0,0,0,0,0,0,Thursday
2020-06-18,Hung Hom,0,0,0,0,0,0,0,0,Thursday
2020-06-18,Lo Wu,0,0,0,0,0,0,0,0,Thursday
2020-06-18,Lok Ma Chau Spur Line,1271,0,0,1271,1271,0,0,1271,Thursday
2020-06-18,Hong Kong-Zhuhai-Macao Bridge,56,3,4,63,60,8,3,71,Thursday
2020-06-18,Lok Ma Chau,0,0,0,0,0,0,0,0,Thursday
2020-06-18,Man Kam To,0,0,0,0,0,0,0,0,Thursday
2020-06-18,Sha Tau Kok,0,0,0,0,0,0,0,0,Thursday
2020-06-18,Shenzhen Bay,1026,143,19,1188,845,92,1,938,Thursday
2020-06-18,China Ferry Terminal,0,0,0,0,0,0,0,0,Thursday
2020-06-18,Harbour Control,0,0,0,0,0,0,0,0,Thursday
2020-06-18,Kai Tak Cruise Terminal,0,0,0,0,0,0,0,0,Thursday
2020-06-18,Tuen Mun Ferry Terminal,0,0,0,0,0,0,0,0,Thursday
2020-06-18,Total,3061,146,57,3264,2614,106,99,2819,Thursday
2020-06-19,Airport,1022,2,86,1110,641,5,180,826,Friday
2020-06-19,Express Rail Link West Kowloon,0,0,0,0,0,0,0,0,Friday
2020-06-19,Hung Hom,0,0,0,0,0,0,0,0,Friday
2020-06-19,Lo Wu,0,0,0,0,0,0,0,0,Friday
2020-06-19,Lok Ma Chau Spur Line,1147,0,0,1147,1146,0,0,1146,Friday
2020-06-19,Hong Kong-Zhuhai-Macao Bridge,59,8,3,70,71,1,8,80,Friday
2020-06-19,Lok Ma Chau,0,0,0,0,0,0,0,0,Friday
2020-06-19,Man Kam To,0,0,0,0,0,0,0,0,Friday
2020-06-19,Sha Tau Kok,0,0,0,0,0,0,0,0,Friday
2020-06-19,Shenzhen Bay,1000,110,10,1120,741,75,13,829,Friday
2020-06-19,China Ferry Terminal,0,0,0,0,0,0,0,0,Friday
2020-06-19,Harbour Control,0,0,0,0,0,0,0,0,Friday
2020-06-19,Kai Tak Cruise Terminal,0,0,0,0,0,0,0,0,Friday
2020-06-19,Macau Ferry Terminal,0,0,0,0,0,0,0,0,Friday
2020-06-19,Tuen Mun Ferry Terminal,0,0,0,0,0,0,0,0,Friday
2020-06-19,Total,3228,120,99,3447,2599,81,201,2881,Friday
2020-06-20,Airport,972,12,54,1038,392,5,51,448,Saturday
2020-06-20,Express Rail Link West Kowloon,0,0,0,0,0,0,0,0,Saturday
2020-06-20,Hung Hom,0,0,0,0,0,0,0,0,Saturday
2020-06-20,Lo Wu,0,0,0,0,0,0,0,0,Saturday
2020-06-20,Lok Ma Chau Spur Line,0,0,0,0,0,0,0,0,Saturday
2020-06-20,Lok Ma Chau,0,0,0,0,0,0,0,0,Saturday
2020-06-20,Man Kam To,0,0,0,0,0,0,0,0,Saturday
2020-06-20,Sha Tau Kok,0,0,0,0,0,0,0,0,Saturday
2020-06-20,Shenzhen Bay,728,154,21,903,444,85,5,534,Saturday
2020-06-20,China Ferry Terminal,0,0,0,0,0,0,0,0,Saturday
2020-06-20,Harbour Control,0,0,0,0,0,0,0,0,Saturday
2020-06-20,Kai Tak Cruise Terminal,0,0,0,0,0,0,0,0,Saturday
2020-06-20,Macau Ferry Terminal,0,0,0,0,0,0,0,0,Saturday
2020-06-20,Tuen Mun Ferry Terminal,0,0,0,0,0,0,0,0,Saturday
2020-06-20,Total,1746,171,83,2000,890,94,62,1046,Saturday
2020-06-21,Airport,1385,5,71,1461,742,27,78,847,Sunday
2020-06-21,Express Rail Link West Kowloon,0,0,0,0,0,0,0,0,Sunday
2020-06-21,Hung Hom,0,0,0,0,0,0,0,0,Sunday
2020-06-21,Lo Wu,0,0,0,0,0,0,0,0,Sunday
2020-06-21,Lok Ma Chau Spur Line,0,0,0,0,0,0,0,0,Sunday
2020-06-21,Hong Kong-Zhuhai-Macao Bridge,52,0,1,53,38,3,2,43,Sunday
2020-06-21,Lok Ma Chau,0,0,0,0,0,0,0,0,Sunday
2020-06-21,Man Kam To,0,0,0,0,0,0,0,0,Sunday
2020-06-21,Sha Tau Kok,0,0,0,0,0,0,0,0,Sunday
2020-06-21,Shenzhen Bay,623,141,17,781,399,77,5,481,Sunday
2020-06-21,China Ferry Terminal,0,0,0,0,0,0,0,0,Sunday
2020-06-21,Harbour Control,0,0,0,0,0,0,0,0,Sunday
2020-06-21,Kai Tak Cruise Terminal,0,0,0,0,0,0,0,0,Sunday
2020-06-21,Macau Ferry Terminal,0,0,0,0,0,0,0,0,Sunday
2020-06-21,Tuen Mun Ferry Terminal,0,0,0,0,0,0,0,0,Sunday
2020-06-21,Total,2060,146,89,2295,1179,107,85,1371,Sunday
2020-06-22,Airport,592,7,64,663,211,4,36,251,Monday
2020-06-22,Hung Hom,0,0,0,0,0,0,0,0,Monday
2020-06-22,Lo Wu,0,0,0,0,0,0,0,0,Monday
2020-06-22,Lok Ma Chau Spur Line,1285,0,0,1285,1285,0,0,1285,Monday
2020-06-22,Hong Kong-Zhuhai-Macao Bridge,54,4,2,60,86,5,14,105,Monday
2020-06-22,Lok Ma Chau,0,0,0,0,0,0,0,0,Monday
2020-06-22,Man Kam To,0,0,0,0,0,0,0,0,Monday
2020-06-22,Sha Tau Kok,0,0,0,0,0,0,0,0,Monday
2020-06-22,Harbour Control,0,0,0,0,0,0,0,0,Monday
2020-06-22,Kai Tak Cruise Terminal,0,0,0,0,0,0,0,0,Monday
2020-06-22,Macau Ferry Terminal,0,0,0,0,0,0,0,0,Monday
2020-06-22,Tuen Mun Ferry Terminal,0,0,0,0,0,0,0,0,Monday
2020-06-22,Total,2979,179,84,3242,2580,83,81,2744,Monday
2020-06-23,Airport,1179,9,34,1222,429,18,54,501,Tuesday
2020-06-23,Express Rail Link West Kowloon,0,0,0,0,0,0,0,0,Tuesday
2020-06-23,Hung Hom,0,0,0,0,0,0,0,0,Tuesday
2020-06-23,Lo Wu,0,0,0,0,0,0,0,0,Tuesday
2020-06-23,Lok Ma Chau Spur Line,1299,0,0,1299,1299,0,0,1299,Tuesday
2020-06-23,Hong Kong-Zhuhai-Macao Bridge,48,2,3,53,58,3,4,65,Tuesday
2020-06-23,Lok Ma Chau,0,0,0,0,0,0,0,0,Tuesday
2020-06-23,Man Kam To,0,0,0,0,0,0,0,0,Tuesday
2020-06-23,Sha Tau Kok,0,0,0,0,0,0,0,0,Tuesday
2020-06-23,Shenzhen Bay,973,136,9,1118,778,73,6,857,Tuesday
2020-06-23,China Ferry Terminal,0,0,0,0,0,0,0,0,Tuesday
2020-06-23,Harbour Control,0,0,0,0,0,0,0,0,Tuesday
2020-06-23,Kai Tak Cruise Terminal,0,0,0,0,0,0,0,0,Tuesday
2020-06-23,Macau Ferry Terminal,0,0,0,0,0,0,0,0,Tuesday
2020-06-23,Total,3499,147,46,3692,2564,94,64,2722,Tuesday
2020-06-24,Airport,738,3,55,796,547,6,44,597,Wednesday
2020-06-24,Express Rail Link West Kowloon,0,0,0,0,0,0,0,0,Wednesday
2020-06-24,Hung Hom,0,0,0,0,0,0,0,0,Wednesday
2020-06-24,Lo Wu,0,0,0,0,0,0,0,0,Wednesday
2020-06-24,Lok Ma Chau Spur Line,1292,0,0,1292,1293,0,0,1293,Wednesday
2020-06-24,Hong Kong-Zhuhai-Macao Bridge,52,2,3,57,67,5,4,76,Wednesday
2020-06-24,Lok Ma Chau,0,0,0,0,0,0,0,0,Wednesday
2020-06-24,Man Kam To,0,0,0,0,0,0,0,0,Wednesday
2020-06-24,Sha Tau Kok,0,0,0,0,0,0,0,0,Wednesday
2020-06-24,Shenzhen Bay,1019,99,15,1133,796,72,4,872,Wednesday
2020-06-24,China Ferry Terminal,0,0,0,0,0,0,0,0,Wednesday
2020-06-24,Harbour Control,0,0,0,0,0,0,0,0,Wednesday
2020-06-24,Kai Tak Cruise Terminal,0,0,0,0,0,0,0,0,Wednesday
2020-06-24,Macau Ferry Terminal,0,0,0,0,0,0,0,0,Wednesday
2020-06-24,Tuen Mun Ferry Terminal,0,0,0,0,0,0,0,0,Wednesday
2020-06-24,Total,3101,104,73,3278,2703,83,52,2838,Wednesday
2020-06-25,Airport,815,2,46,863,716,11,68,795,Thursday
2020-06-25,Express Rail Link West Kowloon,0,0,0,0,0,0,0,0,Thursday
2020-06-25,Hung Hom,0,0,0,0,0,0,0,0,Thursday
2020-06-25,Lo Wu,0,0,0,0,0,0,0,0,Thursday
2020-06-25,Lok Ma Chau Spur Line,0,0,0,0,0,0,0,0,Thursday
2020-06-25,Lok Ma Chau,0,0,0,0,0,0,0,0,Thursday
2020-06-25,Man Kam To,0,0,0,0,0,0,0,0,Thursday
2020-06-25,Sha Tau Kok,0,0,0,0,0,0,0,0,Thursday
2020-06-25,Shenzhen Bay,501,93,9,603,383,56,0,439,Thursday
2020-06-25,China Ferry Terminal,0,0,0,0,0,0,0,0,Thursday
2020-06-25,Harbour Control,0,0,0,0,0,0,0,0,Thursday
2020-06-25,Kai Tak Cruise Terminal,0,0,0,0,0,0,0,0,Thursday
2020-06-25,Macau Ferry Terminal,0,0,0,0,0,0,0,0,Thursday
2020-06-25,Tuen Mun Ferry Terminal,0,0,0,0,0,0,0,0,Thursday
2020-06-25,Total,1365,97,56,1518,1156,70,71,1297,Thursday
2020-06-26,Airport,1077,8,57,1142,640,13,85,738,Friday
2020-06-26,Express Rail Link West Kowloon,0,0,0,0,0,0,0,0,Friday
2020-06-26,Hung Hom,0,0,0,0,0,0,0,0,Friday
2020-06-26,Lo Wu,0,0,0,0,0,0,0,0,Friday
2020-06-26,Lok Ma Chau Spur Line,1264,0,0,1264,1264,0,0,1264,Friday
2020-06-26,Hong Kong-Zhuhai-Macao Bridge,40,3,6,49,58,7,2,67,Friday
2020-06-26,Lok Ma Chau,0,0,0,0,0,0,0,0,Friday
2020-06-26,Man Kam To,0,0,0,0,0,0,0,0,Friday
2020-06-26,Sha Tau Kok,0,0,0,0,0,0,0,0,Friday
2020-06-26,Shenzhen Bay,813,99,17,929,732,76,2,810,Friday
2020-06-26,China Ferry Terminal,0,0,0,0,0,0,0,0,Friday
2020-06-26,Harbour Control,0,0,0,0,0,0,0,0,Friday
2020-06-26,Kai Tak Cruise Terminal,0,0,0,0,0,0,0,0,Friday
2020-06-26,Macau Ferry Terminal,0,0,0,0,0,0,0,0,Friday
2020-06-26,Tuen Mun Ferry Terminal,0,0,0,0,0,0,0,0,Friday
2020-06-26,Total,3194,110,80,3384,2694,96,89,2879,Friday
2020-06-27,Airport,1024,1,53,1078,625,15,138,778,Saturday
2020-06-27,Hung Hom,0,0,0,0,0,0,0,0,Saturday
2020-06-27,Lo Wu,0,0,0,0,0,0,0,0,Saturday
2020-06-27,Lok Ma Chau Spur Line,0,0,0,0,0,0,0,0,Saturday
2020-06-27,Hong Kong-Zhuhai-Macao Bridge,37,7,10,54,42,2,3,47,Saturday
2020-06-27,Lok Ma Chau,0,0,0,0,0,0,0,0,Saturday
2020-06-27,Man Kam To,0,0,0,0,0,0,0,0,Saturday
2020-06-27,Sha Tau Kok,0,0,0,0,0,0,0,0,Saturday
2020-06-27,Shenzhen Bay,527,73,12,612,339,69,7,415,Saturday
2020-06-27,China Ferry Terminal,0,0,0,0,0,0,0,0,Saturday
2020-06-27,Harbour Control,0,0,0,0,0,0,0,0,Saturday
2020-06-27,Kai Tak Cruise Terminal,0,0,0,0,0,0,0,0,Saturday
2020-06-27,Macau Ferry Terminal,0,0,0,0,0,0,0,0,Saturday
2020-06-27,Tuen Mun Ferry Terminal,0,0,0,0,0,0,0,0,Saturday
2020-06-27,Total,1588,81,75,1744,1006,86,148,1240,Saturday
2020-06-28,Airport,928,5,69,1002,874,1,103,978,Sunday
2020-06-28,Express Rail Link West Kowloon,0,0,0,0,0,0,0,0,Sunday
2020-06-28,Hung Hom,0,0,0,0,0,0,0,0,Sunday
2020-06-28,Lo Wu,0,0,0,0,0,0,0,0,Sunday
2020-06-28,Lok Ma Chau Spur Line,0,0,0,0,0,0,0,0,Sunday
2020-08-20,Lo Wu,0,0,0,0,0,0,0,0,Thursday
2020-07-01,Lok Ma Chau Spur Line,0,0,0,0,0,0,0,0,Wednesday
2020-07-01,Hong Kong-Zhuhai-Macao Bridge,41,7,4,52,75,9,5,89,Wednesday
2020-07-01,Lok Ma Chau,0,0,0,0,0,0,0,0,Wednesday
2020-07-01,Man Kam To,0,0,0,0,0,0,0,0,Wednesday
2020-07-01,Sha Tau Kok,0,0,0,0,0,0,0,0,Wednesday
2020-07-01,Shenzhen Bay,566,104,8,678,496,86,3,585,Wednesday
2020-07-01,China Ferry Terminal,0,0,0,0,0,0,0,0,Wednesday
2020-07-01,Harbour Control,0,0,0,0,0,0,0,0,Wednesday
2020-07-01,Kai Tak Cruise Terminal,0,0,0,0,0,0,0,0,Wednesday
2020-07-01,Macau Ferry Terminal,0,0,0,0,0,0,0,0,Wednesday
2020-07-01,Tuen Mun Ferry Terminal,0,0,0,0,0,0,0,0,Wednesday
2020-07-01,Total,1289,114,70,1473,1593,115,90,1798,Wednesday
2020-07-02,Airport,1017,5,75,1097,880,23,60,963,Thursday
2020-07-02,Express Rail Link West Kowloon,0,0,0,0,0,0,0,0,Thursday
2020-07-02,Hung Hom,0,0,0,0,0,0,0,0,Thursday
2020-07-02,Lo Wu,0,0,0,0,0,0,0,0,Thursday
2020-07-02,Lok Ma Chau Spur Line,1291,0,0,1291,1291,0,0,1291,Thursday
2020-07-02,Lok Ma Chau,0,0,0,0,0,0,0,0,Thursday
2020-07-02,Man Kam To,0,0,0,0,0,0,0,0,Thursday
2020-07-02,Sha Tau Kok,0,0,0,0,0,0,0,0,Thursday
2020-07-02,Shenzhen Bay,981,86,11,1078,918,88,8,1014,Thursday
2020-07-02,China Ferry Terminal,0,0,0,0,0,0,0,0,Thursday
2020-07-02,Harbour Control,0,0,0,0,0,0,0,0,Thursday
2020-07-02,Kai Tak Cruise Terminal,0,0,0,0,0,0,0,0,Thursday
2020-07-02,Macau Ferry Terminal,0,0,0,0,0,0,0,0,Thursday
2020-07-02,Tuen Mun Ferry Terminal,0,0,0,0,0,0,0,0,Thursday
2020-07-02,Total,3362,92,89,3543,3175,120,71,3366,Thursday
2020-07-03,Airport,1145,7,71,1223,1054,17,87,1158,Friday
2020-07-03,Express Rail Link West Kowloon,0,0,0,0,0,0,0,0,Friday
2020-07-03,Hung Hom,0,0,0,0,0,0,0,0,Friday
2020-07-03,Lo Wu,0,0,0,0,0,0,0,0,Friday
2020-07-03,Lok Ma Chau Spur Line,1219,0,0,1219,1219,0,0,1219,Friday
2020-07-03,Hong Kong-Zhuhai-Macao Bridge,57,7,3,67,84,6,7,97,Friday
2020-07-03,Lok Ma Chau,0,0,0,0,0,0,0,0,Friday
2020-07-03,Man Kam To,0,0,0,0,0,0,0,0,Friday
2020-07-03,Sha Tau Kok,0,0,0,0,0,0,0,0,Friday
2020-07-03,Shenzhen Bay,1063,134,5,1202,868,107,14,989,Friday
2020-07-03,China Ferry Terminal,0,0,0,0,0,0,0,0,Friday
2020-07-03,Harbour Control,0,0,0,0,0,0,0,0,Friday
2020-07-03,Kai Tak Cruise Terminal,0,0,0,0,0,0,0,0,Friday
2020-07-03,Macau Ferry Terminal,0,0,0,0,0,0,0,0,Friday
2020-07-03,Tuen Mun Ferry Terminal,0,0,0,0,0,0,0,0,Friday
2020-07-03,Total,3484,148,79,3711,3225,130,108,3463,Friday
2020-07-04,Airport,1068,13,57,1138,809,9,133,951,Saturday
2020-07-04,Express Rail Link West Kowloon,0,0,0,0,0,0,0,0,Saturday
2020-07-01,Hung Hom,0,0,0,0,0,0,0,0,Wednesday
2020-06-28,Lok Ma Chau,0,0,0,0,0,0,0,0,Sunday
2020-06-28,Man Kam To,0,0,0,0,0,0,0,0,Sunday
2020-06-28,Sha Tau Kok,0,0,0,0,0,0,0,0,Sunday
2020-06-28,Shenzhen Bay,608,117,11,736,309,42,19,370,Sunday
2020-06-28,China Ferry Terminal,0,0,0,0,0,0,0,0,Sunday
2020-06-28,Harbour Control,0,0,0,0,0,0,0,0,Sunday
2020-06-28,Kai Tak Cruise Terminal,0,0,0,0,0,0,0,0,Sunday
2020-06-28,Macau Ferry Terminal,0,0,0,0,0,0,0,0,Sunday
2020-06-28,Tuen Mun Ferry Terminal,0,0,0,0,0,0,0,0,Sunday
2020-06-28,Total,1567,124,82,1773,1222,43,125,1390,Sunday
2020-06-29,Airport,554,5,34,593,336,4,108,448,Monday
2020-06-29,Express Rail Link West Kowloon,0,0,0,0,0,0,0,0,Monday
2020-06-29,Hung Hom,0,0,0,0,0,0,0,0,Monday
2020-06-29,Lo Wu,0,0,0,0,0,0,0,0,Monday
2020-06-29,Lok Ma Chau Spur Line,1300,0,0,1300,1300,0,0,1300,Monday
2020-06-29,Hong Kong-Zhuhai-Macao Bridge,40,3,4,47,76,4,3,83,Monday
2020-06-29,Lok Ma Chau,0,0,0,0,0,0,0,0,Monday
2020-06-29,Man Kam To,0,0,0,0,0,0,0,0,Monday
2020-06-29,Sha Tau Kok,0,0,0,0,0,0,0,0,Monday
2020-06-29,Shenzhen Bay,865,80,6,951,774,52,20,846,Monday
2020-06-29,China Ferry Terminal,0,0,0,0,0,0,0,0,Monday
2020-06-29,Harbour Control,0,0,0,0,0,0,0,0,Monday
2020-06-29,Kai Tak Cruise Terminal,0,0,0,0,0,0,0,0,Monday
2020-06-29,Macau Ferry Terminal,0,0,0,0,0,0,0,0,Monday
2020-06-29,Tuen Mun Ferry Terminal,0,0,0,0,0,0,0,0,Monday
2020-06-29,Total,2759,88,44,2891,2486,60,131,2677,Monday
2020-06-30,Airport,1221,7,82,1310,730,5,62,797,Tuesday
2020-06-30,Express Rail Link West Kowloon,0,0,0,0,0,0,0,0,Tuesday
2020-06-30,Hung Hom,0,0,0,0,0,0,0,0,Tuesday
2020-06-30,Lo Wu,0,0,0,0,0,0,0,0,Tuesday
2020-06-30,Lok Ma Chau Spur Line,1235,0,0,1235,1235,0,0,1235,Tuesday
2020-06-30,Lok Ma Chau,0,0,0,0,0,0,0,0,Tuesday
2020-06-30,Man Kam To,0,0,0,0,0,0,0,0,Tuesday
2020-06-30,Sha Tau Kok,0,0,0,0,0,0,0,0,Tuesday
2020-06-30,Shenzhen Bay,928,159,10,1097,878,85,3,966,Tuesday
2020-06-30,China Ferry Terminal,0,0,0,0,0,0,0,0,Tuesday
2020-06-30,Harbour Control,0,0,0,0,0,0,0,0,Tuesday
2020-06-30,Kai Tak Cruise Terminal,0,0,0,0,0,0,0,0,Tuesday
2020-06-30,Macau Ferry Terminal,0,0,0,0,0,0,0,0,Tuesday
2020-06-30,Tuen Mun Ferry Terminal,0,0,0,0,0,0,0,0,Tuesday
2020-06-30,Total,3426,169,95,3690,2931,94,71,3096,Tuesday
2020-07-01,Lo Wu,0,0,0,0,0,0,0,0,Wednesday
2020-07-04,Lok Ma Chau Spur Line,0,0,0,0,0,0,0,0,Saturday
2020-07-04,Hong Kong-Zhuhai-Macao Bridge,66,8,3,77,79,3,5,87,Saturday
2020-07-04,Lok Ma Chau,0,0,0,0,0,0,0,0,Saturday
2020-07-04,Man Kam To,0,0,0,0,0,0,0,0,Saturday
2020-07-04,Sha Tau Kok,0,0,0,0,0,0,0,0,Saturday
2020-07-04,Shenzhen Bay,746,145,11,902,707,109,14,830,Saturday
2020-07-04,China Ferry Terminal,0,0,0,0,0,0,0,0,Saturday
2020-07-04,Harbour Control,0,0,0,0,0,0,0,0,Saturday
2020-07-04,Kai Tak Cruise Terminal,0,0,0,0,0,0,0,0,Saturday
2020-07-04,Macau Ferry Terminal,0,0,0,0,0,0,0,0,Saturday
2020-07-04,Tuen Mun Ferry Terminal,0,0,0,0,0,0,0,0,Saturday
2020-07-04,Total,1880,166,71,2117,1595,121,152,1868,Saturday
2020-07-05,Airport,1276,6,48,1330,994,14,151,1159,Sunday
2020-07-05,Express Rail Link West Kowloon,0,0,0,0,0,0,0,0,Sunday
2020-07-05,Hung Hom,0,0,0,0,0,0,0,0,Sunday
2020-07-05,Lo Wu,0,0,0,0,0,0,0,0,Sunday
2020-07-05,Lok Ma Chau Spur Line,0,0,0,0,0,0,0,0,Sunday
2020-07-05,Hong Kong-Zhuhai-Macao Bridge,70,6,4,80,89,12,2,103,Sunday
2020-07-05,Lok Ma Chau,0,0,0,0,0,0,0,0,Sunday
2020-07-05,Man Kam To,0,0,0,0,0,0,0,0,Sunday
2020-07-05,Sha Tau Kok,0,0,0,0,0,0,0,0,Sunday
2020-07-05,Shenzhen Bay,942,197,13,1152,664,131,4,799,Sunday
2020-07-05,China Ferry Terminal,0,0,0,0,0,0,0,0,Sunday
2020-07-05,Harbour Control,0,0,0,0,0,0,0,0,Sunday
2020-07-05,Kai Tak Cruise Terminal,0,0,0,0,0,0,0,0,Sunday
2020-07-05,Macau Ferry Terminal,0,0,0,0,0,0,0,0,Sunday
2020-07-05,Tuen Mun Ferry Terminal,0,0,0,0,0,0,0,0,Sunday
2020-07-05,Total,2288,209,65,2562,1747,157,157,2061,Sunday
2020-07-07,Airport,1044,8,36,1088,819,18,81,918,Tuesday
2020-07-02,Hong Kong-Zhuhai-Macao Bridge,73,1,3,77,86,9,3,98,Thursday
2020-07-04,Hung Hom,0,0,0,0,0,0,0,0,Saturday
2020-07-04,Lo Wu,0,0,0,0,0,0,0,0,Saturday
2020-07-07,Express Rail Link West Kowloon,0,0,0,0,0,0,0,0,Tuesday
2020-07-07,Hung Hom,0,0,0,0,0,0,0,0,Tuesday
2020-07-07,Lo Wu,0,0,0,0,0,0,0,0,Tuesday
2020-07-07,Lok Ma Chau Spur Line,1186,0,0,1186,1186,0,0,1186,Tuesday
2020-07-07,Hong Kong-Zhuhai-Macao Bridge,104,4,9,117,138,5,8,151,Tuesday
2020-07-07,Lok Ma Chau,0,0,0,0,0,0,0,0,Tuesday
2020-07-07,Man Kam To,0,0,0,0,0,0,0,0,Tuesday
2020-07-07,Sha Tau Kok,0,0,0,0,0,0,0,0,Tuesday
2020-07-07,Shenzhen Bay,1279,155,14,1448,1106,130,6,1242,Tuesday
2020-07-07,China Ferry Terminal,0,0,0,0,0,0,0,0,Tuesday
2020-07-07,Harbour Control,0,0,0,0,0,0,0,0,Tuesday
2020-07-07,Kai Tak Cruise Terminal,0,0,0,0,0,0,0,0,Tuesday
2020-07-07,Macau Ferry Terminal,0,0,0,0,0,0,0,0,Tuesday
2020-07-07,Tuen Mun Ferry Terminal,0,0,0,0,0,0,0,0,Tuesday
2020-07-07,Total,3613,167,59,3839,3249,153,95,3497,Tuesday
2020-07-08,Airport,1091,11,76,1178,774,5,197,976,Wednesday
2020-07-08,Express Rail Link West Kowloon,0,0,0,0,0,0,0,0,Wednesday
2020-07-08,Hung Hom,0,0,0,0,0,0,0,0,Wednesday
2020-07-08,Lo Wu,0,0,0,0,0,0,0,0,Wednesday
2020-07-08,Lok Ma Chau Spur Line,1030,0,0,1030,1030,0,0,1030,Wednesday
2020-07-08,Hong Kong-Zhuhai-Macao Bridge,122,6,6,134,172,7,8,187,Wednesday
2020-07-08,Lok Ma Chau,0,0,0,0,0,0,0,0,Wednesday
2020-07-08,Man Kam To,0,0,0,0,0,0,0,0,Wednesday
2020-07-08,Sha Tau Kok,0,0,0,0,0,0,0,0,Wednesday
2020-07-08,Shenzhen Bay,1428,184,20,1632,1341,175,5,1521,Wednesday
2020-07-08,China Ferry Terminal,0,0,0,0,0,0,0,0,Wednesday
2020-07-08,Harbour Control,0,0,0,0,0,0,0,0,Wednesday
2020-07-08,Macau Ferry Terminal,0,0,0,0,0,0,0,0,Wednesday
2020-07-08,Tuen Mun Ferry Terminal,0,0,0,0,0,0,0,0,Wednesday
2020-07-08,Total,3671,201,102,3974,3317,187,210,3714,Wednesday
2020-07-09,Airport,661,9,44,714,727,21,84,832,Thursday
2020-07-09,Express Rail Link West Kowloon,0,0,0,0,0,0,0,0,Thursday
2020-07-09,Hung Hom,0,0,0,0,0,0,0,0,Thursday
2020-07-09,Lo Wu,0,0,0,0,0,0,0,0,Thursday
2020-07-09,Lok Ma Chau Spur Line,721,0,0,721,721,0,0,721,Thursday
2020-07-09,Hong Kong-Zhuhai-Macao Bridge,98,5,3,106,212,10,8,230,Thursday
2020-07-09,Lok Ma Chau,0,0,0,0,0,0,0,0,Thursday
2020-07-09,Man Kam To,0,0,0,0,0,0,0,0,Thursday
2020-07-09,Sha Tau Kok,0,0,0,0,0,0,0,0,Thursday
2020-07-09,Shenzhen Bay,1336,161,7,1504,1178,195,9,1382,Thursday
2020-07-09,China Ferry Terminal,0,0,0,0,0,0,0,0,Thursday
2020-07-09,Harbour Control,0,0,0,0,0,0,0,0,Thursday
2020-07-09,Kai Tak Cruise Terminal,0,0,0,0,0,0,0,0,Thursday
2020-07-09,Macau Ferry Terminal,0,0,0,0,0,0,0,0,Thursday
2020-07-09,Tuen Mun Ferry Terminal,0,0,0,0,0,0,0,0,Thursday
2020-07-09,Total,2816,175,54,3045,2838,226,101,3165,Thursday
2020-07-10,Airport,1298,2,105,1405,852,29,96,977,Friday
2020-07-10,Express Rail Link West Kowloon,0,0,0,0,0,0,0,0,Friday
2020-07-10,Hung Hom,0,0,0,0,0,0,0,0,Friday
2020-07-10,Lo Wu,0,0,0,0,0,0,0,0,Friday
2020-07-10,Lok Ma Chau Spur Line,827,0,0,827,827,0,0,827,Friday
2020-07-10,Lok Ma Chau,0,0,0,0,0,0,0,0,Friday
2020-07-10,Man Kam To,0,0,0,0,0,0,0,0,Friday
2020-07-10,Sha Tau Kok,0,0,0,0,0,0,0,0,Friday
2020-07-10,Shenzhen Bay,1102,162,10,1274,1567,229,16,1812,Friday
2020-07-10,Harbour Control,0,0,0,0,0,0,0,0,Friday
2020-07-10,Kai Tak Cruise Terminal,0,0,0,0,0,0,0,0,Friday
2020-07-10,Macau Ferry Terminal,0,0,0,0,0,0,0,0,Friday
2020-07-10,Tuen Mun Ferry Terminal,0,0,0,0,0,0,0,0,Friday
2020-07-10,Total,3329,175,120,3624,3485,281,128,3894,Friday
2020-07-11,Airport,1248,13,75,1336,791,19,92,902,Saturday
2020-07-11,Express Rail Link West Kowloon,0,0,0,0,0,0,0,0,Saturday
2020-07-11,Hung Hom,0,0,0,0,0,0,0,0,Saturday
2020-07-11,Lo Wu,0,0,0,0,0,0,0,0,Saturday
2020-07-11,Lok Ma Chau Spur Line,0,0,0,0,0,0,0,0,Saturday
2020-07-11,Lok Ma Chau,0,0,0,0,0,0,0,0,Saturday
2020-07-11,Man Kam To,0,0,0,0,0,0,0,0,Saturday
2020-07-11,Sha Tau Kok,0,0,0,0,0,0,0,0,Saturday
2020-07-11,Shenzhen Bay,737,159,10,906,2017,427,11,2455,Saturday
2020-07-11,China Ferry Terminal,0,0,0,0,0,0,0,0,Saturday
2020-07-11,Harbour Control,0,0,0,0,0,0,0,0,Saturday
2020-07-11,Kai Tak Cruise Terminal,0,0,0,0,0,0,0,0,Saturday
2020-07-11,Macau Ferry Terminal,0,0,0,0,0,0,0,0,Saturday
2020-07-11,Tuen Mun Ferry Terminal,0,0,0,0,0,0,0,0,Saturday
2020-07-11,Total,2060,174,92,2326,3071,487,112,3670,Saturday
2020-07-12,Airport,1105,10,79,1194,1114,61,109,1284,Sunday
2020-07-12,Express Rail Link West Kowloon,0,0,0,0,0,0,0,0,Sunday
2020-07-12,Hung Hom,0,0,0,0,0,0,0,0,Sunday
2020-07-12,Lo Wu,0,0,0,0,0,0,0,0,Sunday
2020-07-12,Lok Ma Chau Spur Line,0,0,0,0,0,0,0,0,Sunday
2020-07-12,Hong Kong-Zhuhai-Macao Bridge,71,6,9,86,259,34,5,298,Sunday
2020-07-12,Lok Ma Chau,0,0,0,0,0,0,0,0,Sunday
2020-07-12,Man Kam To,0,0,0,0,0,0,0,0,Sunday
2020-07-12,Sha Tau Kok,0,0,0,0,0,0,0,0,Sunday
2020-07-12,Shenzhen Bay,826,116,7,949,1528,339,17,1884,Sunday
2020-07-12,China Ferry Terminal,0,0,0,0,0,0,0,0,Sunday
2020-07-12,Harbour Control,0,0,0,0,0,0,0,0,Sunday
2020-07-12,Kai Tak Cruise Terminal,0,0,0,0,0,0,0,0,Sunday
2020-07-12,Macau Ferry Terminal,0,0,0,0,0,0,0,0,Sunday
2020-07-12,Tuen Mun Ferry Terminal,0,0,0,0,0,0,0,0,Sunday
2020-07-12,Total,2002,132,95,2229,2901,434,131,3466,Sunday
2020-07-13,Airport,731,9,55,795,326,30,62,418,Monday
2020-07-13,Express Rail Link West Kowloon,0,0,0,0,0,0,0,0,Monday
2020-07-13,Hung Hom,0,0,0,0,0,0,0,0,Monday
2020-07-13,Lo Wu,0,0,0,0,0,0,0,0,Monday
2020-07-13,Lok Ma Chau Spur Line,151,0,0,151,151,0,0,151,Monday
2020-07-13,Lok Ma Chau,0,0,0,0,0,0,0,0,Monday
2020-07-13,Man Kam To,0,0,0,0,0,0,0,0,Monday
2020-07-13,Sha Tau Kok,0,0,0,0,0,0,0,0,Monday
2020-07-13,Shenzhen Bay,935,109,11,1055,2326,355,21,2702,Monday
2020-07-13,China Ferry Terminal,0,0,0,0,0,0,0,0,Monday
2020-07-13,Harbour Control,0,0,0,0,0,0,0,0,Monday
2020-07-13,Kai Tak Cruise Terminal,0,0,0,0,0,0,0,0,Monday
2020-07-13,Macau Ferry Terminal,0,0,0,0,0,0,0,0,Monday
2020-07-13,Tuen Mun Ferry Terminal,0,0,0,0,0,0,0,0,Monday
2020-07-13,Total,1916,120,69,2105,3196,428,87,3711,Monday
2020-07-14,Airport,768,8,55,831,1082,66,84,1232,Tuesday
2020-07-14,Express Rail Link West Kowloon,0,0,0,0,0,0,0,0,Tuesday
2020-07-14,Hung Hom,0,0,0,0,0,0,0,0,Tuesday
2020-07-14,Lo Wu,0,0,0,0,0,0,0,0,Tuesday
2020-07-14,Lok Ma Chau Spur Line,57,0,0,57,57,0,0,57,Tuesday
2020-07-14,Hong Kong-Zhuhai-Macao Bridge,47,2,1,50,516,65,5,586,Tuesday
2020-07-14,Lok Ma Chau,0,0,0,0,0,0,0,0,Tuesday
2020-07-14,Man Kam To,0,0,0,0,0,0,0,0,Tuesday
2020-07-14,Sha Tau Kok,0,0,0,0,0,0,0,0,Tuesday
2020-07-14,Shenzhen Bay,715,88,7,810,2694,469,19,3182,Tuesday
2020-07-14,China Ferry Terminal,0,0,0,0,0,0,0,0,Tuesday
2020-07-14,Harbour Control,0,0,0,0,0,0,0,0,Tuesday
2020-07-14,Kai Tak Cruise Terminal,0,0,0,0,0,0,0,0,Tuesday
2020-07-14,Macau Ferry Terminal,0,0,0,0,0,0,0,0,Tuesday
2020-07-14,Tuen Mun Ferry Terminal,0,0,0,0,0,0,0,0,Tuesday
2020-07-14,Total,1587,98,63,1748,4349,600,108,5057,Tuesday
2020-07-15,Airport,1035,3,58,1096,880,20,74,974,Wednesday
2020-07-15,Hung Hom,0,0,0,0,0,0,0,0,Wednesday
2020-07-15,Lo Wu,0,0,0,0,0,0,0,0,Wednesday
2020-07-15,Lok Ma Chau Spur Line,65,0,0,65,65,0,0,65,Wednesday
2020-07-15,Hong Kong-Zhuhai-Macao Bridge,98,3,3,104,637,87,8,732,Wednesday
2020-07-15,Lok Ma Chau,0,0,0,0,0,0,0,0,Wednesday
2020-07-15,Man Kam To,0,0,0,0,0,0,0,0,Wednesday
2020-07-15,Sha Tau Kok,0,0,0,0,0,0,0,0,Wednesday
2020-07-15,Shenzhen Bay,752,83,7,842,2660,470,16,3146,Wednesday
2020-07-15,China Ferry Terminal,0,0,0,0,0,0,0,0,Wednesday
2020-07-15,Harbour Control,0,0,0,0,0,0,0,0,Wednesday
2020-07-15,Kai Tak Cruise Terminal,0,0,0,0,0,0,0,0,Wednesday
2020-07-15,Macau Ferry Terminal,0,0,0,0,0,0,0,0,Wednesday
2020-07-15,Tuen Mun Ferry Terminal,0,0,0,0,0,0,0,0,Wednesday
2020-07-15,Total,1950,89,68,2107,4242,577,98,4917,Wednesday
2020-07-16,Airport,516,3,28,547,706,24,36,766,Thursday
2020-07-16,Express Rail Link West Kowloon,0,0,0,0,0,0,0,0,Thursday
2020-07-16,Hung Hom,0,0,0,0,0,0,0,0,Thursday
2020-07-16,Lo Wu,0,0,0,0,0,0,0,0,Thursday
2020-07-16,Lok Ma Chau Spur Line,58,0,0,58,58,0,0,58,Thursday
2020-07-16,Hong Kong-Zhuhai-Macao Bridge,91,5,8,104,538,66,8,612,Thursday
2020-07-16,Man Kam To,0,0,0,0,0,0,0,0,Thursday
2020-07-16,Sha Tau Kok,0,0,0,0,0,0,0,0,Thursday
2020-07-16,Shenzhen Bay,651,85,8,744,2576,346,16,2938,Thursday
2020-07-16,Harbour Control,0,0,0,0,0,0,0,0,Thursday
2020-07-16,Kai Tak Cruise Terminal,0,0,0,0,0,0,0,0,Thursday
2020-07-16,Macau Ferry Terminal,0,0,0,0,0,0,0,0,Thursday
2020-07-16,Tuen Mun Ferry Terminal,0,0,0,0,0,0,0,0,Thursday
2020-07-16,Total,1316,93,44,1453,3878,436,60,4374,Thursday
2020-07-17,Airport,1073,7,82,1162,1209,51,72,1332,Friday
2020-07-17,Express Rail Link West Kowloon,0,0,0,0,0,0,0,0,Friday
2020-07-17,Hung Hom,0,0,0,0,0,0,0,0,Friday
2020-07-17,Lo Wu,0,0,0,0,0,0,0,0,Friday
2020-07-17,Lok Ma Chau Spur Line,37,0,0,37,37,0,0,37,Friday
2020-07-17,Hong Kong-Zhuhai-Macao Bridge,69,2,3,74,94,1,3,98,Friday
2020-07-17,Lok Ma Chau,0,0,0,0,0,0,0,0,Friday
2020-07-17,Man Kam To,0,0,0,0,0,0,0,0,Friday
2020-07-17,Sha Tau Kok,0,0,0,0,0,0,0,0,Friday
2020-07-17,Shenzhen Bay,588,54,16,658,360,45,11,416,Friday
2020-07-17,China Ferry Terminal,0,0,0,0,0,0,0,0,Friday
2020-07-17,Harbour Control,0,0,0,0,0,0,0,0,Friday
2020-07-17,Kai Tak Cruise Terminal,0,0,0,0,0,0,0,0,Friday
2020-07-17,Macau Ferry Terminal,0,0,0,0,0,0,0,0,Friday
2020-07-17,Tuen Mun Ferry Terminal,0,0,0,0,0,0,0,0,Friday
2020-07-17,Total,1767,63,101,1931,1700,97,86,1883,Friday
2020-07-18,Airport,693,12,45,750,1074,65,69,1208,Saturday
2020-07-18,Hung Hom,0,0,0,0,0,0,0,0,Saturday
2020-07-18,Lo Wu,0,0,0,0,0,0,0,0,Saturday
2020-07-18,Lok Ma Chau Spur Line,0,0,0,0,0,0,0,0,Saturday
2020-07-18,Hong Kong-Zhuhai-Macao Bridge,58,3,5,66,153,16,7,176,Saturday
2020-07-18,Lok Ma Chau,0,0,0,0,0,0,0,0,Saturday
2020-07-18,Man Kam To,0,0,0,0,0,0,0,0,Saturday
2020-07-18,Sha Tau Kok,0,0,0,0,0,0,0,0,Saturday
2020-07-18,Shenzhen Bay,472,75,4,551,745,68,9,822,Saturday
2020-07-18,China Ferry Terminal,0,0,0,0,0,0,0,0,Saturday
2020-07-18,Harbour Control,0,0,0,0,0,0,0,0,Saturday
2020-07-18,Kai Tak Cruise Terminal,0,0,0,0,0,0,0,0,Saturday
2020-07-18,Macau Ferry Terminal,0,0,0,0,0,0,0,0,Saturday
2020-07-18,Tuen Mun Ferry Terminal,0,0,0,0,0,0,0,0,Saturday
2020-07-18,Total,1223,90,54,1367,1972,149,85,2206,Saturday
2020-07-19,Airport,912,2,42,956,1428,73,109,1610,Sunday
2020-07-19,Express Rail Link West Kowloon,0,0,0,0,0,0,0,0,Sunday
2020-07-19,Hung Hom,0,0,0,0,0,0,0,0,Sunday
2020-07-19,Lo Wu,0,0,0,0,0,0,0,0,Sunday
2020-07-19,Lok Ma Chau Spur Line,0,0,0,0,0,0,0,0,Sunday
2020-07-19,Hong Kong-Zhuhai-Macao Bridge,32,4,5,41,141,5,4,150,Sunday
2020-07-19,Lok Ma Chau,0,0,0,0,0,0,0,0,Sunday
2020-07-19,Man Kam To,0,0,0,0,0,0,0,0,Sunday
2020-07-19,Sha Tau Kok,0,0,0,0,0,0,0,0,Sunday
2020-07-19,Shenzhen Bay,435,78,7,520,674,109,7,790,Sunday
2020-07-19,China Ferry Terminal,0,0,0,0,0,0,0,0,Sunday
2020-07-19,Harbour Control,0,0,0,0,0,0,0,0,Sunday
2020-07-19,Kai Tak Cruise Terminal,0,0,0,0,0,0,0,0,Sunday
2020-07-19,Macau Ferry Terminal,0,0,0,0,0,0,0,0,Sunday
2020-07-19,Total,1379,84,54,1517,2243,187,120,2550,Sunday
2020-07-20,Airport,605,2,27,634,794,41,113,948,Monday
2020-07-20,Express Rail Link West Kowloon,0,0,0,0,0,0,0,0,Monday
2020-07-20,Hung Hom,0,0,0,0,0,0,0,0,Monday
2020-07-20,Lo Wu,0,0,0,0,0,0,0,0,Monday
2020-07-20,Lok Ma Chau Spur Line,0,0,0,0,0,0,0,0,Monday
2020-07-20,Hong Kong-Zhuhai-Macao Bridge,45,3,2,50,156,11,2,169,Monday
2020-07-20,Lok Ma Chau,0,0,0,0,0,0,0,0,Monday
2020-07-20,Man Kam To,0,0,0,0,0,0,0,0,Monday
2020-07-20,Sha Tau Kok,0,0,0,0,0,0,0,0,Monday
2020-07-20,Shenzhen Bay,535,68,12,615,798,114,18,930,Monday
2020-07-20,China Ferry Terminal,0,0,0,0,0,0,0,0,Monday
2020-07-20,Harbour Control,0,0,0,0,0,0,0,0,Monday
2020-07-20,Kai Tak Cruise Terminal,0,0,0,0,0,0,0,0,Monday
2020-07-20,Macau Ferry Terminal,0,0,0,0,0,0,0,0,Monday
2020-07-20,Tuen Mun Ferry Terminal,0,0,0,0,0,0,0,0,Monday
2020-07-20,Total,1185,73,41,1299,1748,166,133,2047,Monday
2020-07-21,Airport,728,3,49,780,1501,95,72,1668,Tuesday
2020-07-21,Express Rail Link West Kowloon,0,0,0,0,0,0,0,0,Tuesday
2020-07-21,Hung Hom,0,0,0,0,0,0,0,0,Tuesday
2020-07-21,Lo Wu,0,0,0,0,0,0,0,0,Tuesday
2020-07-21,Lok Ma Chau Spur Line,0,0,0,0,0,0,0,0,Tuesday
2020-07-21,Lok Ma Chau,0,0,0,0,0,0,0,0,Tuesday
2020-07-21,Man Kam To,0,0,0,0,0,0,0,0,Tuesday
2020-07-21,Sha Tau Kok,0,0,0,0,0,0,0,0,Tuesday
2020-07-21,Shenzhen Bay,386,45,6,437,1126,141,18,1285,Tuesday
2020-07-21,China Ferry Terminal,0,0,0,0,0,0,0,0,Tuesday
2020-07-21,Harbour Control,0,0,0,0,0,0,0,0,Tuesday
2020-07-21,Kai Tak Cruise Terminal,0,0,0,0,0,0,0,0,Tuesday
2020-07-21,Macau Ferry Terminal,0,0,0,0,0,0,0,0,Tuesday
2020-07-21,Tuen Mun Ferry Terminal,0,0,0,0,0,0,0,0,Tuesday
2020-07-21,Total,1149,50,55,1254,2827,248,93,3168,Tuesday
2020-07-22,Airport,1089,3,47,1139,1064,41,68,1173,Wednesday
2020-07-22,Express Rail Link West Kowloon,0,0,0,0,0,0,0,0,Wednesday
2020-07-22,Hung Hom,0,0,0,0,0,0,0,0,Wednesday
2020-07-22,Lo Wu,0,0,0,0,0,0,0,0,Wednesday
2020-07-22,Hong Kong-Zhuhai-Macao Bridge,47,1,5,53,279,26,5,310,Wednesday
2020-07-22,Lok Ma Chau,0,0,0,0,0,0,0,0,Wednesday
2020-07-22,Man Kam To,0,0,0,0,0,0,0,0,Wednesday
2020-07-22,Sha Tau Kok,0,0,0,0,0,0,0,0,Wednesday
2020-07-22,Shenzhen Bay,326,46,6,378,1702,215,10,1927,Wednesday
2020-07-22,China Ferry Terminal,0,0,0,0,0,0,0,0,Wednesday
2020-07-22,Harbour Control,0,0,0,0,0,0,0,0,Wednesday
2020-07-22,Macau Ferry Terminal,0,0,0,0,0,0,0,0,Wednesday
2020-07-22,Tuen Mun Ferry Terminal,0,0,0,0,0,0,0,0,Wednesday
2020-07-22,Total,1462,50,58,1570,3045,282,83,3410,Wednesday
2020-07-23,Airport,453,5,11,469,1165,32,195,1392,Thursday
2020-07-23,Express Rail Link West Kowloon,0,0,0,0,0,0,0,0,Thursday
2020-07-23,Hung Hom,0,0,0,0,0,0,0,0,Thursday
2020-07-23,Lo Wu,0,0,0,0,0,0,0,0,Thursday
2020-07-23,Lok Ma Chau Spur Line,0,0,0,0,0,0,0,0,Thursday
2020-07-23,Hong Kong-Zhuhai-Macao Bridge,37,1,8,46,252,20,5,277,Thursday
2020-07-23,Lok Ma Chau,0,0,0,0,0,0,0,0,Thursday
2020-07-23,Man Kam To,0,0,0,0,0,0,0,0,Thursday
2020-07-23,Sha Tau Kok,0,0,0,0,0,0,0,0,Thursday
2020-07-23,Shenzhen Bay,301,37,20,358,1590,210,16,1816,Thursday
2020-07-23,China Ferry Terminal,0,0,0,0,0,0,0,0,Thursday
2020-07-23,Harbour Control,0,0,0,0,0,0,0,0,Thursday
2020-07-23,Kai Tak Cruise Terminal,0,0,0,0,0,0,0,0,Thursday
2020-07-23,Macau Ferry Terminal,0,0,0,0,0,0,0,0,Thursday
2020-07-23,Tuen Mun Ferry Terminal,0,0,0,0,0,0,0,0,Thursday
2020-07-23,Total,791,43,39,873,3007,262,216,3485,Thursday
2020-07-24,Airport,1069,5,42,1116,1386,56,101,1543,Friday
2020-07-24,Express Rail Link West Kowloon,0,0,0,0,0,0,0,0,Friday
2020-07-24,Hung Hom,0,0,0,0,0,0,0,0,Friday
2020-07-24,Lo Wu,0,0,0,0,0,0,0,0,Friday
2020-07-24,Lok Ma Chau Spur Line,0,0,0,0,0,0,0,0,Friday
2020-07-24,Lok Ma Chau,0,0,0,0,0,0,0,0,Friday
2020-07-24,Man Kam To,0,0,0,0,0,0,0,0,Friday
2020-07-24,Sha Tau Kok,0,0,0,0,0,0,0,0,Friday
2020-07-24,Shenzhen Bay,277,48,0,325,1853,234,16,2103,Friday
2020-07-24,China Ferry Terminal,0,0,0,0,0,0,0,0,Friday
2020-07-24,Harbour Control,0,0,0,0,0,0,0,0,Friday
2020-07-24,Kai Tak Cruise Terminal,0,0,0,0,0,0,0,0,Friday
2020-07-24,Macau Ferry Terminal,0,0,0,0,0,0,0,0,Friday
2020-07-24,Tuen Mun Ferry Terminal,0,0,0,0,0,0,0,0,Friday
2020-07-24,Total,1382,53,44,1479,3489,308,130,3927,Friday
2020-07-25,Airport,577,6,21,604,1280,68,55,1403,Saturday
2020-07-25,Express Rail Link West Kowloon,0,0,0,0,0,0,0,0,Saturday
2020-07-25,Hung Hom,0,0,0,0,0,0,0,0,Saturday
2020-07-25,Lo Wu,0,0,0,0,0,0,0,0,Saturday
2020-07-25,Lok Ma Chau Spur Line,0,0,0,0,0,0,0,0,Saturday
2020-07-25,Hong Kong-Zhuhai-Macao Bridge,29,2,1,32,252,17,4,273,Saturday
2020-07-25,Lok Ma Chau,0,0,0,0,0,0,0,0,Saturday
2020-07-25,Man Kam To,0,0,0,0,0,0,0,0,Saturday
2020-07-25,Sha Tau Kok,0,0,0,0,0,0,0,0,Saturday
2020-07-25,Shenzhen Bay,300,51,5,356,1945,256,6,2207,Saturday
2020-07-25,China Ferry Terminal,0,0,0,0,0,0,0,0,Saturday
2020-07-25,Harbour Control,0,0,0,0,0,0,0,0,Saturday
2020-07-25,Kai Tak Cruise Terminal,0,0,0,0,0,0,0,0,Saturday
2020-07-25,Macau Ferry Terminal,0,0,0,0,0,0,0,0,Saturday
2020-07-25,Tuen Mun Ferry Terminal,0,0,0,0,0,0,0,0,Saturday
2020-07-25,Total,906,59,27,992,3477,341,65,3883,Saturday
2020-07-26,Airport,759,4,49,812,1653,85,73,1811,Sunday
2020-07-26,Express Rail Link West Kowloon,0,0,0,0,0,0,0,0,Sunday
2020-07-26,Hung Hom,0,0,0,0,0,0,0,0,Sunday
2020-07-26,Lo Wu,0,0,0,0,0,0,0,0,Sunday
2020-07-26,Lok Ma Chau Spur Line,0,0,0,0,0,0,0,0,Sunday
2020-07-26,Lok Ma Chau,0,0,0,0,0,0,0,0,Sunday
2020-07-26,Man Kam To,0,0,0,0,0,0,0,0,Sunday
2020-07-26,Sha Tau Kok,0,0,0,0,0,0,0,0,Sunday
2020-07-26,Shenzhen Bay,280,33,8,321,999,113,7,1119,Sunday
2020-07-26,China Ferry Terminal,0,0,0,0,0,0,0,0,Sunday
2020-07-26,Harbour Control,0,0,0,0,0,0,0,0,Sunday
2020-07-26,Kai Tak Cruise Terminal,0,0,0,0,0,0,0,0,Sunday
2020-07-26,Macau Ferry Terminal,0,0,0,0,0,0,0,0,Sunday
2020-07-26,Tuen Mun Ferry Terminal,0,0,0,0,0,0,0,0,Sunday
2020-07-26,Total,1053,38,63,1154,2896,218,84,3198,Sunday
2020-07-27,Airport,517,5,25,547,575,33,42,650,Monday
2020-07-27,Express Rail Link West Kowloon,0,0,0,0,0,0,0,0,Monday
2020-07-27,Hung Hom,0,0,0,0,0,0,0,0,Monday
2020-07-27,Lo Wu,0,0,0,0,0,0,0,0,Monday
2020-07-27,Lok Ma Chau Spur Line,0,0,0,0,0,0,0,0,Monday
2020-07-27,Hong Kong-Zhuhai-Macao Bridge,21,3,4,28,117,3,7,127,Monday
2020-07-27,Lok Ma Chau,0,0,0,0,0,0,0,0,Monday
2020-07-27,Man Kam To,0,0,0,0,0,0,0,0,Monday
2020-07-27,Sha Tau Kok,0,0,0,0,0,0,0,0,Monday
2020-07-27,Shenzhen Bay,286,35,6,327,578,86,5,669,Monday
2020-07-27,China Ferry Terminal,0,0,0,0,0,0,0,0,Monday
2020-07-27,Harbour Control,0,0,0,0,0,0,0,0,Monday
2020-07-27,Kai Tak Cruise Terminal,0,0,0,0,0,0,0,0,Monday
2020-07-27,Macau Ferry Terminal,0,0,0,0,0,0,0,0,Monday
2020-07-27,Tuen Mun Ferry Terminal,0,0,0,0,0,0,0,0,Monday
2020-07-27,Total,824,43,35,902,1270,122,54,1446,Monday
2020-07-28,Airport,869,10,47,926,1379,62,84,1525,Tuesday
2020-07-28,Hung Hom,0,0,0,0,0,0,0,0,Tuesday
2020-07-28,Lo Wu,0,0,0,0,0,0,0,0,Tuesday
2020-07-28,Lok Ma Chau Spur Line,0,0,0,0,0,0,0,0,Tuesday
2020-07-28,Hong Kong-Zhuhai-Macao Bridge,21,0,8,29,222,12,1,235,Tuesday
2020-07-28,Lok Ma Chau,0,0,0,0,0,0,0,0,Tuesday
2020-07-28,Man Kam To,0,0,0,0,0,0,0,0,Tuesday
2020-07-28,Sha Tau Kok,0,0,0,0,0,0,0,0,Tuesday
2020-07-28,Shenzhen Bay,281,37,9,327,1098,125,6,1229,Tuesday
2020-07-28,China Ferry Terminal,0,0,0,0,0,0,0,0,Tuesday
2020-07-28,Harbour Control,0,0,0,0,0,0,0,0,Tuesday
2020-07-28,Kai Tak Cruise Terminal,0,0,0,0,0,0,0,0,Tuesday
2020-07-28,Macau Ferry Terminal,0,0,0,0,0,0,0,0,Tuesday
2020-07-28,Tuen Mun Ferry Terminal,0,0,0,0,0,0,0,0,Tuesday
2020-07-28,Total,1171,47,64,1282,2699,199,91,2989,Tuesday
2020-07-29,Airport,333,0,23,356,1143,28,53,1224,Wednesday
2020-07-29,Express Rail Link West Kowloon,0,0,0,0,0,0,0,0,Wednesday
2020-07-29,Hung Hom,0,0,0,0,0,0,0,0,Wednesday
2020-07-29,Lo Wu,0,0,0,0,0,0,0,0,Wednesday
2020-07-29,Lok Ma Chau Spur Line,0,0,0,0,0,0,0,0,Wednesday
2020-07-29,Lok Ma Chau,0,0,0,0,0,0,0,0,Wednesday
2020-07-29,Man Kam To,0,0,0,0,0,0,0,0,Wednesday
2020-07-29,Sha Tau Kok,0,0,0,0,0,0,0,0,Wednesday
2020-07-29,Shenzhen Bay,306,25,4,335,2295,267,14,2576,Wednesday
2020-07-29,China Ferry Terminal,0,0,0,0,0,0,0,0,Wednesday
2020-07-29,Harbour Control,0,0,0,0,0,0,0,0,Wednesday
2020-07-29,Kai Tak Cruise Terminal,0,0,0,0,0,0,0,0,Wednesday
2020-07-29,Macau Ferry Terminal,0,0,0,0,0,0,0,0,Wednesday
2020-07-29,Tuen Mun Ferry Terminal,0,0,0,0,0,0,0,0,Wednesday
2020-07-29,Total,675,25,34,734,3729,311,73,4113,Wednesday
2020-07-30,Airport,250,3,20,273,779,23,36,838,Thursday
2020-07-30,Express Rail Link West Kowloon,0,0,0,0,0,0,0,0,Thursday
2020-07-30,Hung Hom,0,0,0,0,0,0,0,0,Thursday
2020-07-30,Lo Wu,0,0,0,0,0,0,0,0,Thursday
2020-07-30,Lok Ma Chau Spur Line,0,0,0,0,0,0,0,0,Thursday
2020-07-30,Hong Kong-Zhuhai-Macao Bridge,39,2,1,42,321,20,9,350,Thursday
2020-07-30,Lok Ma Chau,0,0,0,0,0,0,0,0,Thursday
2020-07-30,Man Kam To,0,0,0,0,0,0,0,0,Thursday
2020-07-30,Sha Tau Kok,0,0,0,0,0,0,0,0,Thursday
2020-07-30,Shenzhen Bay,309,36,3,348,1941,228,3,2172,Thursday
2020-07-30,China Ferry Terminal,0,0,0,0,0,0,0,0,Thursday
2020-07-30,Harbour Control,0,0,0,0,0,0,0,0,Thursday
2020-07-30,Kai Tak Cruise Terminal,0,0,0,0,0,0,0,0,Thursday
2020-07-30,Macau Ferry Terminal,0,0,0,0,0,0,0,0,Thursday
2020-07-30,Tuen Mun Ferry Terminal,0,0,0,0,0,0,0,0,Thursday
2020-07-30,Total,598,41,24,663,3041,271,48,3360,Thursday
2020-07-31,Airport,568,3,65,636,1681,57,98,1836,Friday
2020-07-31,Hung Hom,0,0,0,0,0,0,0,0,Friday
2020-07-31,Lo Wu,0,0,0,0,0,0,0,0,Friday
2020-07-31,Lok Ma Chau Spur Line,0,0,0,0,0,0,0,0,Friday
2020-07-31,Hong Kong-Zhuhai-Macao Bridge,56,1,4,61,288,14,5,307,Friday
2020-07-31,Lok Ma Chau,0,0,0,0,0,0,0,0,Friday
2020-07-31,Man Kam To,0,0,0,0,0,0,0,0,Friday
2020-07-31,Sha Tau Kok,0,0,0,0,0,0,0,0,Friday
2020-07-31,Shenzhen Bay,359,39,4,402,2336,301,4,2641,Friday
2020-07-31,China Ferry Terminal,0,0,0,0,0,0,0,0,Friday
2020-07-31,Harbour Control,0,0,0,0,0,0,0,0,Friday
2020-07-31,Kai Tak Cruise Terminal,0,0,0,0,0,0,0,0,Friday
2020-07-31,Macau Ferry Terminal,0,0,0,0,0,0,0,0,Friday
2020-07-31,Tuen Mun Ferry Terminal,0,0,0,0,0,0,0,0,Friday
2020-07-31,Total,983,43,73,1099,4305,372,107,4784,Friday
2020-08-01,Airport,571,5,11,587,1800,80,82,1962,Saturday
2020-08-01,Express Rail Link West Kowloon,0,0,0,0,0,0,0,0,Saturday
2020-08-01,Hung Hom,0,0,0,0,0,0,0,0,Saturday
2020-08-01,Lo Wu,0,0,0,0,0,0,0,0,Saturday
2020-08-01,Lok Ma Chau Spur Line,0,0,0,0,0,0,0,0,Saturday
2020-08-01,Hong Kong-Zhuhai-Macao Bridge,29,1,4,34,242,21,4,267,Saturday
2020-08-01,Lok Ma Chau,0,0,0,0,0,0,0,0,Saturday
2020-08-01,Man Kam To,0,0,0,0,0,0,0,0,Saturday
2020-08-01,Sha Tau Kok,0,0,0,0,0,0,0,0,Saturday
2020-08-01,Shenzhen Bay,350,50,4,404,1861,219,10,2090,Saturday
2020-08-01,China Ferry Terminal,0,0,0,0,0,0,0,0,Saturday
2020-08-01,Harbour Control,0,0,0,0,0,0,0,0,Saturday
2020-08-01,Kai Tak Cruise Terminal,0,0,0,0,0,0,0,0,Saturday
2020-08-01,Macau Ferry Terminal,0,0,0,0,0,0,0,0,Saturday
2020-08-01,Tuen Mun Ferry Terminal,0,0,0,0,0,0,0,0,Saturday
2020-08-01,Total,950,56,19,1025,3903,320,96,4319,Saturday
2020-08-02,Airport,674,3,46,723,1663,59,96,1818,Sunday
2020-08-02,Hung Hom,0,0,0,0,0,0,0,0,Sunday
2020-08-02,Lo Wu,0,0,0,0,0,0,0,0,Sunday
2020-08-02,Lok Ma Chau Spur Line,0,0,0,0,0,0,0,0,Sunday
2020-08-02,Hong Kong-Zhuhai-Macao Bridge,32,2,8,42,233,19,0,252,Sunday
2020-08-02,Lok Ma Chau,0,0,0,0,0,0,0,0,Sunday
2020-08-02,Man Kam To,0,0,0,0,0,0,0,0,Sunday
2020-08-02,Sha Tau Kok,0,0,0,0,0,0,0,0,Sunday
2020-08-02,Shenzhen Bay,338,29,5,372,1032,106,4,1142,Sunday
2020-08-02,China Ferry Terminal,0,0,0,0,0,0,0,0,Sunday
2020-08-02,Harbour Control,0,0,0,0,0,0,0,0,Sunday
2020-08-02,Kai Tak Cruise Terminal,0,0,0,0,0,0,0,0,Sunday
2020-08-02,Tuen Mun Ferry Terminal,0,0,0,0,0,0,0,0,Sunday
2020-08-02,Total,1044,34,59,1137,2928,184,100,3212,Sunday
2020-08-03,Airport,416,2,14,432,883,24,112,1019,Monday
2020-08-03,Hung Hom,0,0,0,0,0,0,0,0,Monday
2020-08-03,Lo Wu,0,0,0,0,0,0,0,0,Monday
2020-08-03,Lok Ma Chau Spur Line,0,0,0,0,0,0,0,0,Monday
2020-08-03,Hong Kong-Zhuhai-Macao Bridge,28,4,11,43,157,4,2,163,Monday
2020-08-03,Lok Ma Chau,0,0,0,0,0,0,0,0,Monday
2020-08-03,Man Kam To,0,0,0,0,0,0,0,0,Monday
2020-08-03,Sha Tau Kok,0,0,0,0,0,0,0,0,Monday
2020-08-03,Shenzhen Bay,428,22,9,459,498,61,1,560,Monday
2020-08-03,China Ferry Terminal,0,0,0,0,0,0,0,0,Monday
2020-08-03,Harbour Control,0,0,0,0,0,0,0,0,Monday
2020-08-03,Kai Tak Cruise Terminal,0,0,0,0,0,0,0,0,Monday
2020-08-03,Macau Ferry Terminal,0,0,0,0,0,0,0,0,Monday
2020-08-03,Tuen Mun Ferry Terminal,0,0,0,0,0,0,0,0,Monday
2020-08-03,Total,872,28,34,934,1538,89,115,1742,Monday
2020-08-04,Airport,693,3,34,730,1440,61,91,1592,Tuesday
2020-08-04,Express Rail Link West Kowloon,0,0,0,0,0,0,0,0,Tuesday
2020-08-04,Hung Hom,0,0,0,0,0,0,0,0,Tuesday
2020-08-04,Lo Wu,0,0,0,0,0,0,0,0,Tuesday
2020-08-04,Lok Ma Chau Spur Line,0,0,0,0,0,0,0,0,Tuesday
2020-08-04,Hong Kong-Zhuhai-Macao Bridge,29,2,5,36,188,21,7,216,Tuesday
2020-08-04,Lok Ma Chau,0,0,0,0,0,0,0,0,Tuesday
2020-08-04,Man Kam To,0,0,0,0,0,0,0,0,Tuesday
2020-08-04,Sha Tau Kok,0,0,0,0,0,0,0,0,Tuesday
2020-08-04,Shenzhen Bay,312,30,6,348,939,103,6,1048,Tuesday
2020-08-04,China Ferry Terminal,0,0,0,0,0,0,0,0,Tuesday
2020-08-04,Harbour Control,0,0,0,0,0,0,0,0,Tuesday
2020-08-04,Kai Tak Cruise Terminal,0,0,0,0,0,0,0,0,Tuesday
2020-08-04,Macau Ferry Terminal,0,0,0,0,0,0,0,0,Tuesday
2020-08-04,Tuen Mun Ferry Terminal,0,0,0,0,0,0,0,0,Tuesday
2020-08-04,Total,1034,35,45,1114,2567,185,104,2856,Tuesday
2020-08-05,Airport,683,3,40,726,857,27,42,926,Wednesday
2020-08-05,Hung Hom,0,0,0,0,0,0,0,0,Wednesday
2020-08-05,Lo Wu,0,0,0,0,0,0,0,0,Wednesday
2020-08-05,Lok Ma Chau Spur Line,0,0,0,0,0,0,0,0,Wednesday
2020-08-05,Hong Kong-Zhuhai-Macao Bridge,31,0,8,39,255,14,10,279,Wednesday
2020-08-05,Lok Ma Chau,0,0,0,0,0,0,0,0,Wednesday
2020-08-05,Man Kam To,0,0,0,0,0,0,0,0,Wednesday
2020-08-05,Sha Tau Kok,0,0,0,0,0,0,0,0,Wednesday
2020-08-05,Shenzhen Bay,301,29,6,336,1832,226,6,2064,Wednesday
2020-08-05,China Ferry Terminal,0,0,0,0,0,0,0,0,Wednesday
2020-08-05,Harbour Control,0,0,0,0,0,0,0,0,Wednesday
2020-08-05,Kai Tak Cruise Terminal,0,0,0,0,0,0,0,0,Wednesday
2020-08-05,Macau Ferry Terminal,0,0,0,0,0,0,0,0,Wednesday
2020-08-05,Tuen Mun Ferry Terminal,0,0,0,0,0,0,0,0,Wednesday
2020-08-05,Total,1015,32,54,1101,2944,267,58,3269,Wednesday
2020-08-06,Airport,373,3,20,396,1195,32,99,1326,Thursday
2020-08-06,Express Rail Link West Kowloon,0,0,0,0,0,0,0,0,Thursday
2020-08-06,Hung Hom,0,0,0,0,0,0,0,0,Thursday
2020-08-06,Lo Wu,0,0,0,0,0,0,0,0,Thursday
2020-08-06,Lok Ma Chau Spur Line,0,0,0,0,0,0,0,0,Thursday
2020-08-06,Hong Kong-Zhuhai-Macao Bridge,41,2,5,48,284,14,7,305,Thursday
2020-08-06,Lok Ma Chau,0,0,0,0,0,0,0,0,Thursday
2020-08-06,Man Kam To,0,0,0,0,0,0,0,0,Thursday
2020-08-06,Sha Tau Kok,0,0,0,0,0,0,0,0,Thursday
2020-08-06,Shenzhen Bay,347,37,2,386,2262,302,5,2569,Thursday
2020-08-06,China Ferry Terminal,0,0,0,0,0,0,0,0,Thursday
2020-08-06,Harbour Control,0,0,0,0,0,0,0,0,Thursday
2020-08-06,Kai Tak Cruise Terminal,0,0,0,0,0,0,0,0,Thursday
2020-08-06,Tuen Mun Ferry Terminal,0,0,0,0,0,0,0,0,Thursday
2020-08-06,Total,761,42,27,830,3741,348,111,4200,Thursday
2020-08-07,Airport,672,5,46,723,1312,32,117,1461,Friday
2020-08-07,Express Rail Link West Kowloon,0,0,0,0,0,0,0,0,Friday
2020-08-07,Hung Hom,0,0,0,0,0,0,0,0,Friday
2020-08-07,Lo Wu,0,0,0,0,0,0,0,0,Friday
2020-08-07,Lok Ma Chau Spur Line,0,0,0,0,0,0,0,0,Friday
2020-08-07,Hong Kong-Zhuhai-Macao Bridge,26,1,10,37,149,12,8,169,Friday
2020-08-07,Lok Ma Chau,0,0,0,0,0,0,0,0,Friday
2020-08-07,Man Kam To,0,0,0,0,0,0,0,0,Friday
2020-08-07,Sha Tau Kok,0,0,0,0,0,0,0,0,Friday
2020-08-07,Shenzhen Bay,411,32,6,449,931,108,2,1041,Friday
2020-08-07,China Ferry Terminal,0,0,0,0,0,0,0,0,Friday
2020-08-07,Harbour Control,0,0,0,0,0,0,0,0,Friday
2020-08-07,Kai Tak Cruise Terminal,0,0,0,0,0,0,0,0,Friday
2020-08-07,Macau Ferry Terminal,0,0,0,0,0,0,0,0,Friday
2020-08-07,Tuen Mun Ferry Terminal,0,0,0,0,0,0,0,0,Friday
2020-08-07,Total,1109,38,62,1209,2392,152,127,2671,Friday
2020-08-08,Airport,646,5,22,673,1594,65,56,1715,Saturday
2020-08-08,Express Rail Link West Kowloon,0,0,0,0,0,0,0,0,Saturday
2020-08-08,Hung Hom,0,0,0,0,0,0,0,0,Saturday
2020-08-08,Lo Wu,0,0,0,0,0,0,0,0,Saturday
2020-08-08,Lok Ma Chau Spur Line,0,0,0,0,0,0,0,0,Saturday
2020-08-08,Lok Ma Chau,0,0,0,0,0,0,0,0,Saturday
2020-08-08,Man Kam To,0,0,0,0,0,0,0,0,Saturday
2020-08-08,Sha Tau Kok,0,0,0,0,0,0,0,0,Saturday
2020-08-08,Shenzhen Bay,370,51,7,428,852,105,1,958,Saturday
2020-08-08,Harbour Control,0,0,0,0,0,0,0,0,Saturday
2020-08-08,Kai Tak Cruise Terminal,0,0,0,0,0,0,0,0,Saturday
2020-08-08,Macau Ferry Terminal,0,0,0,0,0,0,0,0,Saturday
2020-08-08,Tuen Mun Ferry Terminal,0,0,0,0,0,0,0,0,Saturday
2020-08-08,Total,1054,59,34,1147,2627,185,61,2873,Saturday
2020-08-09,Airport,621,10,28,659,1522,47,84,1653,Sunday
2020-08-09,Express Rail Link West Kowloon,0,0,0,0,0,0,0,0,Sunday
2020-08-09,Hung Hom,0,0,0,0,0,0,0,0,Sunday
2020-08-09,Lo Wu,0,0,0,0,0,0,0,0,Sunday
2020-08-09,Lok Ma Chau Spur Line,0,0,0,0,0,0,0,0,Sunday
2020-08-09,Lok Ma Chau,0,0,0,0,0,0,0,0,Sunday
2020-08-09,Man Kam To,0,0,0,0,0,0,0,0,Sunday
2020-08-09,Sha Tau Kok,0,0,0,0,0,0,0,0,Sunday
2020-08-09,Shenzhen Bay,415,37,1,453,646,78,2,726,Sunday
2020-08-09,China Ferry Terminal,0,0,0,0,0,0,0,0,Sunday
2020-08-09,Harbour Control,0,0,0,0,0,0,0,0,Sunday
2020-08-09,Kai Tak Cruise Terminal,0,0,0,0,0,0,0,0,Sunday
2020-08-09,Macau Ferry Terminal,0,0,0,0,0,0,0,0,Sunday
2020-08-09,Tuen Mun Ferry Terminal,0,0,0,0,0,0,0,0,Sunday
2020-08-09,Total,1078,51,35,1164,2281,131,89,2501,Sunday
2020-08-10,Airport,528,10,22,560,749,19,78,846,Monday
2020-08-10,Express Rail Link West Kowloon,0,0,0,0,0,0,0,0,Monday
2020-08-10,Hung Hom,0,0,0,0,0,0,0,0,Monday
2020-08-10,Lo Wu,0,0,0,0,0,0,0,0,Monday
2020-08-10,Lok Ma Chau Spur Line,0,0,0,0,0,0,0,0,Monday
2020-08-10,Hong Kong-Zhuhai-Macao Bridge,33,3,7,43,98,3,4,105,Monday
2020-08-10,Lok Ma Chau,0,0,0,0,0,0,0,0,Monday
2020-08-10,Man Kam To,0,0,0,0,0,0,0,0,Monday
2020-08-10,Sha Tau Kok,0,0,0,0,0,0,0,0,Monday
2020-08-10,Shenzhen Bay,530,43,2,575,500,49,1,550,Monday
2020-08-10,China Ferry Terminal,0,0,0,0,0,0,0,0,Monday
2020-08-10,Harbour Control,0,0,0,0,0,0,0,0,Monday
2020-08-10,Kai Tak Cruise Terminal,0,0,0,0,0,0,0,0,Monday
2020-08-10,Macau Ferry Terminal,0,0,0,0,0,0,0,0,Monday
2020-08-10,Tuen Mun Ferry Terminal,0,0,0,0,0,0,0,0,Monday
2020-08-10,Total,1091,56,31,1178,1347,71,83,1501,Monday
2020-08-11,Airport,798,2,33,833,988,23,57,1068,Tuesday
2020-08-11,Express Rail Link West Kowloon,0,0,0,0,0,0,0,0,Tuesday
2020-08-11,Hung Hom,0,0,0,0,0,0,0,0,Tuesday
2020-08-11,Lo Wu,0,0,0,0,0,0,0,0,Tuesday
2020-08-11,Lok Ma Chau Spur Line,0,0,0,0,0,0,0,0,Tuesday
2020-08-11,Lok Ma Chau,0,0,0,0,0,0,0,0,Tuesday
2020-08-11,Man Kam To,0,0,0,0,0,0,0,0,Tuesday
2020-08-11,Sha Tau Kok,0,0,0,0,0,0,0,0,Tuesday
2020-08-11,Shenzhen Bay,383,44,3,430,884,111,4,999,Tuesday
2020-08-11,China Ferry Terminal,0,0,0,0,0,0,0,0,Tuesday
2020-08-11,Harbour Control,0,0,0,0,0,0,0,0,Tuesday
2020-08-11,Kai Tak Cruise Terminal,0,0,0,0,0,0,0,0,Tuesday
2020-08-11,Macau Ferry Terminal,0,0,0,0,0,0,0,0,Tuesday
2020-08-11,Tuen Mun Ferry Terminal,0,0,0,0,0,0,0,0,Tuesday
2020-08-11,Total,1204,47,38,1289,2039,138,64,2241,Tuesday
2020-08-12,Airport,388,7,21,416,922,24,43,989,Wednesday
2020-08-12,Express Rail Link West Kowloon,0,0,0,0,0,0,0,0,Wednesday
2020-08-12,Hung Hom,0,0,0,0,0,0,0,0,Wednesday
2020-08-12,Lo Wu,0,0,0,0,0,0,0,0,Wednesday
2020-08-12,Lok Ma Chau Spur Line,0,0,0,0,0,0,0,0,Wednesday
2020-08-12,Hong Kong-Zhuhai-Macao Bridge,40,0,5,45,203,23,3,229,Wednesday
2020-08-12,Lok Ma Chau,0,0,0,0,0,0,0,0,Wednesday
2020-08-12,Man Kam To,0,0,0,0,0,0,0,0,Wednesday
2020-08-12,Sha Tau Kok,0,0,0,0,0,0,0,0,Wednesday
2020-08-12,Shenzhen Bay,504,51,8,563,1062,169,4,1235,Wednesday
2020-08-12,China Ferry Terminal,0,0,0,0,0,0,0,0,Wednesday
2020-08-12,Harbour Control,0,0,0,0,0,0,0,0,Wednesday
2020-08-12,Kai Tak Cruise Terminal,0,0,0,0,0,0,0,0,Wednesday
2020-08-12,Macau Ferry Terminal,0,0,0,0,0,0,0,0,Wednesday
2020-08-12,Tuen Mun Ferry Terminal,0,0,0,0,0,0,0,0,Wednesday
2020-08-12,Total,932,58,34,1024,2187,216,50,2453,Wednesday
2020-08-13,Airport,532,2,16,550,1179,15,61,1255,Thursday
2020-08-13,Hung Hom,0,0,0,0,0,0,0,0,Thursday
2020-08-13,Lo Wu,0,0,0,0,0,0,0,0,Thursday
2020-08-13,Lok Ma Chau Spur Line,0,0,0,0,0,0,0,0,Thursday
2020-08-13,Hong Kong-Zhuhai-Macao Bridge,38,3,6,47,194,10,5,209,Thursday
2020-08-13,Lok Ma Chau,0,0,0,0,0,0,0,0,Thursday
2020-08-13,Man Kam To,0,0,0,0,0,0,0,0,Thursday
2020-08-13,Sha Tau Kok,0,0,0,0,0,0,0,0,Thursday
2020-08-13,Shenzhen Bay,571,53,3,627,1035,156,4,1195,Thursday
2020-08-13,China Ferry Terminal,0,0,0,0,0,0,0,0,Thursday
2020-08-13,Harbour Control,0,0,0,0,0,0,0,0,Thursday
2020-08-13,Kai Tak Cruise Terminal,0,0,0,0,0,0,0,0,Thursday
2020-08-13,Macau Ferry Terminal,0,0,0,0,0,0,0,0,Thursday
2020-08-13,Tuen Mun Ferry Terminal,0,0,0,0,0,0,0,0,Thursday
2020-08-13,Total,1141,58,25,1224,2408,181,70,2659,Thursday
2020-08-14,Airport,793,3,49,845,1565,23,88,1676,Friday
2020-08-14,Express Rail Link West Kowloon,0,0,0,0,0,0,0,0,Friday
2020-08-14,Hung Hom,0,0,0,0,0,0,0,0,Friday
2020-08-14,Lo Wu,0,0,0,0,0,0,0,0,Friday
2020-08-14,Lok Ma Chau Spur Line,0,0,0,0,0,0,0,0,Friday
2020-08-14,Hong Kong-Zhuhai-Macao Bridge,51,1,7,59,188,7,7,202,Friday
2020-08-14,Man Kam To,0,0,0,0,0,0,0,0,Friday
2020-08-14,Sha Tau Kok,0,0,0,0,0,0,0,0,Friday
2020-08-14,Shenzhen Bay,500,48,2,550,880,85,5,970,Friday
2020-08-14,China Ferry Terminal,0,0,0,0,0,0,0,0,Friday
2020-08-14,Harbour Control,0,0,0,0,0,0,0,0,Friday
2020-08-14,Macau Ferry Terminal,0,0,0,0,0,0,0,0,Friday
2020-08-14,Tuen Mun Ferry Terminal,0,0,0,0,0,0,0,0,Friday
2020-08-14,Total,1344,52,58,1454,2633,115,100,2848,Friday
2020-08-15,Airport,745,5,39,789,1636,44,195,1875,Saturday
2020-08-15,Express Rail Link West Kowloon,0,0,0,0,0,0,0,0,Saturday
2020-08-15,Hung Hom,0,0,0,0,0,0,0,0,Saturday
2020-08-15,Lo Wu,0,0,0,0,0,0,0,0,Saturday
2020-08-15,Lok Ma Chau Spur Line,0,0,0,0,0,0,0,0,Saturday
2020-08-15,Hong Kong-Zhuhai-Macao Bridge,46,9,33,88,152,6,4,162,Saturday
2020-08-15,Lok Ma Chau,0,0,0,0,0,0,0,0,Saturday
2020-08-15,Man Kam To,0,0,0,0,0,0,0,0,Saturday
2020-08-15,Sha Tau Kok,0,0,0,0,0,0,0,0,Saturday
2020-08-15,Shenzhen Bay,629,76,6,711,774,108,7,889,Saturday
2020-08-15,China Ferry Terminal,0,0,0,0,0,0,0,0,Saturday
2020-08-15,Harbour Control,0,0,0,0,0,0,0,0,Saturday
2020-08-15,Kai Tak Cruise Terminal,0,0,0,0,0,0,0,0,Saturday
2020-08-15,Macau Ferry Terminal,0,0,0,0,0,0,0,0,Saturday
2020-08-15,Tuen Mun Ferry Terminal,0,0,0,0,0,0,0,0,Saturday
2020-08-15,Total,1420,90,78,1588,2562,158,206,2926,Saturday
2020-08-16,Airport,786,11,21,818,1595,35,74,1704,Sunday
2020-08-16,Hung Hom,0,0,0,0,0,0,0,0,Sunday
2020-08-16,Lo Wu,0,0,0,0,0,0,0,0,Sunday
2020-08-16,Lok Ma Chau Spur Line,0,0,0,0,0,0,0,0,Sunday
2020-08-16,Hong Kong-Zhuhai-Macao Bridge,51,3,1,55,113,7,6,126,Sunday
2020-08-16,Lok Ma Chau,0,0,0,0,0,0,0,0,Sunday
2020-08-16,Man Kam To,0,0,0,0,0,0,0,0,Sunday
2020-08-16,Sha Tau Kok,0,0,0,0,0,0,0,0,Sunday
2020-08-16,Shenzhen Bay,699,57,6,762,659,69,2,730,Sunday
2020-08-16,China Ferry Terminal,0,0,0,0,0,0,0,0,Sunday
2020-08-16,Harbour Control,0,0,0,0,0,0,0,0,Sunday
2020-08-16,Kai Tak Cruise Terminal,0,0,0,0,0,0,0,0,Sunday
2020-08-16,Macau Ferry Terminal,0,0,0,0,0,0,0,0,Sunday
2020-08-16,Tuen Mun Ferry Terminal,0,0,0,0,0,0,0,0,Sunday
2020-08-16,Total,1536,71,28,1635,2367,111,82,2560,Sunday
2020-08-17,Airport,690,6,22,718,913,15,32,960,Monday
2020-08-17,Express Rail Link West Kowloon,0,0,0,0,0,0,0,0,Monday
2020-08-17,Hung Hom,0,0,0,0,0,0,0,0,Monday
2020-08-17,Lo Wu,0,0,0,0,0,0,0,0,Monday
2020-08-17,Lok Ma Chau Spur Line,0,0,0,0,0,0,0,0,Monday
2020-08-17,Hong Kong-Zhuhai-Macao Bridge,48,0,7,55,96,5,3,104,Monday
2020-08-17,Lok Ma Chau,0,0,0,0,0,0,0,0,Monday
2020-08-17,Man Kam To,0,0,0,0,0,0,0,0,Monday
2020-08-17,Sha Tau Kok,0,0,0,0,0,0,0,0,Monday
2020-08-17,Shenzhen Bay,710,71,1,782,443,46,1,490,Monday
2020-08-17,China Ferry Terminal,0,0,0,0,0,0,0,0,Monday
2020-08-17,Harbour Control,0,0,0,0,0,0,0,0,Monday
2020-08-17,Kai Tak Cruise Terminal,0,0,0,0,0,0,0,0,Monday
2020-08-17,Macau Ferry Terminal,0,0,0,0,0,0,0,0,Monday
2020-08-17,Tuen Mun Ferry Terminal,0,0,0,0,0,0,0,0,Monday
2020-08-17,Total,1448,77,30,1555,1452,66,36,1554,Monday
2020-08-18,Airport,435,0,14,449,1253,19,48,1320,Tuesday
2020-08-18,Hung Hom,0,0,0,0,0,0,0,0,Tuesday
2020-08-18,Lo Wu,0,0,0,0,0,0,0,0,Tuesday
2020-08-18,Lok Ma Chau Spur Line,0,0,0,0,0,0,0,0,Tuesday
2020-08-18,Hong Kong-Zhuhai-Macao Bridge,57,1,7,65,150,10,8,168,Tuesday
2020-08-18,Lok Ma Chau,0,0,0,0,0,0,0,0,Tuesday
2020-08-18,Man Kam To,0,0,0,0,0,0,0,0,Tuesday
2020-08-18,Sha Tau Kok,0,0,0,0,0,0,0,0,Tuesday
2020-08-18,Shenzhen Bay,673,49,2,724,782,78,3,863,Tuesday
2020-08-18,China Ferry Terminal,0,0,0,0,0,0,0,0,Tuesday
2020-08-18,Harbour Control,0,0,0,0,0,0,0,0,Tuesday
2020-08-18,Kai Tak Cruise Terminal,0,0,0,0,0,0,0,0,Tuesday
2020-08-18,Macau Ferry Terminal,0,0,0,0,0,0,0,0,Tuesday
2020-08-18,Tuen Mun Ferry Terminal,0,0,0,0,0,0,0,0,Tuesday
2020-08-18,Total,1165,50,23,1238,2185,107,59,2351,Tuesday
2020-08-19,Airport,501,1,21,523,870,10,33,913,Wednesday
2020-08-19,Express Rail Link West Kowloon,0,0,0,0,0,0,0,0,Wednesday
2020-08-19,Hung Hom,0,0,0,0,0,0,0,0,Wednesday
2020-08-19,Lo Wu,0,0,0,0,0,0,0,0,Wednesday
2020-08-19,Lok Ma Chau Spur Line,0,0,0,0,0,0,0,0,Wednesday
2020-08-19,Hong Kong-Zhuhai-Macao Bridge,17,0,2,19,79,3,1,83,Wednesday
2020-08-19,Lok Ma Chau,0,0,0,0,0,0,0,0,Wednesday
2020-08-19,Man Kam To,0,0,0,0,0,0,0,0,Wednesday
2020-08-19,Sha Tau Kok,0,0,0,0,0,0,0,0,Wednesday
2020-08-19,Shenzhen Bay,359,27,5,391,806,111,1,918,Wednesday
2020-08-19,China Ferry Terminal,0,0,0,0,0,0,0,0,Wednesday
2020-08-19,Harbour Control,0,0,0,0,0,0,0,0,Wednesday
2020-08-19,Kai Tak Cruise Terminal,0,0,0,0,0,0,0,0,Wednesday
2020-08-19,Macau Ferry Terminal,0,0,0,0,0,0,0,0,Wednesday
2020-08-19,Total,877,28,28,933,1755,124,35,1914,Wednesday
2020-08-20,Airport,712,1,29,742,1260,6,54,1320,Thursday
2020-08-20,Express Rail Link West Kowloon,0,0,0,0,0,0,0,0,Thursday
2020-08-20,Hung Hom,0,0,0,0,0,0,0,0,Thursday
2020-08-20,Lok Ma Chau,0,0,0,0,0,0,0,0,Thursday
2020-08-20,Man Kam To,0,0,0,0,0,0,0,0,Thursday
2020-08-20,Sha Tau Kok,0,0,0,0,0,0,0,0,Thursday
2020-08-20,Shenzhen Bay,605,84,2,691,741,98,5,844,Thursday
2020-08-20,China Ferry Terminal,0,0,0,0,0,0,0,0,Thursday
2020-08-20,Harbour Control,0,0,0,0,0,0,0,0,Thursday
2020-08-20,Kai Tak Cruise Terminal,0,0,0,0,0,0,0,0,Thursday
2020-08-20,Macau Ferry Terminal,0,0,0,0,0,0,0,0,Thursday
2020-08-20,Tuen Mun Ferry Terminal,0,0,0,0,0,0,0,0,Thursday
2020-08-20,Total,1360,87,43,1490,2143,107,65,2315,Thursday
2020-08-21,Airport,722,10,25,757,1681,27,184,1892,Friday
2020-08-21,Express Rail Link West Kowloon,0,0,0,0,0,0,0,0,Friday
2020-08-21,Hung Hom,0,0,0,0,0,0,0,0,Friday
2020-08-21,Lo Wu,0,0,0,0,0,0,0,0,Friday
2020-08-21,Lok Ma Chau Spur Line,0,0,0,0,0,0,0,0,Friday
2020-08-21,Hong Kong-Zhuhai-Macao Bridge,54,3,89,146,164,7,5,176,Friday
2020-08-21,Lok Ma Chau,0,0,0,0,0,0,0,0,Friday
2020-08-21,Man Kam To,0,0,0,0,0,0,0,0,Friday
2020-08-21,Sha Tau Kok,0,0,0,0,0,0,0,0,Friday
2020-08-21,Shenzhen Bay,612,56,3,671,715,75,3,793,Friday
2020-08-21,China Ferry Terminal,0,0,0,0,0,0,0,0,Friday
2020-08-21,Harbour Control,0,0,0,0,0,0,0,0,Friday
2020-08-21,Kai Tak Cruise Terminal,0,0,0,0,0,0,0,0,Friday
2020-08-21,Macau Ferry Terminal,0,0,0,0,0,0,0,0,Friday
2020-08-21,Tuen Mun Ferry Terminal,0,0,0,0,0,0,0,0,Friday
2020-08-21,Total,1388,69,117,1574,2560,109,192,2861,Friday
2020-08-22,Airport,570,1,12,583,1530,26,48,1604,Saturday
2020-08-22,Hung Hom,0,0,0,0,0,0,0,0,Saturday
2020-08-22,Lo Wu,0,0,0,0,0,0,0,0,Saturday
2020-08-22,Lok Ma Chau Spur Line,0,0,0,0,0,0,0,0,Saturday
2020-08-22,Hong Kong-Zhuhai-Macao Bridge,41,4,5,50,182,5,9,196,Saturday
2020-08-22,Lok Ma Chau,0,0,0,0,0,0,0,0,Saturday
2020-08-22,Man Kam To,0,0,0,0,0,0,0,0,Saturday
2020-08-22,Sha Tau Kok,0,0,0,0,0,0,0,0,Saturday
2020-08-22,Shenzhen Bay,502,78,3,583,801,108,1,910,Saturday
2020-08-22,China Ferry Terminal,0,0,0,0,0,0,0,0,Saturday
2020-08-22,Harbour Control,0,0,0,0,0,0,0,0,Saturday
2020-08-22,Kai Tak Cruise Terminal,0,0,0,0,0,0,0,0,Saturday
2020-08-22,Macau Ferry Terminal,0,0,0,0,0,0,0,0,Saturday
2020-08-22,Tuen Mun Ferry Terminal,0,0,0,0,0,0,0,0,Saturday
2020-08-22,Total,1113,83,20,1216,2513,139,58,2710,Saturday
2020-08-23,Airport,865,10,48,923,1790,27,60,1877,Sunday
2020-08-23,Express Rail Link West Kowloon,0,0,0,0,0,0,0,0,Sunday
2020-08-23,Hung Hom,0,0,0,0,0,0,0,0,Sunday
2020-08-23,Lo Wu,0,0,0,0,0,0,0,0,Sunday
2020-08-23,Lok Ma Chau Spur Line,0,0,0,0,0,0,0,0,Sunday
2020-08-23,Hong Kong-Zhuhai-Macao Bridge,52,1,0,53,117,8,1,126,Sunday
2020-08-23,Lok Ma Chau,0,0,0,0,0,0,0,0,Sunday
2020-08-23,Man Kam To,0,0,0,0,0,0,0,0,Sunday
2020-08-23,Sha Tau Kok,0,0,0,0,0,0,0,0,Sunday
2020-08-23,Shenzhen Bay,634,68,8,710,458,58,3,519,Sunday
2020-08-23,China Ferry Terminal,0,0,0,0,0,0,0,0,Sunday
2020-08-23,Harbour Control,0,0,0,0,0,0,0,0,Sunday
2020-08-23,Kai Tak Cruise Terminal,0,0,0,0,0,0,0,0,Sunday
2020-08-23,Macau Ferry Terminal,0,0,0,0,0,0,0,0,Sunday
2020-08-23,Tuen Mun Ferry Terminal,0,0,0,0,0,0,0,0,Sunday
2020-08-23,Total,1551,79,56,1686,2365,93,64,2522,Sunday
2020-08-24,Airport,611,8,9,628,1045,22,81,1148,Monday
2020-08-24,Hung Hom,0,0,0,0,0,0,0,0,Monday
2020-08-24,Lo Wu,0,0,0,0,0,0,0,0,Monday
2020-08-24,Lok Ma Chau Spur Line,0,0,0,0,0,0,0,0,Monday
2020-08-24,Hong Kong-Zhuhai-Macao Bridge,46,1,2,49,84,6,8,98,Monday
2020-08-24,Lok Ma Chau,0,0,0,0,0,0,0,0,Monday
2020-08-24,Man Kam To,0,0,0,0,0,0,0,0,Monday
2020-08-24,Sha Tau Kok,0,0,0,0,0,0,0,0,Monday
2020-08-24,Shenzhen Bay,614,47,5,666,395,48,3,446,Monday
2020-08-24,China Ferry Terminal,0,0,0,0,0,0,0,0,Monday
2020-08-24,Harbour Control,0,0,0,0,0,0,0,0,Monday
2020-08-24,Kai Tak Cruise Terminal,0,0,0,0,0,0,0,0,Monday
2020-08-24,Macau Ferry Terminal,0,0,0,0,0,0,0,0,Monday
2020-08-24,Tuen Mun Ferry Terminal,0,0,0,0,0,0,0,0,Monday
2020-08-24,Total,1271,56,16,1343,1524,76,92,1692,Monday
2020-08-25,Airport,433,9,10,452,1498,19,91,1608,Tuesday
2020-08-25,Express Rail Link West Kowloon,0,0,0,0,0,0,0,0,Tuesday
2020-08-25,Hung Hom,0,0,0,0,0,0,0,0,Tuesday
2020-08-25,Lo Wu,0,0,0,0,0,0,0,0,Tuesday
2020-08-25,Lok Ma Chau Spur Line,0,0,0,0,0,0,0,0,Tuesday
2020-08-25,Hong Kong-Zhuhai-Macao Bridge,55,4,3,62,131,7,6,144,Tuesday
2020-08-25,Lok Ma Chau,0,0,0,0,0,0,0,0,Tuesday
2020-08-25,Man Kam To,0,0,0,0,0,0,0,0,Tuesday
2020-08-25,Sha Tau Kok,0,0,0,0,0,0,0,0,Tuesday
2020-08-25,Shenzhen Bay,588,61,4,653,610,59,6,675,Tuesday
2020-08-25,China Ferry Terminal,0,0,0,0,0,0,0,0,Tuesday
2020-08-25,Harbour Control,0,0,0,0,0,0,0,0,Tuesday
2020-08-25,Macau Ferry Terminal,0,0,0,0,0,0,0,0,Tuesday
2020-08-25,Tuen Mun Ferry Terminal,0,0,0,0,0,0,0,0,Tuesday
2020-08-25,Total,1076,74,17,1167,2239,85,103,2427,Tuesday
2020-08-26,Airport,588,2,30,620,1002,10,56,1068,Wednesday
2020-09-06,Airport,1093,5,51,1149,1633,31,69,1733,Sunday
2020-08-26,Hung Hom,0,0,0,0,0,0,0,0,Wednesday
2020-08-26,Lo Wu,0,0,0,0,0,0,0,0,Wednesday
2020-08-26,Lok Ma Chau Spur Line,0,0,0,0,0,0,0,0,Wednesday
2020-08-26,Heung Yuen Wai,0,0,0,0,0,0,0,0,Wednesday
2020-08-26,Hong Kong-Zhuhai-Macao Bridge,59,2,3,64,162,10,2,174,Wednesday
2020-08-26,Lok Ma Chau,0,0,0,0,0,0,0,0,Wednesday
2020-08-26,Man Kam To,0,0,0,0,0,0,0,0,Wednesday
2020-08-26,Sha Tau Kok,0,0,0,0,0,0,0,0,Wednesday
2020-08-26,Shenzhen Bay,658,61,2,721,771,84,4,859,Wednesday
2020-08-26,China Ferry Terminal,0,0,0,0,0,0,0,0,Wednesday
2020-08-26,Harbour Control,0,0,0,0,0,0,0,0,Wednesday
2020-08-26,Macau Ferry Terminal,0,0,0,0,0,0,0,0,Wednesday
2020-08-26,Tuen Mun Ferry Terminal,0,0,0,0,0,0,0,0,Wednesday
2020-08-26,Total,1305,65,35,1405,1935,104,62,2101,Wednesday
2020-08-27,Airport,628,4,13,645,1292,3,49,1344,Thursday
2020-08-27,Express Rail Link West Kowloon,0,0,0,0,0,0,0,0,Thursday
2020-08-27,Hung Hom,0,0,0,0,0,0,0,0,Thursday
2020-08-27,Lo Wu,0,0,0,0,0,0,0,0,Thursday
2020-08-27,Lok Ma Chau Spur Line,0,0,0,0,0,0,0,0,Thursday
2020-08-27,Heung Yuen Wai,0,0,0,0,0,0,0,0,Thursday
2020-08-27,Hong Kong-Zhuhai-Macao Bridge,67,1,2,70,125,12,6,143,Thursday
2020-08-27,Lok Ma Chau,0,0,0,0,0,0,0,0,Thursday
2020-08-27,Man Kam To,0,0,0,0,0,0,0,0,Thursday
2020-08-27,Sha Tau Kok,0,0,0,0,0,0,0,0,Thursday
2020-08-27,Shenzhen Bay,587,70,4,661,716,67,3,786,Thursday
2020-08-27,China Ferry Terminal,0,0,0,0,0,0,0,0,Thursday
2020-08-27,Harbour Control,0,0,0,0,0,0,0,0,Thursday
2020-08-27,Kai Tak Cruise Terminal,0,0,0,0,0,0,0,0,Thursday
2020-08-27,Macau Ferry Terminal,0,0,0,0,0,0,0,0,Thursday
2020-08-27,Tuen Mun Ferry Terminal,0,0,0,0,0,0,0,0,Thursday
2020-08-27,Total,1282,75,19,1376,2133,82,58,2273,Thursday
2020-08-28,Airport,795,9,35,839,1624,13,82,1719,Friday
2020-08-28,Express Rail Link West Kowloon,0,0,0,0,0,0,0,0,Friday
2020-08-28,Hung Hom,0,0,0,0,0,0,0,0,Friday
2020-08-28,Lo Wu,0,0,0,0,0,0,0,0,Friday
2020-08-28,Lok Ma Chau Spur Line,0,0,0,0,0,0,0,0,Friday
2020-08-28,Heung Yuen Wai,0,0,0,0,0,0,0,0,Friday
2020-08-28,Lok Ma Chau,0,0,0,0,0,0,0,0,Friday
2020-08-28,Man Kam To,0,0,0,0,0,0,0,0,Friday
2020-08-28,Sha Tau Kok,0,0,0,0,0,0,0,0,Friday
2020-08-28,Shenzhen Bay,867,88,8,963,562,75,4,641,Friday
2020-08-28,China Ferry Terminal,0,0,0,0,0,0,0,0,Friday
2020-08-28,Harbour Control,0,0,0,0,0,0,0,0,Friday
2020-08-28,Kai Tak Cruise Terminal,0,0,0,0,0,0,0,0,Friday
2020-08-28,Macau Ferry Terminal,0,0,0,0,0,0,0,0,Friday
2020-08-28,Tuen Mun Ferry Terminal,0,0,0,0,0,0,0,0,Friday
2020-08-28,Total,1726,98,44,1868,2304,92,97,2493,Friday
2020-08-29,Airport,805,4,17,826,1912,42,224,2178,Saturday
2020-08-29,Express Rail Link West Kowloon,0,0,0,0,0,0,0,0,Saturday
2020-08-29,Hung Hom,0,0,0,0,0,0,0,0,Saturday
2020-08-29,Lo Wu,0,0,0,0,0,0,0,0,Saturday
2020-08-29,Lok Ma Chau Spur Line,0,0,0,0,0,0,0,0,Saturday
2020-08-29,Heung Yuen Wai,0,0,0,0,0,0,0,0,Saturday
2020-08-29,Hong Kong-Zhuhai-Macao Bridge,68,3,13,84,132,11,9,152,Saturday
2020-08-29,Lok Ma Chau,0,0,0,0,0,0,0,0,Saturday
2020-08-29,Man Kam To,0,0,0,0,0,0,0,0,Saturday
2020-08-29,Sha Tau Kok,0,0,0,0,0,0,0,0,Saturday
2020-08-29,Shenzhen Bay,755,95,2,852,452,53,2,507,Saturday
2020-08-29,China Ferry Terminal,0,0,0,0,0,0,0,0,Saturday
2020-08-29,Harbour Control,0,0,0,0,0,0,0,0,Saturday
2020-08-29,Kai Tak Cruise Terminal,0,0,0,0,0,0,0,0,Saturday
2020-08-29,Macau Ferry Terminal,0,0,0,0,0,0,0,0,Saturday
2020-08-29,Tuen Mun Ferry Terminal,0,0,0,0,0,0,0,0,Saturday
2020-08-29,Total,1628,102,32,1762,2496,106,235,2837,Saturday
2020-08-30,Airport,1031,9,32,1072,1645,10,57,1712,Sunday
2020-08-30,Hung Hom,0,0,0,0,0,0,0,0,Sunday
2020-08-30,Lo Wu,0,0,0,0,0,0,0,0,Sunday
2020-08-30,Lok Ma Chau Spur Line,0,0,0,0,0,0,0,0,Sunday
2020-08-30,Heung Yuen Wai,0,0,0,0,0,0,0,0,Sunday
2020-08-30,Hong Kong-Zhuhai-Macao Bridge,87,6,4,97,78,4,5,87,Sunday
2020-08-30,Lok Ma Chau,0,0,0,0,0,0,0,0,Sunday
2020-08-30,Man Kam To,0,0,0,0,0,0,0,0,Sunday
2020-08-30,Sha Tau Kok,0,0,0,0,0,0,0,0,Sunday
2020-08-30,Shenzhen Bay,1160,113,1,1274,377,39,1,417,Sunday
2020-08-30,China Ferry Terminal,0,0,0,0,0,0,0,0,Sunday
2020-08-30,Harbour Control,0,0,0,0,0,0,0,0,Sunday
2020-08-30,Kai Tak Cruise Terminal,0,0,0,0,0,0,0,0,Sunday
2020-08-30,Macau Ferry Terminal,0,0,0,0,0,0,0,0,Sunday
2020-08-30,Tuen Mun Ferry Terminal,0,0,0,0,0,0,0,0,Sunday
2020-08-30,Total,2278,128,37,2443,2100,53,63,2216,Sunday
2020-08-31,Airport,616,2,14,632,1921,6,40,1967,Monday
2020-08-31,Express Rail Link West Kowloon,0,0,0,0,0,0,0,0,Monday
2020-08-31,Hung Hom,0,0,0,0,0,0,0,0,Monday
2020-08-31,Lo Wu,0,0,0,0,0,0,0,0,Monday
2020-08-31,Lok Ma Chau Spur Line,0,0,0,0,0,0,0,0,Monday
2020-08-31,Heung Yuen Wai,0,0,0,0,0,0,0,0,Monday
2020-08-31,Hong Kong-Zhuhai-Macao Bridge,97,5,4,106,84,5,2,91,Monday
2020-08-31,Lok Ma Chau,0,0,0,0,0,0,0,0,Monday
2020-08-31,Man Kam To,0,0,0,0,0,0,0,0,Monday
2020-08-31,Shenzhen Bay,1276,96,2,1374,417,43,4,464,Monday
2020-08-31,Harbour Control,0,0,0,0,0,0,0,0,Monday
2020-08-31,Kai Tak Cruise Terminal,0,0,0,0,0,0,0,0,Monday
2020-08-31,Macau Ferry Terminal,0,0,0,0,0,0,0,0,Monday
2020-08-31,Tuen Mun Ferry Terminal,0,0,0,0,0,0,0,0,Monday
2020-08-31,Total,1989,103,20,2112,2422,54,46,2522,Monday
2020-09-01,Airport,545,4,22,571,1956,18,57,2031,Tuesday
2020-09-01,Express Rail Link West Kowloon,0,0,0,0,0,0,0,0,Tuesday
2020-09-01,Hung Hom,0,0,0,0,0,0,0,0,Tuesday
2020-09-01,Lo Wu,0,0,0,0,0,0,0,0,Tuesday
2020-09-01,Lok Ma Chau Spur Line,0,0,0,0,0,0,0,0,Tuesday
2020-09-01,Heung Yuen Wai,0,0,0,0,0,0,0,0,Tuesday
2020-09-01,Hong Kong-Zhuhai-Macao Bridge,65,1,1,67,138,4,7,149,Tuesday
2020-09-01,Lok Ma Chau,0,0,0,0,0,0,0,0,Tuesday
2020-09-01,Man Kam To,0,0,0,0,0,0,0,0,Tuesday
2020-09-01,Sha Tau Kok,0,0,0,0,0,0,0,0,Tuesday
2020-09-01,Shenzhen Bay,816,72,2,890,643,73,7,723,Tuesday
2020-09-01,Harbour Control,0,0,0,0,0,0,0,0,Tuesday
2020-09-01,Kai Tak Cruise Terminal,0,0,0,0,0,0,0,0,Tuesday
2020-09-01,Macau Ferry Terminal,0,0,0,0,0,0,0,0,Tuesday
2020-09-01,Tuen Mun Ferry Terminal,0,0,0,0,0,0,0,0,Tuesday
2020-09-01,Total,1426,77,25,1528,2737,95,71,2903,Tuesday
2020-09-02,Airport,735,6,37,778,1647,26,40,1713,Wednesday
2020-09-02,Express Rail Link West Kowloon,0,0,0,0,0,0,0,0,Wednesday
2020-09-02,Hung Hom,0,0,0,0,0,0,0,0,Wednesday
2020-09-02,Lo Wu,0,0,0,0,0,0,0,0,Wednesday
2020-09-02,Lok Ma Chau Spur Line,0,0,0,0,0,0,0,0,Wednesday
2020-09-02,Heung Yuen Wai,0,0,0,0,0,0,0,0,Wednesday
2020-09-02,Hong Kong-Zhuhai-Macao Bridge,57,5,1,63,140,10,1,151,Wednesday
2020-09-02,Lok Ma Chau,0,0,0,0,0,0,0,0,Wednesday
2020-09-02,Man Kam To,0,0,0,0,0,0,0,0,Wednesday
2020-09-02,Sha Tau Kok,0,0,0,0,0,0,0,0,Wednesday
2020-09-02,Shenzhen Bay,1012,89,2,1103,710,82,2,794,Wednesday
2020-09-02,China Ferry Terminal,0,0,0,0,0,0,0,0,Wednesday
2020-09-02,Harbour Control,0,0,0,0,0,0,0,0,Wednesday
2020-09-02,Kai Tak Cruise Terminal,0,0,0,0,0,0,0,0,Wednesday
2020-09-02,Macau Ferry Terminal,0,0,0,0,0,0,0,0,Wednesday
2020-09-02,Tuen Mun Ferry Terminal,0,0,0,0,0,0,0,0,Wednesday
2020-09-02,Total,1804,100,40,1944,2497,118,43,2658,Wednesday
2020-09-03,Airport,622,4,15,641,1466,12,28,1506,Thursday
2020-09-03,Hung Hom,0,0,0,0,0,0,0,0,Thursday
2020-09-03,Lo Wu,0,0,0,0,0,0,0,0,Thursday
2020-09-03,Lok Ma Chau Spur Line,0,0,0,0,0,0,0,0,Thursday
2020-09-03,Heung Yuen Wai,0,0,0,0,0,0,0,0,Thursday
2020-09-03,Hong Kong-Zhuhai-Macao Bridge,84,4,4,92,141,7,2,150,Thursday
2020-09-03,Lok Ma Chau,0,0,0,0,0,0,0,0,Thursday
2020-09-03,Man Kam To,0,0,0,0,0,0,0,0,Thursday
2020-09-03,Sha Tau Kok,0,0,0,0,0,0,0,0,Thursday
2020-09-03,Shenzhen Bay,1032,79,4,1115,756,86,7,849,Thursday
2020-09-03,China Ferry Terminal,0,0,0,0,0,0,0,0,Thursday
2020-09-03,Harbour Control,0,0,0,0,0,0,0,0,Thursday
2020-09-03,Kai Tak Cruise Terminal,0,0,0,0,0,0,0,0,Thursday
2020-09-03,Macau Ferry Terminal,0,0,0,0,0,0,0,0,Thursday
2020-09-03,Tuen Mun Ferry Terminal,0,0,0,0,0,0,0,0,Thursday
2020-09-03,Total,1738,87,23,1848,2363,105,37,2505,Thursday
2020-09-04,Airport,1231,5,32,1268,1377,16,41,1434,Friday
2020-09-04,Express Rail Link West Kowloon,0,0,0,0,0,0,0,0,Friday
2020-09-04,Hung Hom,0,0,0,0,0,0,0,0,Friday
2020-09-04,Lo Wu,0,0,0,0,0,0,0,0,Friday
2020-09-04,Lok Ma Chau Spur Line,0,0,0,0,0,0,0,0,Friday
2020-09-04,Heung Yuen Wai,0,0,0,0,0,0,0,0,Friday
2020-09-04,Hong Kong-Zhuhai-Macao Bridge,72,2,6,80,175,6,9,190,Friday
2020-09-04,Lok Ma Chau,0,0,0,0,0,0,0,0,Friday
2020-09-04,Man Kam To,0,0,0,0,0,0,0,0,Friday
2020-09-04,Sha Tau Kok,0,0,0,0,0,0,0,0,Friday
2020-09-04,Shenzhen Bay,845,114,4,963,695,80,2,777,Friday
2020-09-04,China Ferry Terminal,0,0,0,0,0,0,0,0,Friday
2020-09-04,Harbour Control,0,0,0,0,0,0,0,0,Friday
2020-09-04,Kai Tak Cruise Terminal,0,0,0,0,0,0,0,0,Friday
2020-09-04,Macau Ferry Terminal,0,0,0,0,0,0,0,0,Friday
2020-09-04,Total,2148,121,42,2311,2247,102,52,2401,Friday
2020-09-05,Airport,1046,11,28,1085,1900,40,70,2010,Saturday
2020-09-05,Express Rail Link West Kowloon,0,0,0,0,0,0,0,0,Saturday
2020-09-05,Hung Hom,0,0,0,0,0,0,0,0,Saturday
2020-09-05,Lo Wu,0,0,0,0,0,0,0,0,Saturday
2020-09-05,Lok Ma Chau Spur Line,0,0,0,0,0,0,0,0,Saturday
2020-09-05,Heung Yuen Wai,0,0,0,0,0,0,0,0,Saturday
2020-09-05,Hong Kong-Zhuhai-Macao Bridge,71,4,6,81,100,6,6,112,Saturday
2020-09-05,Lok Ma Chau,0,0,0,0,0,0,0,0,Saturday
2020-09-05,Man Kam To,0,0,0,0,0,0,0,0,Saturday
2020-09-05,Sha Tau Kok,0,0,0,0,0,0,0,0,Saturday
2020-09-05,Shenzhen Bay,1401,154,5,1560,550,82,3,635,Saturday
2020-09-05,China Ferry Terminal,0,0,0,0,0,0,0,0,Saturday
2020-09-05,Harbour Control,0,0,0,0,0,0,0,0,Saturday
2020-09-05,Kai Tak Cruise Terminal,0,0,0,0,0,0,0,0,Saturday
2020-09-05,Macau Ferry Terminal,0,0,0,0,0,0,0,0,Saturday
2020-09-05,Tuen Mun Ferry Terminal,0,0,0,0,0,0,0,0,Saturday
2020-09-05,Total,2518,169,39,2726,2550,128,79,2757,Saturday
2020-09-06,Hung Hom,0,0,0,0,0,0,0,0,Sunday
2020-09-06,Lo Wu,0,0,0,0,0,0,0,0,Sunday
2020-09-06,Lok Ma Chau Spur Line,0,0,0,0,0,0,0,0,Sunday
2020-09-06,Heung Yuen Wai,0,0,0,0,0,0,0,0,Sunday
2020-09-06,Hong Kong-Zhuhai-Macao Bridge,199,10,6,215,39,3,0,42,Sunday
2020-09-06,Lok Ma Chau,0,0,0,0,0,0,0,0,Sunday
2020-09-06,Man Kam To,0,0,0,0,0,0,0,0,Sunday
2020-09-06,Sha Tau Kok,0,0,0,0,0,0,0,0,Sunday
2020-09-06,Shenzhen Bay,2543,257,12,2812,337,44,2,383,Sunday
2020-09-06,China Ferry Terminal,0,0,0,0,0,0,0,0,Sunday
2020-09-06,Harbour Control,0,0,0,0,0,0,0,0,Sunday
2020-09-06,Macau Ferry Terminal,0,0,0,0,0,0,0,0,Sunday
2020-09-06,Tuen Mun Ferry Terminal,0,0,0,0,0,0,0,0,Sunday
2020-09-06,Total,3835,272,69,4176,2009,78,71,2158,Sunday
2020-09-07,Airport,614,5,19,638,1242,5,39,1286,Monday
2020-09-07,Express Rail Link West Kowloon,0,0,0,0,0,0,0,0,Monday
2020-09-07,Hung Hom,0,0,0,0,0,0,0,0,Monday
2020-09-07,Lo Wu,0,0,0,0,0,0,0,0,Monday
2020-09-07,Lok Ma Chau Spur Line,0,0,0,0,0,0,0,0,Monday
2020-09-07,Heung Yuen Wai,0,0,0,0,0,0,0,0,Monday
2020-09-07,Hong Kong-Zhuhai-Macao Bridge,125,8,4,137,71,3,1,75,Monday
2020-09-07,Lok Ma Chau,0,0,0,0,0,0,0,0,Monday
2020-09-07,Man Kam To,0,0,0,0,0,0,0,0,Monday
2020-09-07,Sha Tau Kok,0,0,0,0,0,0,0,0,Monday
2020-09-07,Shenzhen Bay,1680,170,6,1856,360,43,2,405,Monday
2020-09-07,China Ferry Terminal,0,0,0,0,0,0,0,0,Monday
2020-09-07,Harbour Control,0,0,0,0,0,0,0,0,Monday
2020-09-07,Kai Tak Cruise Terminal,0,0,0,0,0,0,0,0,Monday
2020-09-07,Macau Ferry Terminal,0,0,0,0,0,0,0,0,Monday
2020-09-07,Tuen Mun Ferry Terminal,0,0,0,0,0,0,0,0,Monday
2020-09-07,Total,2419,183,29,2631,1673,51,42,1766,Monday
2020-09-08,Airport,1030,9,45,1084,1378,27,46,1451,Tuesday
2020-09-08,Hung Hom,0,0,0,0,0,0,0,0,Tuesday
2020-09-08,Lo Wu,0,0,0,0,0,0,0,0,Tuesday
2020-09-08,Lok Ma Chau Spur Line,0,0,0,0,0,0,0,0,Tuesday
2020-09-08,Heung Yuen Wai,0,0,0,0,0,0,0,0,Tuesday
2020-09-08,Hong Kong-Zhuhai-Macao Bridge,167,10,5,182,114,12,3,129,Tuesday
2020-09-08,Lok Ma Chau,0,0,0,0,0,0,0,0,Tuesday
2020-09-08,Man Kam To,0,0,0,0,0,0,0,0,Tuesday
2020-09-08,Sha Tau Kok,0,0,0,0,0,0,0,0,Tuesday
2020-09-08,Shenzhen Bay,2340,290,7,2637,735,64,7,806,Tuesday
2020-09-08,China Ferry Terminal,0,0,0,0,0,0,0,0,Tuesday
2020-09-08,Harbour Control,0,0,0,0,0,0,0,0,Tuesday
2020-09-08,Kai Tak Cruise Terminal,0,0,0,0,0,0,0,0,Tuesday
2020-09-08,Macau Ferry Terminal,0,0,0,0,0,0,0,0,Tuesday
2020-09-08,Tuen Mun Ferry Terminal,0,0,0,0,0,0,0,0,Tuesday
2020-09-08,Total,3537,309,57,3903,2227,103,56,2386,Tuesday
2020-09-09,Airport,916,9,24,949,1181,18,115,1314,Wednesday
2020-09-09,Express Rail Link West Kowloon,0,0,0,0,0,0,0,0,Wednesday
2020-09-09,Hung Hom,0,0,0,0,0,0,0,0,Wednesday
2020-09-09,Lo Wu,0,0,0,0,0,0,0,0,Wednesday
2020-09-09,Lok Ma Chau Spur Line,0,0,0,0,0,0,0,0,Wednesday
2020-09-09,Heung Yuen Wai,0,0,0,0,0,0,0,0,Wednesday
2020-09-09,Hong Kong-Zhuhai-Macao Bridge,137,7,50,194,113,9,3,125,Wednesday
2020-09-09,Lok Ma Chau,0,0,0,0,0,0,0,0,Wednesday
2020-09-09,Man Kam To,0,0,0,0,0,0,0,0,Wednesday
2020-09-09,Sha Tau Kok,0,0,0,0,0,0,0,0,Wednesday
2020-09-09,Shenzhen Bay,2182,291,9,2482,636,96,4,736,Wednesday
2020-09-09,China Ferry Terminal,0,0,0,0,0,0,0,0,Wednesday
2020-09-09,Harbour Control,0,0,0,0,0,0,0,0,Wednesday
2020-09-09,Macau Ferry Terminal,0,0,0,0,0,0,0,0,Wednesday
2020-09-09,Tuen Mun Ferry Terminal,0,0,0,0,0,0,0,0,Wednesday
2020-09-09,Total,3235,307,83,3625,1930,123,122,2175,Wednesday
2020-09-10,Airport,688,4,15,707,1199,11,37,1247,Thursday
2020-09-10,Express Rail Link West Kowloon,0,0,0,0,0,0,0,0,Thursday
2020-09-10,Hung Hom,0,0,0,0,0,0,0,0,Thursday
2020-09-10,Lo Wu,0,0,0,0,0,0,0,0,Thursday
2020-09-10,Lok Ma Chau Spur Line,0,0,0,0,0,0,0,0,Thursday
2020-09-10,Heung Yuen Wai,0,0,0,0,0,0,0,0,Thursday
2020-09-10,Hong Kong-Zhuhai-Macao Bridge,125,9,3,137,136,7,7,150,Thursday
2020-09-10,Lok Ma Chau,0,0,0,0,0,0,0,0,Thursday
2020-09-10,Man Kam To,0,0,0,0,0,0,0,0,Thursday
2020-09-10,Sha Tau Kok,0,0,0,0,0,0,0,0,Thursday
2020-09-10,Shenzhen Bay,1317,171,7,1495,612,84,6,702,Thursday
2020-09-10,China Ferry Terminal,0,0,0,0,0,0,0,0,Thursday
2020-09-10,Harbour Control,0,0,0,0,0,0,0,0,Thursday
2020-09-10,Kai Tak Cruise Terminal,0,0,0,0,0,0,0,0,Thursday
2020-09-10,Macau Ferry Terminal,0,0,0,0,0,0,0,0,Thursday
2020-09-10,Tuen Mun Ferry Terminal,0,0,0,0,0,0,0,0,Thursday
2020-09-10,Total,2130,184,25,2339,1947,102,50,2099,Thursday
2020-09-11,Airport,1166,7,44,1217,1430,9,56,1495,Friday
2020-09-11,Express Rail Link West Kowloon,0,0,0,0,0,0,0,0,Friday
2020-09-11,Hung Hom,0,0,0,0,0,0,0,0,Friday
2020-09-11,Lo Wu,0,0,0,0,0,0,0,0,Friday
2020-09-11,Lok Ma Chau Spur Line,0,0,0,0,0,0,0,0,Friday
2020-09-11,Heung Yuen Wai,0,0,0,0,0,0,0,0,Friday
2020-09-11,Lok Ma Chau,0,0,0,0,0,0,0,0,Friday
2020-09-11,Man Kam To,0,0,0,0,0,0,0,0,Friday
2020-09-11,Shenzhen Bay,1213,180,6,1399,537,89,5,631,Friday
2020-09-11,China Ferry Terminal,0,0,0,0,0,0,0,0,Friday
2020-09-11,Harbour Control,0,0,0,0,0,0,0,0,Friday
2020-09-11,Macau Ferry Terminal,0,0,0,0,0,0,0,0,Friday
2020-09-11,Tuen Mun Ferry Terminal,0,0,0,0,0,0,0,0,Friday
2020-09-11,Total,2489,194,57,2740,2100,106,63,2269,Friday
2020-09-12,Airport,959,15,39,1013,1457,40,46,1543,Saturday
2020-09-12,Express Rail Link West Kowloon,0,0,0,0,0,0,0,0,Saturday
2020-09-12,Hung Hom,0,0,0,0,0,0,0,0,Saturday
2020-09-12,Lo Wu,0,0,0,0,0,0,0,0,Saturday
2020-09-12,Lok Ma Chau Spur Line,0,0,0,0,0,0,0,0,Saturday
2020-09-12,Heung Yuen Wai,0,0,0,0,0,0,0,0,Saturday
2020-09-12,Hong Kong-Zhuhai-Macao Bridge,109,13,5,127,101,8,3,112,Saturday
2020-09-12,Lok Ma Chau,0,0,0,0,0,0,0,0,Saturday
2020-09-12,Man Kam To,0,0,0,0,0,0,0,0,Saturday
2020-09-12,Sha Tau Kok,0,0,0,0,0,0,0,0,Saturday
2020-09-12,Shenzhen Bay,1576,251,4,1831,576,88,2,666,Saturday
2020-09-12,China Ferry Terminal,0,0,0,0,0,0,0,0,Saturday
2020-09-12,Harbour Control,0,0,0,0,0,0,0,0,Saturday
2020-09-12,Kai Tak Cruise Terminal,0,0,0,0,0,0,0,0,Saturday
2020-09-12,Macau Ferry Terminal,0,0,0,0,0,0,0,0,Saturday
2020-09-12,Tuen Mun Ferry Terminal,0,0,0,0,0,0,0,0,Saturday
2020-09-12,Total,2644,279,48,2971,2134,136,51,2321,Saturday
2020-09-13,Airport,1351,9,49,1409,1426,29,60,1515,Sunday
2020-09-13,Hung Hom,0,0,0,0,0,0,0,0,Sunday
2020-09-13,Lo Wu,0,0,0,0,0,0,0,0,Sunday
2020-09-13,Lok Ma Chau Spur Line,0,0,0,0,0,0,0,0,Sunday
2020-09-13,Heung Yuen Wai,0,0,0,0,0,0,0,0,Sunday
2020-09-13,Hong Kong-Zhuhai-Macao Bridge,229,20,7,256,70,2,4,76,Sunday
2020-09-13,Lok Ma Chau,0,0,0,0,0,0,0,0,Sunday
2020-09-13,Man Kam To,0,0,0,0,0,0,0,0,Sunday
2020-09-13,Sha Tau Kok,0,0,0,0,0,0,0,0,Sunday
2020-09-13,Shenzhen Bay,3251,443,9,3703,416,72,3,491,Sunday
2020-09-13,China Ferry Terminal,0,0,0,0,0,0,0,0,Sunday
2020-09-13,Harbour Control,0,0,0,0,0,0,0,0,Sunday
2020-09-13,Kai Tak Cruise Terminal,0,0,0,0,0,0,0,0,Sunday
2020-09-13,Macau Ferry Terminal,0,0,0,0,0,0,0,0,Sunday
2020-09-13,Tuen Mun Ferry Terminal,0,0,0,0,0,0,0,0,Sunday
2020-09-13,Total,4831,472,65,5368,1912,103,67,2082,Sunday
2020-09-14,Airport,656,4,26,686,866,8,38,912,Monday
2020-09-14,Express Rail Link West Kowloon,0,0,0,0,0,0,0,0,Monday
2020-09-14,Hung Hom,0,0,0,0,0,0,0,0,Monday
2020-09-14,Lo Wu,0,0,0,0,0,0,0,0,Monday
2020-09-14,Lok Ma Chau Spur Line,0,0,0,0,0,0,0,0,Monday
2020-09-14,Heung Yuen Wai,0,0,0,0,0,0,0,0,Monday
2020-09-14,Hong Kong-Zhuhai-Macao Bridge,160,9,3,172,87,2,3,92,Monday
2020-09-14,Lok Ma Chau,0,0,0,0,0,0,0,0,Monday
2020-09-14,Man Kam To,0,0,0,0,0,0,0,0,Monday
2020-09-14,Sha Tau Kok,0,0,0,0,0,0,0,0,Monday
2020-09-14,Shenzhen Bay,2277,302,7,2586,415,45,4,464,Monday
2020-09-14,China Ferry Terminal,0,0,0,0,0,0,0,0,Monday
2020-09-14,Harbour Control,0,0,0,0,0,0,0,0,Monday
2020-09-14,Kai Tak Cruise Terminal,0,0,0,0,0,0,0,0,Monday
2020-09-14,Macau Ferry Terminal,0,0,0,0,0,0,0,0,Monday
2020-09-14,Tuen Mun Ferry Terminal,0,0,0,0,0,0,0,0,Monday
2020-09-14,Total,3093,315,36,3444,1368,55,45,1468,Monday
2020-09-15,Airport,754,7,40,801,1340,18,64,1422,Tuesday
2020-09-15,Hung Hom,0,0,0,0,0,0,0,0,Tuesday
2020-09-15,Lo Wu,0,0,0,0,0,0,0,0,Tuesday
2020-09-15,Lok Ma Chau Spur Line,0,0,0,0,0,0,0,0,Tuesday
2020-09-15,Heung Yuen Wai,0,0,0,0,0,0,0,0,Tuesday
2020-09-15,Hong Kong-Zhuhai-Macao Bridge,125,6,5,136,128,3,3,134,Tuesday
2020-09-15,Lok Ma Chau,0,0,0,0,0,0,0,0,Tuesday
2020-09-15,Man Kam To,0,0,0,0,0,0,0,0,Tuesday
2020-09-15,Sha Tau Kok,0,0,0,0,0,0,0,0,Tuesday
2020-09-15,Shenzhen Bay,1764,263,9,2036,550,51,2,603,Tuesday
2020-09-15,China Ferry Terminal,0,0,0,0,0,0,0,0,Tuesday
2020-09-15,Harbour Control,0,0,0,0,0,0,0,0,Tuesday
2020-09-15,Kai Tak Cruise Terminal,0,0,0,0,0,0,0,0,Tuesday
2020-09-15,Macau Ferry Terminal,0,0,0,0,0,0,0,0,Tuesday
2020-09-15,Tuen Mun Ferry Terminal,0,0,0,0,0,0,0,0,Tuesday
2020-09-15,Total,2643,276,54,2973,2018,72,69,2159,Tuesday
2020-09-16,Airport,799,10,30,839,1065,17,47,1129,Wednesday
2020-09-16,Express Rail Link West Kowloon,0,0,0,0,0,0,0,0,Wednesday
2020-09-16,Hung Hom,0,0,0,0,0,0,0,0,Wednesday
2020-09-16,Lo Wu,0,0,0,0,0,0,0,0,Wednesday
2020-09-16,Lok Ma Chau Spur Line,0,0,0,0,0,0,0,0,Wednesday
2020-09-16,Heung Yuen Wai,0,0,0,0,0,0,0,0,Wednesday
2020-09-16,Hong Kong-Zhuhai-Macao Bridge,73,3,2,78,321,11,7,339,Wednesday
2020-09-16,Lok Ma Chau,0,0,0,0,0,0,0,0,Wednesday
2020-09-16,Man Kam To,0,0,0,0,0,0,0,0,Wednesday
2020-09-16,Sha Tau Kok,0,0,0,0,0,0,0,0,Wednesday
2020-09-16,Shenzhen Bay,1091,183,5,1279,1189,85,5,1279,Wednesday
2020-09-16,Harbour Control,0,0,0,0,0,0,0,0,Wednesday
2020-09-16,Kai Tak Cruise Terminal,0,0,0,0,0,0,0,0,Wednesday
2020-09-16,Macau Ferry Terminal,0,0,0,0,0,0,0,0,Wednesday
2020-09-16,Tuen Mun Ferry Terminal,0,0,0,0,0,0,0,0,Wednesday
2020-09-16,Total,1963,196,37,2196,2575,113,59,2747,Wednesday
2020-09-17,Hung Hom,0,0,0,0,0,0,0,0,Thursday
2020-09-17,Lo Wu,0,0,0,0,0,0,0,0,Thursday
2020-09-17,Lok Ma Chau Spur Line,0,0,0,0,0,0,0,0,Thursday
2020-09-17,Heung Yuen Wai,0,0,0,0,0,0,0,0,Thursday
2020-09-17,Hong Kong-Zhuhai-Macao Bridge,72,4,1,77,87,9,4,100,Thursday
2020-09-17,Lok Ma Chau,0,0,0,0,0,0,0,0,Thursday
2020-09-17,Man Kam To,0,0,0,0,0,0,0,0,Thursday
2020-09-17,Sha Tau Kok,0,0,0,0,0,0,0,0,Thursday
2020-09-17,Shenzhen Bay,844,103,0,947,459,37,3,499,Thursday
2020-09-17,China Ferry Terminal,0,0,0,0,0,0,0,0,Thursday
2020-09-17,Harbour Control,0,0,0,0,0,0,0,0,Thursday
2020-09-17,Kai Tak Cruise Terminal,0,0,0,0,0,0,0,0,Thursday
2020-09-17,Macau Ferry Terminal,0,0,0,0,0,0,0,0,Thursday
2020-09-17,Tuen Mun Ferry Terminal,0,0,0,0,0,0,0,0,Thursday
2020-09-17,Total,1566,112,22,1700,1822,52,49,1923,Thursday
2020-09-18,Airport,822,4,41,867,1336,5,41,1382,Friday
2020-09-18,Express Rail Link West Kowloon,0,0,0,0,0,0,0,0,Friday
2020-09-18,Hung Hom,0,0,0,0,0,0,0,0,Friday
2020-09-18,Lo Wu,0,0,0,0,0,0,0,0,Friday
2020-09-18,Lok Ma Chau Spur Line,0,0,0,0,0,0,0,0,Friday
2020-09-18,Heung Yuen Wai,0,0,0,0,0,0,0,0,Friday
2020-09-18,Hong Kong-Zhuhai-Macao Bridge,75,11,3,89,72,2,1,75,Friday
2020-09-18,Lok Ma Chau,0,0,0,0,0,0,0,0,Friday
2020-09-18,Man Kam To,0,0,0,0,0,0,0,0,Friday
2020-09-18,Sha Tau Kok,0,0,0,0,0,0,0,0,Friday
2020-09-18,Shenzhen Bay,868,121,4,993,393,48,11,452,Friday
2020-09-18,China Ferry Terminal,0,0,0,0,0,0,0,0,Friday
2020-09-18,Harbour Control,0,0,0,0,0,0,0,0,Friday
2020-09-18,Macau Ferry Terminal,0,0,0,0,0,0,0,0,Friday
2020-09-18,Tuen Mun Ferry Terminal,0,0,0,0,0,0,0,0,Friday
2020-09-18,Total,1765,136,48,1949,1801,55,53,1909,Friday
2020-09-19,Airport,1306,11,31,1348,1544,25,36,1605,Saturday
2020-09-19,Express Rail Link West Kowloon,0,0,0,0,0,0,0,0,Saturday
2020-09-19,Hung Hom,0,0,0,0,0,0,0,0,Saturday
2020-09-19,Lo Wu,0,0,0,0,0,0,0,0,Saturday
2020-09-19,Lok Ma Chau Spur Line,0,0,0,0,0,0,0,0,Saturday
2020-09-19,Heung Yuen Wai,0,0,0,0,0,0,0,0,Saturday
2020-09-19,Hong Kong-Zhuhai-Macao Bridge,114,9,4,127,82,6,5,93,Saturday
2020-09-19,Lok Ma Chau,0,0,0,0,0,0,0,0,Saturday
2020-09-19,Man Kam To,0,0,0,0,0,0,0,0,Saturday
2020-09-19,Sha Tau Kok,0,0,0,0,0,0,0,0,Saturday
2020-09-19,Shenzhen Bay,1236,202,4,1442,357,52,6,415,Saturday
2020-09-19,China Ferry Terminal,0,0,0,0,0,0,0,0,Saturday
2020-09-19,Harbour Control,0,0,0,0,0,0,0,0,Saturday
2020-09-19,Kai Tak Cruise Terminal,0,0,0,0,0,0,0,0,Saturday
2020-09-19,Macau Ferry Terminal,0,0,0,0,0,0,0,0,Saturday
2020-09-19,Tuen Mun Ferry Terminal,0,0,0,0,0,0,0,0,Saturday
2020-09-19,Total,2656,222,39,2917,1983,83,47,2113,Saturday
2020-09-20,Airport,1171,9,43,1223,1292,21,48,1361,Sunday
2020-09-20,Hung Hom,0,0,0,0,0,0,0,0,Sunday
2020-09-20,Lo Wu,0,0,0,0,0,0,0,0,Sunday
2020-09-20,Lok Ma Chau Spur Line,0,0,0,0,0,0,0,0,Sunday
2020-09-20,Heung Yuen Wai,0,0,0,0,0,0,0,0,Sunday
2020-09-20,Hong Kong-Zhuhai-Macao Bridge,144,16,5,165,50,5,1,56,Sunday
2020-09-20,Lok Ma Chau,0,0,0,0,0,0,0,0,Sunday
2020-09-20,Man Kam To,0,0,0,0,0,0,0,0,Sunday
2020-09-20,Sha Tau Kok,0,0,0,0,0,0,0,0,Sunday
2020-09-20,Shenzhen Bay,2339,314,9,2662,313,26,6,345,Sunday
2020-09-20,China Ferry Terminal,0,0,0,0,0,0,0,0,Sunday
2020-09-20,Harbour Control,0,0,0,0,0,0,0,0,Sunday
2020-09-20,Kai Tak Cruise Terminal,0,0,0,0,0,0,0,0,Sunday
2020-09-20,Macau Ferry Terminal,0,0,0,0,0,0,0,0,Sunday
2020-09-20,Tuen Mun Ferry Terminal,0,0,0,0,0,0,0,0,Sunday
2020-09-20,Total,3654,339,57,4050,1655,52,55,1762,Sunday
2020-09-21,Airport,740,1,17,758,1110,5,23,1138,Monday
2020-09-21,Express Rail Link West Kowloon,0,0,0,0,0,0,0,0,Monday
2020-09-21,Hung Hom,0,0,0,0,0,0,0,0,Monday
2020-09-21,Lo Wu,0,0,0,0,0,0,0,0,Monday
2020-09-21,Lok Ma Chau Spur Line,0,0,0,0,0,0,0,0,Monday
2020-09-21,Heung Yuen Wai,0,0,0,0,0,0,0,0,Monday
2020-09-21,Hong Kong-Zhuhai-Macao Bridge,119,9,1,129,44,1,3,48,Monday
2020-09-21,Lok Ma Chau,0,0,0,0,0,0,0,0,Monday
2020-09-21,Man Kam To,0,0,0,0,0,0,0,0,Monday
2020-09-21,Sha Tau Kok,0,0,0,0,0,0,0,0,Monday
2020-09-21,Shenzhen Bay,1398,204,3,1605,296,39,3,338,Monday
2020-09-21,China Ferry Terminal,0,0,0,0,0,0,0,0,Monday
2020-09-21,Harbour Control,0,0,0,0,0,0,0,0,Monday
2020-09-21,Kai Tak Cruise Terminal,0,0,0,0,0,0,0,0,Monday
2020-09-21,Macau Ferry Terminal,0,0,0,0,0,0,0,0,Monday
2020-09-21,Total,2257,214,21,2492,1450,45,29,1524,Monday
2020-09-22,Airport,740,2,21,763,1109,22,57,1188,Tuesday
2020-09-22,Express Rail Link West Kowloon,0,0,0,0,0,0,0,0,Tuesday
2020-09-22,Hung Hom,0,0,0,0,0,0,0,0,Tuesday
2020-09-22,Lo Wu,0,0,0,0,0,0,0,0,Tuesday
2020-09-22,Lok Ma Chau Spur Line,0,0,0,0,0,0,0,0,Tuesday
2020-09-22,Heung Yuen Wai,0,0,0,0,0,0,0,0,Tuesday
2020-09-22,Hong Kong-Zhuhai-Macao Bridge,104,5,2,111,102,6,1,109,Tuesday
2020-09-22,Lok Ma Chau,0,0,0,0,0,0,0,0,Tuesday
2020-09-22,Man Kam To,0,0,0,0,0,0,0,0,Tuesday
2020-09-22,Shenzhen Bay,950,129,3,1082,373,32,7,412,Tuesday
2020-09-22,Harbour Control,0,0,0,0,0,0,0,0,Tuesday
2020-09-22,Kai Tak Cruise Terminal,0,0,0,0,0,0,0,0,Tuesday
2020-09-22,Macau Ferry Terminal,0,0,0,0,0,0,0,0,Tuesday
2020-09-22,Tuen Mun Ferry Terminal,0,0,0,0,0,0,0,0,Tuesday
2020-09-22,Total,1794,136,26,1956,1584,60,65,1709,Tuesday
2020-09-23,Airport,884,1,39,924,891,11,60,962,Wednesday
2020-09-23,Express Rail Link West Kowloon,0,0,0,0,0,0,0,0,Wednesday
2020-09-23,Hung Hom,0,0,0,0,0,0,0,0,Wednesday
2020-09-23,Lo Wu,0,0,0,0,0,0,0,0,Wednesday
2020-09-23,Lok Ma Chau Spur Line,0,0,0,0,0,0,0,0,Wednesday
2020-09-23,Heung Yuen Wai,0,0,0,0,0,0,0,0,Wednesday
2020-09-23,Hong Kong-Zhuhai-Macao Bridge,88,6,4,98,175,5,1,181,Wednesday
2020-09-23,Lok Ma Chau,0,0,0,0,0,0,0,0,Wednesday
2020-09-23,Man Kam To,0,0,0,0,0,0,0,0,Wednesday
2020-09-23,Sha Tau Kok,0,0,0,0,0,0,0,0,Wednesday
2020-09-23,Shenzhen Bay,878,141,6,1025,573,80,8,661,Wednesday
2020-09-23,China Ferry Terminal,0,0,0,0,0,0,0,0,Wednesday
2020-09-23,Harbour Control,0,0,0,0,0,0,0,0,Wednesday
2020-09-23,Macau Ferry Terminal,0,0,0,0,0,0,0,0,Wednesday
2020-09-23,Tuen Mun Ferry Terminal,0,0,0,0,0,0,0,0,Wednesday
2020-09-23,Total,1850,148,49,2047,1639,96,69,1804,Wednesday
2020-09-24,Airport,604,3,14,621,1255,6,37,1298,Thursday
2020-09-24,Express Rail Link West Kowloon,0,0,0,0,0,0,0,0,Thursday
2020-09-24,Hung Hom,0,0,0,0,0,0,0,0,Thursday
2020-09-24,Lo Wu,0,0,0,0,0,0,0,0,Thursday
2020-09-24,Lok Ma Chau Spur Line,0,0,0,0,0,0,0,0,Thursday
2020-09-24,Heung Yuen Wai,0,0,0,0,0,0,0,0,Thursday
2020-09-24,Hong Kong-Zhuhai-Macao Bridge,103,6,3,112,110,4,0,114,Thursday
2020-09-24,Lok Ma Chau,0,0,0,0,0,0,0,0,Thursday
2020-09-24,Man Kam To,0,0,0,0,0,0,0,0,Thursday
2020-09-24,Sha Tau Kok,0,0,0,0,0,0,0,0,Thursday
2020-09-24,Shenzhen Bay,769,119,5,893,495,61,7,563,Thursday
2020-09-24,China Ferry Terminal,0,0,0,0,0,0,0,0,Thursday
2020-09-24,Harbour Control,0,0,0,0,0,0,0,0,Thursday
2020-09-24,Kai Tak Cruise Terminal,0,0,0,0,0,0,0,0,Thursday
2020-09-24,Macau Ferry Terminal,0,0,0,0,0,0,0,0,Thursday
2020-09-24,Tuen Mun Ferry Terminal,0,0,0,0,0,0,0,0,Thursday
2020-09-24,Total,1476,128,22,1626,1860,71,44,1975,Thursday
2020-09-25,Airport,885,3,42,930,1358,13,51,1422,Friday
2020-09-25,Express Rail Link West Kowloon,0,0,0,0,0,0,0,0,Friday
2020-09-25,Hung Hom,0,0,0,0,0,0,0,0,Friday
2020-09-25,Lo Wu,0,0,0,0,0,0,0,0,Friday
2020-09-25,Lok Ma Chau Spur Line,0,0,0,0,0,0,0,0,Friday
2020-09-25,Heung Yuen Wai,0,0,0,0,0,0,0,0,Friday
2020-09-25,Lok Ma Chau,0,0,0,0,0,0,0,0,Friday
2020-09-25,Man Kam To,0,0,0,0,0,0,0,0,Friday
2020-09-25,Sha Tau Kok,0,0,0,0,0,0,0,0,Friday
2020-09-25,Shenzhen Bay,965,129,6,1100,513,71,5,589,Friday
2020-09-25,China Ferry Terminal,0,0,0,0,0,0,0,0,Friday
2020-09-25,Harbour Control,0,0,0,0,0,0,0,0,Friday
2020-09-25,Kai Tak Cruise Terminal,0,0,0,0,0,0,0,0,Friday
2020-09-25,Macau Ferry Terminal,0,0,0,0,0,0,0,0,Friday
2020-09-25,Tuen Mun Ferry Terminal,0,0,0,0,0,0,0,0,Friday
2020-09-25,Total,1972,135,49,2156,2032,89,56,2177,Friday
2020-09-26,Airport,1100,18,12,1130,1382,47,27,1456,Saturday
2020-09-26,Express Rail Link West Kowloon,0,0,0,0,0,0,0,0,Saturday
2020-09-26,Hung Hom,0,0,0,0,0,0,0,0,Saturday
2020-09-26,Lo Wu,0,0,0,0,0,0,0,0,Saturday
2020-09-26,Lok Ma Chau Spur Line,0,0,0,0,0,0,0,0,Saturday
2020-09-26,Heung Yuen Wai,0,0,0,0,0,0,0,0,Saturday
2020-09-26,Hong Kong-Zhuhai-Macao Bridge,87,9,1,97,83,7,1,91,Saturday
2020-09-26,Lok Ma Chau,0,0,0,0,0,0,0,0,Saturday
2020-09-26,Man Kam To,0,0,0,0,0,0,0,0,Saturday
2020-09-26,Sha Tau Kok,0,0,0,0,0,0,0,0,Saturday
2020-09-26,Shenzhen Bay,1003,128,5,1136,489,80,5,574,Saturday
2020-09-26,China Ferry Terminal,0,0,0,0,0,0,0,0,Saturday
2020-09-26,Harbour Control,0,0,0,0,0,0,0,0,Saturday
2020-09-26,Kai Tak Cruise Terminal,0,0,0,0,0,0,0,0,Saturday
2020-09-26,Macau Ferry Terminal,0,0,0,0,0,0,0,0,Saturday
2020-09-26,Tuen Mun Ferry Terminal,0,0,0,0,0,0,0,0,Saturday
2020-09-26,Total,2190,155,18,2363,1954,134,33,2121,Saturday
2020-09-27,Airport,1315,3,37,1355,1213,8,52,1273,Sunday
2020-09-27,Hung Hom,0,0,0,0,0,0,0,0,Sunday
2020-09-27,Lo Wu,0,0,0,0,0,0,0,0,Sunday
2020-09-27,Lok Ma Chau Spur Line,0,0,0,0,0,0,0,0,Sunday
2020-09-27,Heung Yuen Wai,0,0,0,0,0,0,0,0,Sunday
2020-09-27,Hong Kong-Zhuhai-Macao Bridge,51,5,2,58,51,2,0,53,Sunday
2020-09-27,Lok Ma Chau,0,0,0,0,0,0,0,0,Sunday
2020-09-27,Man Kam To,0,0,0,0,0,0,0,0,Sunday
2020-09-27,Sha Tau Kok,0,0,0,0,0,0,0,0,Sunday
2020-09-27,Shenzhen Bay,1073,147,4,1224,308,40,9,357,Sunday
2020-09-27,China Ferry Terminal,0,0,0,0,0,0,0,0,Sunday
2020-09-27,Harbour Control,0,0,0,0,0,0,0,0,Sunday
2020-09-27,Kai Tak Cruise Terminal,0,0,0,0,0,0,0,0,Sunday
2020-09-27,Macau Ferry Terminal,0,0,0,0,0,0,0,0,Sunday
2020-09-27,Tuen Mun Ferry Terminal,0,0,0,0,0,0,0,0,Sunday
2020-09-27,Total,2439,155,43,2637,1572,50,61,1683,Sunday
2020-09-28,Hung Hom,0,0,0,0,0,0,0,0,Monday
2020-09-28,Lo Wu,0,0,0,0,0,0,0,0,Monday
2020-09-28,Lok Ma Chau Spur Line,0,0,0,0,0,0,0,0,Monday
2020-09-28,Heung Yuen Wai,0,0,0,0,0,0,0,0,Monday
2020-09-28,Hong Kong-Zhuhai-Macao Bridge,52,4,1,57,49,6,3,58,Monday
2020-09-28,Lok Ma Chau,0,0,0,0,0,0,0,0,Monday
2020-09-28,Man Kam To,0,0,0,0,0,0,0,0,Monday
2020-09-28,Sha Tau Kok,0,0,0,0,0,0,0,0,Monday
2020-09-28,Shenzhen Bay,882,116,5,1003,426,31,9,466,Monday
2020-09-28,China Ferry Terminal,0,0,0,0,0,0,0,0,Monday
2020-09-28,Harbour Control,0,0,0,0,0,0,0,0,Monday
2020-09-28,Kai Tak Cruise Terminal,0,0,0,0,0,0,0,0,Monday
2020-09-28,Macau Ferry Terminal,0,0,0,0,0,0,0,0,Monday
2020-09-28,Tuen Mun Ferry Terminal,0,0,0,0,0,0,0,0,Monday
2020-09-28,Total,1899,124,41,2064,1494,49,52,1595,Monday
2020-09-29,Airport,1224,11,30,1265,1303,20,75,1398,Tuesday
2020-09-29,Express Rail Link West Kowloon,0,0,0,0,0,0,0,0,Tuesday
2020-09-29,Hung Hom,0,0,0,0,0,0,0,0,Tuesday
2020-09-29,Lo Wu,0,0,0,0,0,0,0,0,Tuesday
2020-09-29,Lok Ma Chau Spur Line,0,0,0,0,0,0,0,0,Tuesday
2020-09-29,Heung Yuen Wai,0,0,0,0,0,0,0,0,Tuesday
2020-09-29,Lok Ma Chau,0,0,0,0,0,0,0,0,Tuesday
2020-09-29,Man Kam To,0,0,0,0,0,0,0,0,Tuesday
2020-09-29,Sha Tau Kok,0,0,0,0,0,0,0,0,Tuesday
2020-09-29,Shenzhen Bay,1010,124,4,1138,411,48,4,463,Tuesday
2020-09-29,China Ferry Terminal,0,0,0,0,0,0,0,0,Tuesday
2020-09-29,Harbour Control,0,0,0,0,0,0,0,0,Tuesday
2020-09-29,Kai Tak Cruise Terminal,0,0,0,0,0,0,0,0,Tuesday
2020-09-29,Macau Ferry Terminal,0,0,0,0,0,0,0,0,Tuesday
2020-09-29,Tuen Mun Ferry Terminal,0,0,0,0,0,0,0,0,Tuesday
2020-09-29,Total,2315,141,39,2495,1792,71,87,1950,Tuesday
2020-09-30,Airport,1678,3,28,1709,992,18,49,1059,Wednesday
2020-09-30,Express Rail Link West Kowloon,0,0,0,0,0,0,0,0,Wednesday
2020-09-30,Hung Hom,0,0,0,0,0,0,0,0,Wednesday
2020-09-30,Lo Wu,0,0,0,0,0,0,0,0,Wednesday
2020-09-30,Lok Ma Chau Spur Line,0,0,0,0,0,0,0,0,Wednesday
2020-09-30,Heung Yuen Wai,0,0,0,0,0,0,0,0,Wednesday
2020-09-30,Hong Kong-Zhuhai-Macao Bridge,133,5,8,146,88,7,2,97,Wednesday
2020-09-30,Lok Ma Chau,0,0,0,0,0,0,0,0,Wednesday
2020-09-30,Man Kam To,0,0,0,0,0,0,0,0,Wednesday
2020-09-30,Sha Tau Kok,0,0,0,0,0,0,0,0,Wednesday
2020-09-30,Shenzhen Bay,1201,141,6,1348,667,79,22,768,Wednesday
2020-09-30,China Ferry Terminal,0,0,0,0,0,0,0,0,Wednesday
2020-09-30,Harbour Control,0,0,0,0,0,0,0,0,Wednesday
2020-09-30,Kai Tak Cruise Terminal,0,0,0,0,0,0,0,0,Wednesday
2020-09-30,Macau Ferry Terminal,0,0,0,0,0,0,0,0,Wednesday
2020-09-30,Tuen Mun Ferry Terminal,0,0,0,0,0,0,0,0,Wednesday
2020-09-30,Total,3012,149,42,3203,1747,104,73,1924,Wednesday
2020-10-01,Airport,898,4,34,936,1147,5,101,1253,Thursday
2020-10-01,Hung Hom,0,0,0,0,0,0,0,0,Thursday
2020-10-01,Lo Wu,0,0,0,0,0,0,0,0,Thursday
2020-10-01,Lok Ma Chau Spur Line,0,0,0,0,0,0,0,0,Thursday
2020-10-01,Heung Yuen Wai,0,0,0,0,0,0,0,0,Thursday
2020-10-01,Hong Kong-Zhuhai-Macao Bridge,58,4,76,138,80,10,2,92,Thursday
2020-10-01,Lok Ma Chau,0,0,0,0,0,0,0,0,Thursday
2020-10-01,Man Kam To,0,0,0,0,0,0,0,0,Thursday
2020-10-01,Sha Tau Kok,0,0,0,0,0,0,0,0,Thursday
2020-10-01,Shenzhen Bay,570,85,8,663,403,46,3,452,Thursday
2020-10-01,China Ferry Terminal,0,0,0,0,0,0,0,0,Thursday
2020-10-01,Harbour Control,0,0,0,0,0,0,0,0,Thursday
2020-10-01,Kai Tak Cruise Terminal,0,0,0,0,0,0,0,0,Thursday
2020-10-01,Macau Ferry Terminal,0,0,0,0,0,0,0,0,Thursday
2020-10-01,Tuen Mun Ferry Terminal,0,0,0,0,0,0,0,0,Thursday
2020-10-01,Total,1526,93,118,1737,1630,61,106,1797,Thursday
2020-10-02,Airport,677,4,43,724,960,19,66,1045,Friday
2020-10-02,Express Rail Link West Kowloon,0,0,0,0,0,0,0,0,Friday
2020-10-02,Hung Hom,0,0,0,0,0,0,0,0,Friday
2020-10-02,Lo Wu,0,0,0,0,0,0,0,0,Friday
2020-10-02,Lok Ma Chau Spur Line,0,0,0,0,0,0,0,0,Friday
2020-10-02,Heung Yuen Wai,0,0,0,0,0,0,0,0,Friday
2020-10-02,Hong Kong-Zhuhai-Macao Bridge,54,0,5,59,48,3,1,52,Friday
2020-10-02,Lok Ma Chau,0,0,0,0,0,0,0,0,Friday
2020-10-02,Man Kam To,0,0,0,0,0,0,0,0,Friday
2020-10-02,Sha Tau Kok,0,0,0,0,0,0,0,0,Friday
2020-10-02,Shenzhen Bay,946,150,2,1098,388,60,6,454,Friday
2020-10-02,China Ferry Terminal,0,0,0,0,0,0,0,0,Friday
2020-10-02,Harbour Control,0,0,0,0,0,0,0,0,Friday
2020-10-02,Kai Tak Cruise Terminal,0,0,0,0,0,0,0,0,Friday
2020-10-02,Macau Ferry Terminal,0,0,0,0,0,0,0,0,Friday
2020-10-02,Tuen Mun Ferry Terminal,0,0,0,0,0,0,0,0,Friday
2020-10-02,Total,1677,154,50,1881,1396,82,73,1551,Friday
2020-10-03,Airport,760,4,19,783,1051,21,58,1130,Saturday
2020-10-03,Hung Hom,0,0,0,0,0,0,0,0,Saturday
2020-10-03,Lo Wu,0,0,0,0,0,0,0,0,Saturday
2020-10-03,Lok Ma Chau Spur Line,0,0,0,0,0,0,0,0,Saturday
2020-10-03,Heung Yuen Wai,0,0,0,0,0,0,0,0,Saturday
2020-10-03,Hong Kong-Zhuhai-Macao Bridge,54,12,5,71,35,2,2,39,Saturday
2020-10-03,Lok Ma Chau,0,0,0,0,0,0,0,0,Saturday
2020-10-03,Sha Tau Kok,0,0,0,0,0,0,0,0,Saturday
2020-10-03,China Ferry Terminal,0,0,0,0,0,0,0,0,Saturday
2020-10-03,Harbour Control,0,0,0,0,0,0,0,0,Saturday
2020-10-03,Kai Tak Cruise Terminal,0,0,0,0,0,0,0,0,Saturday
2020-10-03,Macau Ferry Terminal,0,0,0,0,0,0,0,0,Saturday
2020-10-03,Tuen Mun Ferry Terminal,0,0,0,0,0,0,0,0,Saturday
2020-10-03,Total,1751,186,30,1967,1268,54,63,1385,Saturday
2020-10-04,Airport,1030,3,59,1092,846,8,44,898,Sunday
2020-10-04,Express Rail Link West Kowloon,0,0,0,0,0,0,0,0,Sunday
2020-10-04,Hung Hom,0,0,0,0,0,0,0,0,Sunday
2020-10-04,Lo Wu,0,0,0,0,0,0,0,0,Sunday
2020-10-04,Lok Ma Chau Spur Line,0,0,0,0,0,0,0,0,Sunday
2020-10-04,Heung Yuen Wai,0,0,0,0,0,0,0,0,Sunday
2020-10-04,Lok Ma Chau,0,0,0,0,0,0,0,0,Sunday
2020-10-04,Man Kam To,0,0,0,0,0,0,0,0,Sunday
2020-10-04,Sha Tau Kok,0,0,0,0,0,0,0,0,Sunday
2020-10-04,Shenzhen Bay,1290,212,9,1511,320,49,9,378,Sunday
2020-10-04,China Ferry Terminal,0,0,0,0,0,0,0,0,Sunday
2020-10-04,Harbour Control,0,0,0,0,0,0,0,0,Sunday
2020-10-04,Kai Tak Cruise Terminal,0,0,0,0,0,0,0,0,Sunday
2020-10-04,Macau Ferry Terminal,0,0,0,0,0,0,0,0,Sunday
2020-10-04,Tuen Mun Ferry Terminal,0,0,0,0,0,0,0,0,Sunday
2020-10-04,Total,2397,225,72,2694,1226,62,56,1344,Sunday
2020-10-05,Airport,731,2,33,766,717,13,34,764,Monday
2020-10-05,Express Rail Link West Kowloon,0,0,0,0,0,0,0,0,Monday
2020-10-05,Hung Hom,0,0,0,0,0,0,0,0,Monday
2020-10-05,Lo Wu,0,0,0,0,0,0,0,0,Monday
2020-10-05,Lok Ma Chau Spur Line,0,0,0,0,0,0,0,0,Monday
2020-10-05,Heung Yuen Wai,0,0,0,0,0,0,0,0,Monday
2020-10-05,Hong Kong-Zhuhai-Macao Bridge,78,4,4,86,98,14,5,117,Monday
2020-10-05,Lok Ma Chau,0,0,0,0,0,0,0,0,Monday
2020-10-05,Man Kam To,0,0,0,0,0,0,0,0,Monday
2020-10-05,Sha Tau Kok,0,0,0,0,0,0,0,0,Monday
2020-10-05,Shenzhen Bay,927,137,2,1066,450,77,6,533,Monday
2020-10-05,China Ferry Terminal,0,0,0,0,0,0,0,0,Monday
2020-10-05,Harbour Control,0,0,0,0,0,0,0,0,Monday
2020-10-05,Kai Tak Cruise Terminal,0,0,0,0,0,0,0,0,Monday
2020-10-05,Macau Ferry Terminal,0,0,0,0,0,0,0,0,Monday
2020-10-05,Tuen Mun Ferry Terminal,0,0,0,0,0,0,0,0,Monday
2020-10-05,Total,1736,143,39,1918,1265,104,45,1414,Monday
2020-10-06,Airport,701,4,24,729,823,23,29,875,Tuesday
2020-10-06,Hung Hom,0,0,0,0,0,0,0,0,Tuesday
2020-10-06,Lo Wu,0,0,0,0,0,0,0,0,Tuesday
2020-10-06,Lok Ma Chau Spur Line,0,0,0,0,0,0,0,0,Tuesday
2020-10-06,Heung Yuen Wai,0,0,0,0,0,0,0,0,Tuesday
2020-10-06,Hong Kong-Zhuhai-Macao Bridge,66,3,1,70,160,7,0,167,Tuesday
2020-10-06,Lok Ma Chau,0,0,0,0,0,0,0,0,Tuesday
2020-10-06,Man Kam To,0,0,0,0,0,0,0,0,Tuesday
2020-10-06,Sha Tau Kok,0,0,0,0,0,0,0,0,Tuesday
2020-10-06,Shenzhen Bay,821,86,5,912,733,86,6,825,Tuesday
2020-10-06,China Ferry Terminal,0,0,0,0,0,0,0,0,Tuesday
2020-10-06,Harbour Control,0,0,0,0,0,0,0,0,Tuesday
2020-10-06,Kai Tak Cruise Terminal,0,0,0,0,0,0,0,0,Tuesday
2020-10-06,Macau Ferry Terminal,0,0,0,0,0,0,0,0,Tuesday
2020-10-06,Tuen Mun Ferry Terminal,0,0,0,0,0,0,0,0,Tuesday
2020-10-06,Total,1588,93,30,1711,1716,116,35,1867,Tuesday
2020-10-07,Airport,525,1,26,552,621,11,38,670,Wednesday
2020-10-07,Express Rail Link West Kowloon,0,0,0,0,0,0,0,0,Wednesday
2020-10-07,Hung Hom,0,0,0,0,0,0,0,0,Wednesday
2020-10-07,Lo Wu,0,0,0,0,0,0,0,0,Wednesday
2020-10-07,Lok Ma Chau Spur Line,0,0,0,0,0,0,0,0,Wednesday
2020-10-07,Heung Yuen Wai,0,0,0,0,0,0,0,0,Wednesday
2020-10-07,Hong Kong-Zhuhai-Macao Bridge,74,7,6,87,158,5,4,167,Wednesday
2020-10-07,Lok Ma Chau,0,0,0,0,0,0,0,0,Wednesday
2020-10-07,Man Kam To,0,0,0,0,0,0,0,0,Wednesday
2020-10-07,Sha Tau Kok,0,0,0,0,0,0,0,0,Wednesday
2020-10-07,Shenzhen Bay,602,77,3,682,998,171,7,1176,Wednesday
2020-10-07,China Ferry Terminal,0,0,0,0,0,0,0,0,Wednesday
2020-10-07,Harbour Control,0,0,0,0,0,0,0,0,Wednesday
2020-10-07,Macau Ferry Terminal,0,0,0,0,0,0,0,0,Wednesday
2020-10-07,Tuen Mun Ferry Terminal,0,0,0,0,0,0,0,0,Wednesday
2020-10-07,Total,1201,85,35,1321,1777,187,49,2013,Wednesday
2020-10-08,Airport,798,1,35,834,932,6,53,991,Thursday
2020-10-08,Express Rail Link West Kowloon,0,0,0,0,0,0,0,0,Thursday
2020-10-08,Hung Hom,0,0,0,0,0,0,0,0,Thursday
2020-10-08,Lo Wu,0,0,0,0,0,0,0,0,Thursday
2020-10-08,Lok Ma Chau Spur Line,0,0,0,0,0,0,0,0,Thursday
2020-10-08,Heung Yuen Wai,0,0,0,0,0,0,0,0,Thursday
2020-10-08,Hong Kong-Zhuhai-Macao Bridge,76,2,2,80,165,14,2,181,Thursday
2020-10-08,Lok Ma Chau,0,0,0,0,0,0,0,0,Thursday
2020-10-08,Man Kam To,0,0,0,0,0,0,0,0,Thursday
2020-10-08,Sha Tau Kok,0,0,0,0,0,0,0,0,Thursday
2020-10-08,Shenzhen Bay,701,73,2,776,931,112,5,1048,Thursday
2020-10-08,China Ferry Terminal,0,0,0,0,0,0,0,0,Thursday
2020-10-08,Harbour Control,0,0,0,0,0,0,0,0,Thursday
2020-10-08,Kai Tak Cruise Terminal,0,0,0,0,0,0,0,0,Thursday
2020-10-08,Macau Ferry Terminal,0,0,0,0,0,0,0,0,Thursday
2020-10-08,Tuen Mun Ferry Terminal,0,0,0,0,0,0,0,0,Thursday
2020-10-09,Airport,793,5,37,835,790,45,26,861,Friday
2020-10-09,Hung Hom,0,0,0,0,0,0,0,0,Friday
2020-10-09,Lo Wu,0,0,0,0,0,0,0,0,Friday
2020-10-09,Lok Ma Chau Spur Line,0,0,0,0,0,0,0,0,Friday
2020-10-09,Heung Yuen Wai,0,0,0,0,0,0,0,0,Friday
2020-10-09,Hong Kong-Zhuhai-Macao Bridge,69,0,7,76,142,11,9,162,Friday
2020-10-09,Lok Ma Chau,0,0,0,0,0,0,0,0,Friday
2020-10-09,Man Kam To,0,0,0,0,0,0,0,0,Friday
2020-10-09,Sha Tau Kok,0,0,0,0,0,0,0,0,Friday
2020-10-09,Shenzhen Bay,811,99,1,911,767,104,11,882,Friday
2020-10-09,China Ferry Terminal,0,0,0,0,0,0,0,0,Friday
2020-10-09,Harbour Control,0,0,0,0,0,0,0,0,Friday
2020-10-09,Kai Tak Cruise Terminal,0,0,0,0,0,0,0,0,Friday
2020-10-09,Macau Ferry Terminal,0,0,0,0,0,0,0,0,Friday
2020-10-09,Tuen Mun Ferry Terminal,0,0,0,0,0,0,0,0,Friday
2020-10-09,Total,1673,104,45,1822,1699,160,46,1905,Friday
2020-10-10,Airport,670,4,14,688,1028,30,26,1084,Saturday
2020-10-10,Express Rail Link West Kowloon,0,0,0,0,0,0,0,0,Saturday
2020-10-10,Hung Hom,0,0,0,0,0,0,0,0,Saturday
2020-10-10,Lo Wu,0,0,0,0,0,0,0,0,Saturday
2020-10-10,Lok Ma Chau Spur Line,0,0,0,0,0,0,0,0,Saturday
2020-10-10,Heung Yuen Wai,0,0,0,0,0,0,0,0,Saturday
2020-10-10,Lok Ma Chau,0,0,0,0,0,0,0,0,Saturday
2020-10-10,Man Kam To,0,0,0,0,0,0,0,0,Saturday
2020-10-10,Sha Tau Kok,0,0,0,0,0,0,0,0,Saturday
2020-10-10,Shenzhen Bay,1212,174,2,1388,830,125,9,964,Saturday
2020-10-10,China Ferry Terminal,0,0,0,0,0,0,0,0,Saturday
2020-10-10,Harbour Control,0,0,0,0,0,0,0,0,Saturday
2020-10-10,Kai Tak Cruise Terminal,0,0,0,0,0,0,0,0,Saturday
2020-10-10,Macau Ferry Terminal,0,0,0,0,0,0,0,0,Saturday
2020-10-10,Tuen Mun Ferry Terminal,0,0,0,0,0,0,0,0,Saturday
2020-10-10,Total,1966,185,20,2171,1968,167,37,2172,Saturday
2020-10-11,Airport,1304,13,68,1385,940,48,48,1036,Sunday
2020-10-11,Express Rail Link West Kowloon,0,0,0,0,0,0,0,0,Sunday
2020-10-11,Hung Hom,0,0,0,0,0,0,0,0,Sunday
2020-10-11,Lo Wu,0,0,0,0,0,0,0,0,Sunday
2020-10-11,Lok Ma Chau Spur Line,0,0,0,0,0,0,0,0,Sunday
2020-10-11,Heung Yuen Wai,0,0,0,0,0,0,0,0,Sunday
2020-10-11,Hong Kong-Zhuhai-Macao Bridge,82,8,3,93,70,10,0,80,Sunday
2020-10-11,Lok Ma Chau,0,0,0,0,0,0,0,0,Sunday
2020-10-11,Man Kam To,0,0,0,0,0,0,0,0,Sunday
2020-10-11,Sha Tau Kok,0,0,0,0,0,0,0,0,Sunday
2020-10-11,Shenzhen Bay,1370,157,3,1530,430,106,5,541,Sunday
2020-10-11,China Ferry Terminal,0,0,0,0,0,0,0,0,Sunday
2020-10-11,Harbour Control,0,0,0,0,0,0,0,0,Sunday
2020-10-11,Kai Tak Cruise Terminal,0,0,0,0,0,0,0,0,Sunday
2020-10-11,Macau Ferry Terminal,0,0,0,0,0,0,0,0,Sunday
2020-10-11,Tuen Mun Ferry Terminal,0,0,0,0,0,0,0,0,Sunday
2020-10-11,Total,2756,178,74,3008,1440,164,53,1657,Sunday
2020-10-12,Airport,478,10,32,520,545,11,40,596,Monday
2020-10-12,Hung Hom,0,0,0,0,0,0,0,0,Monday
2020-10-12,Lo Wu,0,0,0,0,0,0,0,0,Monday
2020-10-12,Lok Ma Chau Spur Line,0,0,0,0,0,0,0,0,Monday
2020-10-12,Heung Yuen Wai,0,0,0,0,0,0,0,0,Monday
2020-10-12,Hong Kong-Zhuhai-Macao Bridge,61,6,2,69,103,6,1,110,Monday
2020-10-12,Lok Ma Chau,0,0,0,0,0,0,0,0,Monday
2020-10-12,Man Kam To,0,0,0,0,0,0,0,0,Monday
2020-10-12,Sha Tau Kok,0,0,0,0,0,0,0,0,Monday
2020-10-12,Shenzhen Bay,1169,133,5,1307,643,73,5,721,Monday
2020-10-12,China Ferry Terminal,0,0,0,0,0,0,0,0,Monday
2020-10-12,Harbour Control,0,0,0,0,0,0,0,0,Monday
2020-10-12,Kai Tak Cruise Terminal,0,0,0,0,0,0,0,0,Monday
2020-10-12,Macau Ferry Terminal,0,0,0,0,0,0,0,0,Monday
2020-10-12,Tuen Mun Ferry Terminal,0,0,0,0,0,0,0,0,Monday
2020-10-12,Total,1708,149,39,1896,1291,90,46,1427,Monday
2020-10-13,Airport,422,2,31,455,639,22,27,688,Tuesday
2020-10-13,Express Rail Link West Kowloon,0,0,0,0,0,0,0,0,Tuesday
2020-10-13,Hung Hom,0,0,0,0,0,0,0,0,Tuesday
2020-10-13,Lo Wu,0,0,0,0,0,0,0,0,Tuesday
2020-10-13,Lok Ma Chau Spur Line,0,0,0,0,0,0,0,0,Tuesday
2020-10-13,Heung Yuen Wai,0,0,0,0,0,0,0,0,Tuesday
2020-10-13,Hong Kong-Zhuhai-Macao Bridge,0,0,0,0,0,0,0,0,Tuesday
2020-10-13,Lok Ma Chau,0,0,0,0,0,0,0,0,Tuesday
2020-10-13,Man Kam To,0,0,0,0,0,0,0,0,Tuesday
2020-10-13,Sha Tau Kok,0,0,0,0,0,0,0,0,Tuesday
2020-10-13,Shenzhen Bay,691,88,2,781,427,32,4,463,Tuesday
2020-10-13,China Ferry Terminal,0,0,0,0,0,0,0,0,Tuesday
2020-10-13,Harbour Control,0,0,0,0,0,0,0,0,Tuesday
2020-10-13,Kai Tak Cruise Terminal,0,0,0,0,0,0,0,0,Tuesday
2020-10-13,Macau Ferry Terminal,0,0,0,0,0,0,0,0,Tuesday
2020-10-13,Total,1113,90,33,1236,1066,54,31,1151,Tuesday
2020-10-14,Airport,564,4,30,598,656,21,31,708,Wednesday
2020-10-14,Express Rail Link West Kowloon,0,0,0,0,0,0,0,0,Wednesday
2020-10-14,Hung Hom,0,0,0,0,0,0,0,0,Wednesday
2020-10-14,Lo Wu,0,0,0,0,0,0,0,0,Wednesday
2020-10-14,Lok Ma Chau Spur Line,0,0,0,0,0,0,0,0,Wednesday
2020-10-14,Heung Yuen Wai,0,0,0,0,0,0,0,0,Wednesday
2020-10-14,Hong Kong-Zhuhai-Macao Bridge,104,10,5,119,134,8,2,144,Wednesday
2020-10-14,Lok Ma Chau,0,0,0,0,0,0,0,0,Wednesday
2020-10-14,Sha Tau Kok,0,0,0,0,0,0,0,0,Wednesday
2020-10-14,Shenzhen Bay,1046,138,2,1186,843,121,16,980,Wednesday
2020-10-14,China Ferry Terminal,0,0,0,0,0,0,0,0,Wednesday
2020-10-14,Harbour Control,0,0,0,0,0,0,0,0,Wednesday
2020-10-14,Kai Tak Cruise Terminal,0,0,0,0,0,0,0,0,Wednesday
2020-10-14,Macau Ferry Terminal,0,0,0,0,0,0,0,0,Wednesday
2020-10-14,Total,1714,152,37,1903,1633,150,49,1832,Wednesday
2020-10-15,Airport,984,3,53,1040,1121,14,64,1199,Thursday
2020-10-15,Express Rail Link West Kowloon,0,0,0,0,0,0,0,0,Thursday
2020-10-15,Hung Hom,0,0,0,0,0,0,0,0,Thursday
2020-10-15,Lo Wu,0,0,0,0,0,0,0,0,Thursday
2020-10-15,Lok Ma Chau Spur Line,0,0,0,0,0,0,0,0,Thursday
2020-10-15,Heung Yuen Wai,0,0,0,0,0,0,0,0,Thursday
2020-10-15,Hong Kong-Zhuhai-Macao Bridge,111,4,4,119,164,7,8,179,Thursday
2020-10-15,Lok Ma Chau,0,0,0,0,0,0,0,0,Thursday
2020-10-15,Man Kam To,0,0,0,0,0,0,0,0,Thursday
2020-10-15,Sha Tau Kok,0,0,0,0,0,0,0,0,Thursday
2020-10-15,Shenzhen Bay,1204,164,3,1371,807,110,5,922,Thursday
2020-10-15,China Ferry Terminal,0,0,0,0,0,0,0,0,Thursday
2020-10-15,Harbour Control,0,0,0,0,0,0,0,0,Thursday
2020-10-15,Kai Tak Cruise Terminal,0,0,0,0,0,0,0,0,Thursday
2020-10-15,Macau Ferry Terminal,0,0,0,0,0,0,0,0,Thursday
2020-10-15,Tuen Mun Ferry Terminal,0,0,0,0,0,0,0,0,Thursday
2020-10-15,Total,2299,171,60,2530,2092,131,77,2300,Thursday
2020-10-16,Airport,1153,5,49,1207,927,30,42,999,Friday
2020-10-16,Express Rail Link West Kowloon,0,0,0,0,0,0,0,0,Friday
2020-10-16,Hung Hom,0,0,0,0,0,0,0,0,Friday
2020-10-16,Lo Wu,0,0,0,0,0,0,0,0,Friday
2020-10-16,Lok Ma Chau Spur Line,0,0,0,0,0,0,0,0,Friday
2020-10-16,Heung Yuen Wai,0,0,0,0,0,0,0,0,Friday
2020-10-16,Lok Ma Chau,0,0,0,0,0,0,0,0,Friday
2020-10-16,Man Kam To,0,0,0,0,0,0,0,0,Friday
2020-10-16,Sha Tau Kok,0,0,0,0,0,0,0,0,Friday
2020-10-16,Shenzhen Bay,950,138,3,1091,1051,159,6,1216,Friday
2020-10-16,China Ferry Terminal,0,0,0,0,0,0,0,0,Friday
2020-10-16,Harbour Control,0,0,0,0,0,0,0,0,Friday
2020-10-16,Kai Tak Cruise Terminal,0,0,0,0,0,0,0,0,Friday
2020-10-16,Macau Ferry Terminal,0,0,0,0,0,0,0,0,Friday
2020-10-16,Tuen Mun Ferry Terminal,0,0,0,0,0,0,0,0,Friday
2020-10-16,Total,2170,150,55,2375,2155,196,56,2407,Friday
2020-10-17,Airport,824,8,9,841,996,27,48,1071,Saturday
2020-10-17,Express Rail Link West Kowloon,0,0,0,0,0,0,0,0,Saturday
2020-10-17,Hung Hom,0,0,0,0,0,0,0,0,Saturday
2020-10-17,Lo Wu,0,0,0,0,0,0,0,0,Saturday
2020-10-17,Lok Ma Chau Spur Line,0,0,0,0,0,0,0,0,Saturday
2020-10-17,Heung Yuen Wai,0,0,0,0,0,0,0,0,Saturday
2020-10-17,Hong Kong-Zhuhai-Macao Bridge,61,6,3,70,135,20,1,156,Saturday
2020-10-17,Lok Ma Chau,0,0,0,0,0,0,0,0,Saturday
2020-10-17,Man Kam To,0,0,0,0,0,0,0,0,Saturday
2020-10-17,Sha Tau Kok,0,0,0,0,0,0,0,0,Saturday
2020-10-17,Shenzhen Bay,985,173,5,1163,860,129,4,993,Saturday
2020-10-17,China Ferry Terminal,0,0,0,0,0,0,0,0,Saturday
2020-10-17,Harbour Control,0,0,0,0,0,0,0,0,Saturday
2020-10-17,Kai Tak Cruise Terminal,0,0,0,0,0,0,0,0,Saturday
2020-10-17,Macau Ferry Terminal,0,0,0,0,0,0,0,0,Saturday
2020-10-17,Tuen Mun Ferry Terminal,0,0,0,0,0,0,0,0,Saturday
2020-10-17,Total,1870,187,17,2074,1991,176,53,2220,Saturday
2020-10-18,Airport,1057,13,52,1122,822,26,38,886,Sunday
2020-10-18,Hung Hom,0,0,0,0,0,0,0,0,Sunday
2020-10-18,Lo Wu,0,0,0,0,0,0,0,0,Sunday
2020-10-18,Lok Ma Chau Spur Line,0,0,0,0,0,0,0,0,Sunday
2020-10-18,Heung Yuen Wai,0,0,0,0,0,0,0,0,Sunday
2020-10-18,Hong Kong-Zhuhai-Macao Bridge,70,8,5,83,82,5,6,93,Sunday
2020-10-18,Lok Ma Chau,0,0,0,0,0,0,0,0,Sunday
2020-10-18,Man Kam To,0,0,0,0,0,0,0,0,Sunday
2020-10-18,Sha Tau Kok,0,0,0,0,0,0,0,0,Sunday
2020-10-18,Shenzhen Bay,1363,193,1,1557,479,84,4,567,Sunday
2020-10-18,China Ferry Terminal,0,0,0,0,0,0,0,0,Sunday
2020-10-18,Harbour Control,0,0,0,0,0,0,0,0,Sunday
2020-10-18,Kai Tak Cruise Terminal,0,0,0,0,0,0,0,0,Sunday
2020-10-18,Macau Ferry Terminal,0,0,0,0,0,0,0,0,Sunday
2020-10-18,Tuen Mun Ferry Terminal,0,0,0,0,0,0,0,0,Sunday
2020-10-18,Total,2490,214,58,2762,1383,115,48,1546,Sunday
2020-10-19,Airport,462,2,31,495,613,8,28,649,Monday
2020-10-19,Express Rail Link West Kowloon,0,0,0,0,0,0,0,0,Monday
2020-10-19,Hung Hom,0,0,0,0,0,0,0,0,Monday
2020-10-19,Lo Wu,0,0,0,0,0,0,0,0,Monday
2020-10-19,Lok Ma Chau Spur Line,0,0,0,0,0,0,0,0,Monday
2020-10-19,Heung Yuen Wai,0,0,0,0,0,0,0,0,Monday
2020-10-19,Hong Kong-Zhuhai-Macao Bridge,84,3,6,93,115,4,2,121,Monday
2020-10-19,Lok Ma Chau,0,0,0,0,0,0,0,0,Monday
2020-10-19,Man Kam To,0,0,0,0,0,0,0,0,Monday
2020-10-19,Sha Tau Kok,0,0,0,0,0,0,0,0,Monday
2020-10-19,Shenzhen Bay,1048,121,2,1171,491,50,3,544,Monday
2020-10-19,China Ferry Terminal,0,0,0,0,0,0,0,0,Monday
2020-10-19,Harbour Control,0,0,0,0,0,0,0,0,Monday
2020-10-19,Kai Tak Cruise Terminal,0,0,0,0,0,0,0,0,Monday
2020-10-19,Macau Ferry Terminal,0,0,0,0,0,0,0,0,Monday
2020-10-19,Tuen Mun Ferry Terminal,0,0,0,0,0,0,0,0,Monday
2020-10-20,Airport,512,5,16,533,842,10,93,945,Tuesday
2020-10-20,Hung Hom,0,0,0,0,0,0,0,0,Tuesday
2020-10-20,Lo Wu,0,0,0,0,0,0,0,0,Tuesday
2020-10-20,Lok Ma Chau Spur Line,0,0,0,0,0,0,0,0,Tuesday
2020-10-20,Heung Yuen Wai,0,0,0,0,0,0,0,0,Tuesday
2020-10-20,Hong Kong-Zhuhai-Macao Bridge,59,3,70,132,120,5,1,126,Tuesday
2020-10-20,Lok Ma Chau,0,0,0,0,0,0,0,0,Tuesday
2020-10-20,Man Kam To,0,0,0,0,0,0,0,0,Tuesday
2020-10-20,Sha Tau Kok,0,0,0,0,0,0,0,0,Tuesday
2020-10-20,Shenzhen Bay,934,148,7,1089,731,83,4,818,Tuesday
2020-10-20,China Ferry Terminal,0,0,0,0,0,0,0,0,Tuesday
2020-10-20,Harbour Control,0,0,0,0,0,0,0,0,Tuesday
2020-10-20,Kai Tak Cruise Terminal,0,0,0,0,0,0,0,0,Tuesday
2020-10-20,Macau Ferry Terminal,0,0,0,0,0,0,0,0,Tuesday
2020-10-20,Tuen Mun Ferry Terminal,0,0,0,0,0,0,0,0,Tuesday
2020-10-20,Total,1505,156,93,1754,1693,98,98,1889,Tuesday
2020-10-21,Airport,770,2,31,803,715,10,78,803,Wednesday
2020-10-21,Hung Hom,0,0,0,0,0,0,0,0,Wednesday
2020-10-21,Lo Wu,0,0,0,0,0,0,0,0,Wednesday
2020-10-21,Lok Ma Chau Spur Line,0,0,0,0,0,0,0,0,Wednesday
2020-10-21,Heung Yuen Wai,0,0,0,0,0,0,0,0,Wednesday
2020-10-21,Hong Kong-Zhuhai-Macao Bridge,49,10,7,66,172,11,2,185,Wednesday
2020-10-21,Lok Ma Chau,0,0,0,0,0,0,0,0,Wednesday
2020-10-21,Man Kam To,0,0,0,0,0,0,0,0,Wednesday
2020-10-21,Sha Tau Kok,0,0,0,0,0,0,0,0,Wednesday
2020-10-21,Shenzhen Bay,845,148,6,999,938,123,9,1070,Wednesday
2020-10-21,China Ferry Terminal,0,0,0,0,0,0,0,0,Wednesday
2020-10-21,Harbour Control,0,0,0,0,0,0,0,0,Wednesday
2020-10-21,Kai Tak Cruise Terminal,0,0,0,0,0,0,0,0,Wednesday
2020-10-21,Macau Ferry Terminal,0,0,0,0,0,0,0,0,Wednesday
2020-10-21,Tuen Mun Ferry Terminal,0,0,0,0,0,0,0,0,Wednesday
2020-10-21,Total,1664,160,44,1868,1825,144,89,2058,Wednesday
2020-10-22,Airport,517,2,34,553,661,7,43,711,Thursday
2020-10-22,Express Rail Link West Kowloon,0,0,0,0,0,0,0,0,Thursday
2020-10-22,Hung Hom,0,0,0,0,0,0,0,0,Thursday
2020-10-22,Lo Wu,0,0,0,0,0,0,0,0,Thursday
2020-10-22,Lok Ma Chau Spur Line,0,0,0,0,0,0,0,0,Thursday
2020-10-22,Heung Yuen Wai,0,0,0,0,0,0,0,0,Thursday
2020-10-22,Hong Kong-Zhuhai-Macao Bridge,56,6,7,69,130,7,2,139,Thursday
2020-10-22,Lok Ma Chau,0,0,0,0,0,0,0,0,Thursday
2020-10-22,Man Kam To,0,0,0,0,0,0,0,0,Thursday
2020-10-22,Sha Tau Kok,0,0,0,0,0,0,0,0,Thursday
2020-10-22,Shenzhen Bay,810,156,2,968,725,102,4,831,Thursday
2020-10-22,China Ferry Terminal,0,0,0,0,0,0,0,0,Thursday
2020-10-22,Harbour Control,0,0,0,0,0,0,0,0,Thursday
2020-10-22,Kai Tak Cruise Terminal,0,0,0,0,0,0,0,0,Thursday
2020-10-22,Macau Ferry Terminal,0,0,0,0,0,0,0,0,Thursday
2020-10-22,Tuen Mun Ferry Terminal,0,0,0,0,0,0,0,0,Thursday
2020-10-22,Total,1383,164,43,1590,1516,116,49,1681,Thursday
2020-10-23,Airport,796,2,42,840,953,25,58,1036,Friday
2020-10-23,Hung Hom,0,0,0,0,0,0,0,0,Friday
2020-10-23,Lo Wu,0,0,0,0,0,0,0,0,Friday
2020-10-23,Lok Ma Chau Spur Line,0,0,0,0,0,0,0,0,Friday
2020-10-23,Heung Yuen Wai,0,0,0,0,0,0,0,0,Friday
2020-10-23,Hong Kong-Zhuhai-Macao Bridge,81,2,5,88,122,4,4,130,Friday
2020-10-23,Lok Ma Chau,0,0,0,0,0,0,0,0,Friday
2020-10-23,Man Kam To,0,0,0,0,0,0,0,0,Friday
2020-10-23,Sha Tau Kok,0,0,0,0,0,0,0,0,Friday
2020-10-23,Shenzhen Bay,747,156,3,906,674,80,3,757,Friday
2020-10-23,China Ferry Terminal,0,0,0,0,0,0,0,0,Friday
2020-10-23,Harbour Control,0,0,0,0,0,0,0,0,Friday
2020-10-23,Kai Tak Cruise Terminal,0,0,0,0,0,0,0,0,Friday
2020-10-23,Macau Ferry Terminal,0,0,0,0,0,0,0,0,Friday
2020-10-23,Tuen Mun Ferry Terminal,0,0,0,0,0,0,0,0,Friday
2020-10-23,Total,1624,160,50,1834,1749,109,65,1923,Friday
2020-10-24,Airport,986,7,27,1020,904,9,26,939,Saturday
2020-10-24,Express Rail Link West Kowloon,0,0,0,0,0,0,0,0,Saturday
2020-10-24,Hung Hom,0,0,0,0,0,0,0,0,Saturday
2020-10-24,Lo Wu,0,0,0,0,0,0,0,0,Saturday
2020-10-24,Lok Ma Chau Spur Line,0,0,0,0,0,0,0,0,Saturday
2020-10-24,Heung Yuen Wai,0,0,0,0,0,0,0,0,Saturday
2020-10-24,Hong Kong-Zhuhai-Macao Bridge,44,6,3,53,93,10,6,109,Saturday
2020-10-24,Lok Ma Chau,0,0,0,0,0,0,0,0,Saturday
2020-10-24,Man Kam To,0,0,0,0,0,0,0,0,Saturday
2020-10-24,Sha Tau Kok,0,0,0,0,0,0,0,0,Saturday
2020-10-24,Shenzhen Bay,714,134,5,853,602,75,4,681,Saturday
2020-10-24,China Ferry Terminal,0,0,0,0,0,0,0,0,Saturday
2020-10-24,Harbour Control,0,0,0,0,0,0,0,0,Saturday
2020-10-24,Macau Ferry Terminal,0,0,0,0,0,0,0,0,Saturday
2020-10-24,Tuen Mun Ferry Terminal,0,0,0,0,0,0,0,0,Saturday
2020-10-24,Total,1744,147,35,1926,1599,94,36,1729,Saturday
2020-10-25,Airport,911,14,38,963,953,31,48,1032,Sunday
2020-10-25,Express Rail Link West Kowloon,0,0,0,0,0,0,0,0,Sunday
2020-10-25,Hung Hom,0,0,0,0,0,0,0,0,Sunday
2020-10-25,Lo Wu,0,0,0,0,0,0,0,0,Sunday
2020-10-25,Lok Ma Chau Spur Line,0,0,0,0,0,0,0,0,Sunday
2020-10-25,Heung Yuen Wai,0,0,0,0,0,0,0,0,Sunday
2020-10-25,Hong Kong-Zhuhai-Macao Bridge,56,3,9,68,78,3,6,87,Sunday
2020-10-25,Man Kam To,0,0,0,0,0,0,0,0,Sunday
2020-10-25,Sha Tau Kok,0,0,0,0,0,0,0,0,Sunday
2020-10-25,Shenzhen Bay,942,228,6,1176,423,46,3,472,Sunday
2020-10-25,China Ferry Terminal,0,0,0,0,0,0,0,0,Sunday
2020-10-25,Harbour Control,0,0,0,0,0,0,0,0,Sunday
2020-10-25,Kai Tak Cruise Terminal,0,0,0,0,0,0,0,0,Sunday
2020-10-25,Macau Ferry Terminal,0,0,0,0,0,0,0,0,Sunday
2020-10-25,Total,1909,245,53,2207,1454,80,57,1591,Sunday
2020-10-26,Airport,575,3,21,599,542,7,26,575,Monday
2020-10-26,Express Rail Link West Kowloon,0,0,0,0,0,0,0,0,Monday
2020-10-26,Hung Hom,0,0,0,0,0,0,0,0,Monday
2020-10-26,Lo Wu,0,0,0,0,0,0,0,0,Monday
2020-10-26,Lok Ma Chau Spur Line,0,0,0,0,0,0,0,0,Monday
2020-10-26,Heung Yuen Wai,0,0,0,0,0,0,0,0,Monday
2020-10-26,Hong Kong-Zhuhai-Macao Bridge,48,3,8,59,41,7,1,49,Monday
2020-10-26,Lok Ma Chau,0,0,0,0,0,0,0,0,Monday
2020-10-26,Man Kam To,0,0,0,0,0,0,0,0,Monday
2020-10-26,Sha Tau Kok,0,0,0,0,0,0,0,0,Monday
2020-10-26,Shenzhen Bay,966,137,1,1104,279,21,5,305,Monday
2020-10-26,China Ferry Terminal,0,0,0,0,0,0,0,0,Monday
2020-10-26,Harbour Control,0,0,0,0,0,0,0,0,Monday
2020-10-26,Kai Tak Cruise Terminal,0,0,0,0,0,0,0,0,Monday
2020-10-26,Macau Ferry Terminal,0,0,0,0,0,0,0,0,Monday
2020-10-26,Tuen Mun Ferry Terminal,0,0,0,0,0,0,0,0,Monday
2020-10-26,Total,1589,143,30,1762,862,35,32,929,Monday
2020-10-27,Airport,534,2,17,553,546,4,28,578,Tuesday
2020-10-27,Express Rail Link West Kowloon,0,0,0,0,0,0,0,0,Tuesday
2020-10-27,Hung Hom,0,0,0,0,0,0,0,0,Tuesday
2020-10-27,Lo Wu,0,0,0,0,0,0,0,0,Tuesday
2020-10-27,Lok Ma Chau Spur Line,0,0,0,0,0,0,0,0,Tuesday
2020-10-27,Heung Yuen Wai,0,0,0,0,0,0,0,0,Tuesday
2020-10-27,Lok Ma Chau,0,0,0,0,0,0,0,0,Tuesday
2020-10-27,Man Kam To,0,0,0,0,0,0,0,0,Tuesday
2020-10-27,Sha Tau Kok,0,0,0,0,0,0,0,0,Tuesday
2020-10-27,Shenzhen Bay,868,128,3,999,390,30,1,421,Tuesday
2020-10-27,China Ferry Terminal,0,0,0,0,0,0,0,0,Tuesday
2020-10-27,Harbour Control,0,0,0,0,0,0,0,0,Tuesday
2020-10-27,Kai Tak Cruise Terminal,0,0,0,0,0,0,0,0,Tuesday
2020-10-27,Macau Ferry Terminal,0,0,0,0,0,0,0,0,Tuesday
2020-10-27,Tuen Mun Ferry Terminal,0,0,0,0,0,0,0,0,Tuesday
2020-10-27,Total,1464,132,23,1619,991,35,30,1056,Tuesday
2020-10-28,Airport,352,2,23,377,479,11,28,518,Wednesday
2020-10-28,Express Rail Link West Kowloon,0,0,0,0,0,0,0,0,Wednesday
2020-10-28,Hung Hom,0,0,0,0,0,0,0,0,Wednesday
2020-10-28,Lo Wu,0,0,0,0,0,0,0,0,Wednesday
2020-10-28,Lok Ma Chau Spur Line,0,0,0,0,0,0,0,0,Wednesday
2020-10-28,Heung Yuen Wai,0,0,0,0,0,0,0,0,Wednesday
2020-10-28,Hong Kong-Zhuhai-Macao Bridge,64,2,6,72,141,2,4,147,Wednesday
2020-10-28,Lok Ma Chau,0,0,0,0,0,0,0,0,Wednesday
2020-10-28,Man Kam To,0,0,0,0,0,0,0,0,Wednesday
2020-10-28,Sha Tau Kok,0,0,0,0,0,0,0,0,Wednesday
2020-10-28,Shenzhen Bay,557,108,4,669,737,79,4,820,Wednesday
2020-10-28,China Ferry Terminal,0,0,0,0,0,0,0,0,Wednesday
2020-10-28,Harbour Control,0,0,0,0,0,0,0,0,Wednesday
2020-10-28,Kai Tak Cruise Terminal,0,0,0,0,0,0,0,0,Wednesday
2020-10-28,Macau Ferry Terminal,0,0,0,0,0,0,0,0,Wednesday
2020-10-28,Tuen Mun Ferry Terminal,0,0,0,0,0,0,0,0,Wednesday
2020-10-28,Total,973,112,33,1118,1357,92,36,1485,Wednesday
2020-10-29,Airport,534,6,28,568,731,8,45,784,Thursday
2020-10-29,Hung Hom,0,0,0,0,0,0,0,0,Thursday
2020-10-29,Lo Wu,0,0,0,0,0,0,0,0,Thursday
2020-10-29,Lok Ma Chau Spur Line,0,0,0,0,0,0,0,0,Thursday
2020-10-29,Heung Yuen Wai,0,0,0,0,0,0,0,0,Thursday
2020-10-29,Hong Kong-Zhuhai-Macao Bridge,62,3,5,70,144,11,4,159,Thursday
2020-10-29,Lok Ma Chau,0,0,0,0,0,0,0,0,Thursday
2020-10-29,Man Kam To,0,0,0,0,0,0,0,0,Thursday
2020-10-29,Sha Tau Kok,0,0,0,0,0,0,0,0,Thursday
2020-10-29,Shenzhen Bay,478,81,1,560,814,90,2,906,Thursday
2020-10-29,China Ferry Terminal,0,0,0,0,0,0,0,0,Thursday
2020-10-29,Harbour Control,0,0,0,0,0,0,0,0,Thursday
2020-10-29,Kai Tak Cruise Terminal,0,0,0,0,0,0,0,0,Thursday
2020-10-29,Macau Ferry Terminal,0,0,0,0,0,0,0,0,Thursday
2020-10-29,Tuen Mun Ferry Terminal,0,0,0,0,0,0,0,0,Thursday
2020-10-29,Total,1074,90,34,1198,1689,109,51,1849,Thursday
2020-10-30,Airport,890,4,37,931,986,26,57,1069,Friday
2020-10-30,Express Rail Link West Kowloon,0,0,0,0,0,0,0,0,Friday
2020-10-30,Hung Hom,0,0,0,0,0,0,0,0,Friday
2020-10-30,Lo Wu,0,0,0,0,0,0,0,0,Friday
2020-10-30,Lok Ma Chau Spur Line,0,0,0,0,0,0,0,0,Friday
2020-10-30,Heung Yuen Wai,0,0,0,0,0,0,0,0,Friday
2020-10-30,Hong Kong-Zhuhai-Macao Bridge,55,3,6,64,137,9,6,152,Friday
2020-10-30,Lok Ma Chau,0,0,0,0,0,0,0,0,Friday
2020-10-30,Man Kam To,0,0,0,0,0,0,0,0,Friday
2020-10-30,Sha Tau Kok,0,0,0,0,0,0,0,0,Friday
2020-10-30,Shenzhen Bay,544,102,2,648,698,72,6,776,Friday
2020-10-30,China Ferry Terminal,0,0,0,0,0,0,0,0,Friday
2020-10-30,Harbour Control,0,0,0,0,0,0,0,0,Friday
2020-10-30,Macau Ferry Terminal,0,0,0,0,0,0,0,0,Friday
2020-10-30,Total,1489,109,45,1643,1821,107,69,1997,Friday
2020-10-31,Airport,776,5,19,800,1262,19,36,1317,Saturday
2020-10-31,Express Rail Link West Kowloon,0,0,0,0,0,0,0,0,Saturday
2020-10-31,Hung Hom,0,0,0,0,0,0,0,0,Saturday
2020-10-31,Lo Wu,0,0,0,0,0,0,0,0,Saturday
2020-10-31,Lok Ma Chau Spur Line,0,0,0,0,0,0,0,0,Saturday
2020-10-31,Heung Yuen Wai,0,0,0,0,0,0,0,0,Saturday
2020-10-31,Lok Ma Chau,0,0,0,0,0,0,0,0,Saturday
2020-10-31,Man Kam To,0,0,0,0,0,0,0,0,Saturday
2020-10-31,Sha Tau Kok,0,0,0,0,0,0,0,0,Saturday
2020-10-31,Shenzhen Bay,516,131,4,651,614,72,11,697,Saturday
2020-10-31,China Ferry Terminal,0,0,0,0,0,0,0,0,Saturday
2020-10-31,Harbour Control,0,0,0,0,0,0,0,0,Saturday
2020-10-31,Kai Tak Cruise Terminal,0,0,0,0,0,0,0,0,Saturday
2020-10-31,Macau Ferry Terminal,0,0,0,0,0,0,0,0,Saturday
2020-10-31,Tuen Mun Ferry Terminal,0,0,0,0,0,0,0,0,Saturday
2020-10-31,Total,1340,139,27,1506,1999,99,47,2145,Saturday
2020-11-01,Airport,1021,1,47,1069,935,8,39,982,Sunday
2020-11-01,Express Rail Link West Kowloon,0,0,0,0,0,0,0,0,Sunday
2020-11-01,Hung Hom,0,0,0,0,0,0,0,0,Sunday
2020-11-01,Lo Wu,0,0,0,0,0,0,0,0,Sunday
2020-11-01,Lok Ma Chau Spur Line,0,0,0,0,0,0,0,0,Sunday
2020-11-01,Heung Yuen Wai,0,0,0,0,0,0,0,0,Sunday
2020-11-01,Hong Kong-Zhuhai-Macao Bridge,61,8,4,73,122,5,4,131,Sunday
2020-11-01,Lok Ma Chau,0,0,0,0,0,0,0,0,Sunday
2020-11-01,Man Kam To,0,0,0,0,0,0,0,0,Sunday
2020-11-01,Sha Tau Kok,0,0,0,0,0,0,0,0,Sunday
2020-11-01,Shenzhen Bay,1075,173,8,1256,444,69,3,516,Sunday
2020-11-01,China Ferry Terminal,0,0,0,0,0,0,0,0,Sunday
2020-11-01,Harbour Control,0,0,0,0,0,0,0,0,Sunday
2020-11-01,Kai Tak Cruise Terminal,0,0,0,0,0,0,0,0,Sunday
2020-11-01,Macau Ferry Terminal,0,0,0,0,0,0,0,0,Sunday
2020-11-01,Tuen Mun Ferry Terminal,0,0,0,0,0,0,0,0,Sunday
2020-11-01,Total,2157,182,59,2398,1501,82,46,1629,Sunday
2020-11-02,Airport,503,0,25,528,472,9,17,498,Monday
2020-11-02,Hung Hom,0,0,0,0,0,0,0,0,Monday
2020-11-02,Lo Wu,0,0,0,0,0,0,0,0,Monday
2020-11-02,Lok Ma Chau Spur Line,0,0,0,0,0,0,0,0,Monday
2020-11-02,Heung Yuen Wai,0,0,0,0,0,0,0,0,Monday
2020-11-02,Hong Kong-Zhuhai-Macao Bridge,70,6,0,76,81,3,0,84,Monday
2020-11-02,Lok Ma Chau,0,0,0,0,0,0,0,0,Monday
2020-11-02,Man Kam To,0,0,0,0,0,0,0,0,Monday
2020-11-02,Sha Tau Kok,0,0,0,0,0,0,0,0,Monday
2020-11-02,Shenzhen Bay,838,122,1,961,357,44,2,403,Monday
2020-11-02,China Ferry Terminal,0,0,0,0,0,0,0,0,Monday
2020-11-02,Harbour Control,0,0,0,0,0,0,0,0,Monday
2020-11-02,Kai Tak Cruise Terminal,0,0,0,0,0,0,0,0,Monday
2020-11-02,Macau Ferry Terminal,0,0,0,0,0,0,0,0,Monday
2020-11-02,Tuen Mun Ferry Terminal,0,0,0,0,0,0,0,0,Monday
2020-11-02,Total,1411,128,26,1565,910,56,19,985,Monday
2020-11-03,Airport,717,14,32,763,1139,20,96,1255,Tuesday
2020-11-03,Express Rail Link West Kowloon,0,0,0,0,0,0,0,0,Tuesday
2020-11-03,Hung Hom,0,0,0,0,0,0,0,0,Tuesday
2020-11-03,Lo Wu,0,0,0,0,0,0,0,0,Tuesday
2020-11-03,Lok Ma Chau Spur Line,0,0,0,0,0,0,0,0,Tuesday
2020-11-03,Heung Yuen Wai,0,0,0,0,0,0,0,0,Tuesday
2020-11-03,Hong Kong-Zhuhai-Macao Bridge,59,4,6,69,162,8,3,173,Tuesday
2020-11-03,Lok Ma Chau,0,0,0,0,0,0,0,0,Tuesday
2020-11-03,Man Kam To,0,0,0,0,0,0,0,0,Tuesday
2020-11-03,Sha Tau Kok,0,0,0,0,0,0,0,0,Tuesday
2020-11-03,Shenzhen Bay,723,137,2,862,776,85,7,868,Tuesday
2020-11-03,China Ferry Terminal,0,0,0,0,0,0,0,0,Tuesday
2020-11-03,Harbour Control,0,0,0,0,0,0,0,0,Tuesday
2020-11-03,Kai Tak Cruise Terminal,0,0,0,0,0,0,0,0,Tuesday
2020-11-03,Macau Ferry Terminal,0,0,0,0,0,0,0,0,Tuesday
2020-11-03,Tuen Mun Ferry Terminal,0,0,0,0,0,0,0,0,Tuesday
2020-11-03,Total,1499,155,40,1694,2077,113,106,2296,Tuesday
2020-11-04,Airport,829,7,33,869,819,6,124,949,Wednesday
2020-11-04,Hung Hom,0,0,0,0,0,0,0,0,Wednesday
2020-11-04,Lo Wu,0,0,0,0,0,0,0,0,Wednesday
2020-11-04,Lok Ma Chau Spur Line,0,0,0,0,0,0,0,0,Wednesday
2020-11-04,Heung Yuen Wai,0,0,0,0,0,0,0,0,Wednesday
2020-11-04,Hong Kong-Zhuhai-Macao Bridge,61,2,30,93,158,14,5,177,Wednesday
2020-11-04,Lok Ma Chau,0,0,0,0,0,0,0,0,Wednesday
2020-11-04,Man Kam To,0,0,0,0,0,0,0,0,Wednesday
2020-11-04,Sha Tau Kok,0,0,0,0,0,0,0,0,Wednesday
2020-11-04,Shenzhen Bay,664,111,3,778,742,97,8,847,Wednesday
2020-11-04,China Ferry Terminal,0,0,0,0,0,0,0,0,Wednesday
2020-11-04,Harbour Control,0,0,0,0,0,0,0,0,Wednesday
2020-11-04,Kai Tak Cruise Terminal,0,0,0,0,0,0,0,0,Wednesday
2020-11-04,Macau Ferry Terminal,0,0,0,0,0,0,0,0,Wednesday
2020-11-04,Tuen Mun Ferry Terminal,0,0,0,0,0,0,0,0,Wednesday
2020-11-04,Total,1554,120,66,1740,1719,117,137,1973,Wednesday
2020-11-05,Airport,1007,1,30,1038,560,3,84,647,Thursday
2020-11-05,Express Rail Link West Kowloon,0,0,0,0,0,0,0,0,Thursday
2020-11-05,Hung Hom,0,0,0,0,0,0,0,0,Thursday
2020-11-05,Lo Wu,0,0,0,0,0,0,0,0,Thursday
2020-11-05,Lok Ma Chau Spur Line,0,0,0,0,0,0,0,0,Thursday
2020-11-05,Heung Yuen Wai,0,0,0,0,0,0,0,0,Thursday
2020-11-05,Lok Ma Chau,0,0,0,0,0,0,0,0,Thursday
2020-11-05,Man Kam To,0,0,0,0,0,0,0,0,Thursday
2020-11-05,Sha Tau Kok,0,0,0,0,0,0,0,0,Thursday
2020-11-05,Shenzhen Bay,691,92,1,784,631,109,5,745,Thursday
2020-11-05,China Ferry Terminal,0,0,0,0,0,0,0,0,Thursday
2020-11-05,Harbour Control,0,0,0,0,0,0,0,0,Thursday
2020-11-05,Kai Tak Cruise Terminal,0,0,0,0,0,0,0,0,Thursday
2020-11-05,Macau Ferry Terminal,0,0,0,0,0,0,0,0,Thursday
2020-11-05,Tuen Mun Ferry Terminal,0,0,0,0,0,0,0,0,Thursday
2020-11-05,Total,1767,98,92,1957,1300,122,94,1516,Thursday
2020-11-06,Airport,931,5,40,976,832,10,55,897,Friday
2020-11-06,Hung Hom,0,0,0,0,0,0,0,0,Friday
2020-11-06,Lo Wu,0,0,0,0,0,0,0,0,Friday
2020-11-06,Lok Ma Chau Spur Line,0,0,0,0,0,0,0,0,Friday
2020-11-06,Heung Yuen Wai,0,0,0,0,0,0,0,0,Friday
2020-11-06,Hong Kong-Zhuhai-Macao Bridge,58,1,7,66,59,10,6,75,Friday
2020-11-06,Lok Ma Chau,0,0,0,0,0,0,0,0,Friday
2020-11-06,Man Kam To,0,0,0,0,0,0,0,0,Friday
2020-11-06,Sha Tau Kok,0,0,0,0,0,0,0,0,Friday
2020-11-06,Shenzhen Bay,669,96,2,767,603,86,7,696,Friday
2020-11-06,China Ferry Terminal,0,0,0,0,0,0,0,0,Friday
2020-11-06,Harbour Control,0,0,0,0,0,0,0,0,Friday
2020-11-06,Kai Tak Cruise Terminal,0,0,0,0,0,0,0,0,Friday
2020-11-06,Macau Ferry Terminal,0,0,0,0,0,0,0,0,Friday
2020-11-06,Tuen Mun Ferry Terminal,0,0,0,0,0,0,0,0,Friday
2020-11-06,Total,1658,102,49,1809,1494,106,68,1668,Friday
2020-11-07,Airport,876,8,26,910,738,9,28,775,Saturday
2020-11-07,Express Rail Link West Kowloon,0,0,0,0,0,0,0,0,Saturday
2020-11-07,Hung Hom,0,0,0,0,0,0,0,0,Saturday
2020-11-07,Lo Wu,0,0,0,0,0,0,0,0,Saturday
2020-11-07,Lok Ma Chau Spur Line,0,0,0,0,0,0,0,0,Saturday
2020-11-07,Heung Yuen Wai,0,0,0,0,0,0,0,0,Saturday
2020-11-07,Hong Kong-Zhuhai-Macao Bridge,36,3,0,39,92,12,4,108,Saturday
2020-11-07,Lok Ma Chau,0,0,0,0,0,0,0,0,Saturday
2020-11-07,Man Kam To,0,0,0,0,0,0,0,0,Saturday
2020-11-07,Sha Tau Kok,0,0,0,0,0,0,0,0,Saturday
2020-11-07,Shenzhen Bay,702,117,2,821,467,69,3,539,Saturday
2020-11-07,China Ferry Terminal,0,0,0,0,0,0,0,0,Saturday
2020-11-07,Harbour Control,0,0,0,0,0,0,0,0,Saturday
2020-11-07,Macau Ferry Terminal,0,0,0,0,0,0,0,0,Saturday
2020-11-07,Tuen Mun Ferry Terminal,0,0,0,0,0,0,0,0,Saturday
2020-11-07,Total,1614,128,28,1770,1297,90,35,1422,Saturday
2020-11-08,Airport,1089,4,63,1156,816,22,60,898,Sunday
2020-11-08,Express Rail Link West Kowloon,0,0,0,0,0,0,0,0,Sunday
2020-11-08,Hung Hom,0,0,0,0,0,0,0,0,Sunday
2020-11-08,Lo Wu,0,0,0,0,0,0,0,0,Sunday
2020-11-08,Lok Ma Chau Spur Line,0,0,0,0,0,0,0,0,Sunday
2020-11-08,Heung Yuen Wai,0,0,0,0,0,0,0,0,Sunday
2020-11-08,Hong Kong-Zhuhai-Macao Bridge,64,4,3,71,67,32,1,100,Sunday
2020-11-08,Lok Ma Chau,0,0,0,0,0,0,0,0,Sunday
2020-11-08,Man Kam To,0,0,0,0,0,0,0,0,Sunday
2020-11-08,Sha Tau Kok,0,0,0,0,0,0,0,0,Sunday
2020-11-08,Shenzhen Bay,906,130,2,1038,339,78,3,420,Sunday
2020-11-08,China Ferry Terminal,0,0,0,0,0,0,0,0,Sunday
2020-11-08,Harbour Control,0,0,0,0,0,0,0,0,Sunday
2020-11-08,Kai Tak Cruise Terminal,0,0,0,0,0,0,0,0,Sunday
2020-11-08,Macau Ferry Terminal,0,0,0,0,0,0,0,0,Sunday
2020-11-08,Tuen Mun Ferry Terminal,0,0,0,0,0,0,0,0,Sunday
2020-11-08,Total,2059,138,68,2265,1222,132,64,1418,Sunday
2020-11-09,Airport,621,0,19,640,379,13,20,412,Monday
2020-11-09,Hung Hom,0,0,0,0,0,0,0,0,Monday
2020-11-09,Lo Wu,0,0,0,0,0,0,0,0,Monday
2020-11-09,Lok Ma Chau Spur Line,0,0,0,0,0,0,0,0,Monday
2020-11-09,Heung Yuen Wai,0,0,0,0,0,0,0,0,Monday
2020-11-09,Hong Kong-Zhuhai-Macao Bridge,62,5,5,72,62,3,5,70,Monday
2020-11-09,Lok Ma Chau,0,0,0,0,0,0,0,0,Monday
2020-11-09,Man Kam To,0,0,0,0,0,0,0,0,Monday
2020-11-09,Sha Tau Kok,0,0,0,0,0,0,0,0,Monday
2020-11-09,Shenzhen Bay,773,85,1,859,352,53,3,408,Monday
2020-11-09,China Ferry Terminal,0,0,0,0,0,0,0,0,Monday
2020-11-09,Harbour Control,0,0,0,0,0,0,0,0,Monday
2020-11-09,Kai Tak Cruise Terminal,0,0,0,0,0,0,0,0,Monday
2020-11-09,Macau Ferry Terminal,0,0,0,0,0,0,0,0,Monday
2020-11-09,Tuen Mun Ferry Terminal,0,0,0,0,0,0,0,0,Monday
2020-11-09,Total,1456,90,25,1571,793,69,28,890,Monday
2020-11-10,Airport,952,6,36,994,964,20,36,1020,Tuesday
2020-11-10,Express Rail Link West Kowloon,0,0,0,0,0,0,0,0,Tuesday
2020-11-10,Hung Hom,0,0,0,0,0,0,0,0,Tuesday
2020-11-10,Lo Wu,0,0,0,0,0,0,0,0,Tuesday
2020-11-10,Lok Ma Chau Spur Line,0,0,0,0,0,0,0,0,Tuesday
2020-11-10,Heung Yuen Wai,0,0,0,0,0,0,0,0,Tuesday
2020-11-10,Hong Kong-Zhuhai-Macao Bridge,83,4,6,93,114,6,3,123,Tuesday
2020-11-10,Lok Ma Chau,0,0,0,0,0,0,0,0,Tuesday
2020-11-10,Man Kam To,0,0,0,0,0,0,0,0,Tuesday
2020-11-10,Sha Tau Kok,0,0,0,0,0,0,0,0,Tuesday
2020-11-10,Shenzhen Bay,736,93,2,831,739,82,10,831,Tuesday
2020-11-10,China Ferry Terminal,0,0,0,0,0,0,0,0,Tuesday
2020-11-10,Harbour Control,0,0,0,0,0,0,0,0,Tuesday
2020-11-10,Kai Tak Cruise Terminal,0,0,0,0,0,0,0,0,Tuesday
2020-12-19,Lo Wu,0,0,0,0,0,0,0,0,Saturday
2020-11-10,Tuen Mun Ferry Terminal,0,0,0,0,0,0,0,0,Tuesday
2020-11-10,Total,1771,103,44,1918,1817,108,49,1974,Tuesday
2020-11-11,Airport,1321,2,52,1375,508,8,42,558,Wednesday
2020-11-11,Express Rail Link West Kowloon,0,0,0,0,0,0,0,0,Wednesday
2020-11-11,Hung Hom,0,0,0,0,0,0,0,0,Wednesday
2020-11-11,Lo Wu,0,0,0,0,0,0,0,0,Wednesday
2020-11-11,Lok Ma Chau Spur Line,0,0,0,0,0,0,0,0,Wednesday
2020-11-11,Heung Yuen Wai,0,0,0,0,0,0,0,0,Wednesday
2020-11-11,Lok Ma Chau,0,0,0,0,0,0,0,0,Wednesday
2020-11-11,Man Kam To,0,0,0,0,0,0,0,0,Wednesday
2020-11-11,Sha Tau Kok,0,0,0,0,0,0,0,0,Wednesday
2020-11-11,Shenzhen Bay,658,88,3,749,676,84,3,763,Wednesday
2020-11-11,China Ferry Terminal,0,0,0,0,0,0,0,0,Wednesday
2020-11-11,Harbour Control,0,0,0,0,0,0,0,0,Wednesday
2020-11-11,Kai Tak Cruise Terminal,0,0,0,0,0,0,0,0,Wednesday
2020-11-11,Macau Ferry Terminal,0,0,0,0,0,0,0,0,Wednesday
2020-11-11,Tuen Mun Ferry Terminal,0,0,0,0,0,0,0,0,Wednesday
2020-11-11,Total,2023,94,59,2176,1278,99,46,1423,Wednesday
2020-11-12,Airport,1646,4,61,1711,589,7,74,670,Thursday
2020-11-12,Express Rail Link West Kowloon,0,0,0,0,0,0,0,0,Thursday
2020-11-12,Hung Hom,0,0,0,0,0,0,0,0,Thursday
2020-11-12,Lo Wu,0,0,0,0,0,0,0,0,Thursday
2020-11-12,Lok Ma Chau Spur Line,0,0,0,0,0,0,0,0,Thursday
2020-11-12,Heung Yuen Wai,0,0,0,0,0,0,0,0,Thursday
2020-11-12,Hong Kong-Zhuhai-Macao Bridge,54,1,22,77,101,7,3,111,Thursday
2020-11-12,Lok Ma Chau,0,0,0,0,0,0,0,0,Thursday
2020-11-12,Man Kam To,0,0,0,0,0,0,0,0,Thursday
2020-11-12,Sha Tau Kok,0,0,0,0,0,0,0,0,Thursday
2020-11-12,Shenzhen Bay,616,102,4,722,587,67,4,658,Thursday
2020-11-12,China Ferry Terminal,0,0,0,0,0,0,0,0,Thursday
2020-11-12,Harbour Control,0,0,0,0,0,0,0,0,Thursday
2020-11-12,Kai Tak Cruise Terminal,0,0,0,0,0,0,0,0,Thursday
2020-11-12,Macau Ferry Terminal,0,0,0,0,0,0,0,0,Thursday
2020-11-12,Tuen Mun Ferry Terminal,0,0,0,0,0,0,0,0,Thursday
2020-11-12,Total,2316,107,87,2510,1277,81,81,1439,Thursday
2020-11-13,Airport,806,1,26,833,706,8,49,763,Friday
2020-11-13,Hung Hom,0,0,0,0,0,0,0,0,Friday
2020-11-13,Lo Wu,0,0,0,0,0,0,0,0,Friday
2020-11-13,Lok Ma Chau Spur Line,0,0,0,0,0,0,0,0,Friday
2020-11-13,Heung Yuen Wai,0,0,0,0,0,0,0,0,Friday
2020-11-13,Hong Kong-Zhuhai-Macao Bridge,46,7,3,56,109,10,6,125,Friday
2020-11-13,Lok Ma Chau,0,0,0,0,0,0,0,0,Friday
2020-11-13,Man Kam To,0,0,0,0,0,0,0,0,Friday
2020-11-13,Sha Tau Kok,0,0,0,0,0,0,0,0,Friday
2020-11-13,Shenzhen Bay,604,99,2,705,569,68,7,644,Friday
2020-11-13,China Ferry Terminal,0,0,0,0,0,0,0,0,Friday
2020-11-13,Harbour Control,0,0,0,0,0,0,0,0,Friday
2020-11-13,Kai Tak Cruise Terminal,0,0,0,0,0,0,0,0,Friday
2020-11-13,Macau Ferry Terminal,0,0,0,0,0,0,0,0,Friday
2020-11-13,Tuen Mun Ferry Terminal,0,0,0,0,0,0,0,0,Friday
2020-11-13,Total,1456,107,31,1594,1384,86,62,1532,Friday
2020-11-14,Airport,714,3,19,736,885,15,34,934,Saturday
2020-11-14,Express Rail Link West Kowloon,0,0,0,0,0,0,0,0,Saturday
2020-11-14,Hung Hom,0,0,0,0,0,0,0,0,Saturday
2020-11-14,Lo Wu,0,0,0,0,0,0,0,0,Saturday
2020-11-14,Lok Ma Chau Spur Line,0,0,0,0,0,0,0,0,Saturday
2020-11-14,Heung Yuen Wai,0,0,0,0,0,0,0,0,Saturday
2020-11-14,Hong Kong-Zhuhai-Macao Bridge,47,4,1,52,107,6,2,115,Saturday
2020-11-14,Lok Ma Chau,0,0,0,0,0,0,0,0,Saturday
2020-11-14,Man Kam To,0,0,0,0,0,0,0,0,Saturday
2020-11-14,Sha Tau Kok,0,0,0,0,0,0,0,0,Saturday
2020-11-14,Shenzhen Bay,525,112,6,643,540,64,2,606,Saturday
2020-11-14,China Ferry Terminal,0,0,0,0,0,0,0,0,Saturday
2020-11-14,Harbour Control,0,0,0,0,0,0,0,0,Saturday
2020-11-14,Kai Tak Cruise Terminal,0,0,0,0,0,0,0,0,Saturday
2020-11-14,Tuen Mun Ferry Terminal,0,0,0,0,0,0,0,0,Saturday
2020-11-14,Total,1286,119,26,1431,1532,85,38,1655,Saturday
2020-11-15,Airport,969,6,38,1013,1174,30,55,1259,Sunday
2020-11-15,Express Rail Link West Kowloon,0,0,0,0,0,0,0,0,Sunday
2020-11-15,Hung Hom,0,0,0,0,0,0,0,0,Sunday
2020-11-15,Lo Wu,0,0,0,0,0,0,0,0,Sunday
2020-11-15,Lok Ma Chau Spur Line,0,0,0,0,0,0,0,0,Sunday
2020-11-15,Heung Yuen Wai,0,0,0,0,0,0,0,0,Sunday
2020-11-15,Hong Kong-Zhuhai-Macao Bridge,34,4,6,44,62,8,0,70,Sunday
2020-11-15,Lok Ma Chau,0,0,0,0,0,0,0,0,Sunday
2020-11-15,Man Kam To,0,0,0,0,0,0,0,0,Sunday
2020-11-15,Sha Tau Kok,0,0,0,0,0,0,0,0,Sunday
2020-11-15,Shenzhen Bay,742,114,2,858,358,50,1,409,Sunday
2020-11-15,China Ferry Terminal,0,0,0,0,0,0,0,0,Sunday
2020-11-15,Harbour Control,0,0,0,0,0,0,0,0,Sunday
2020-11-15,Kai Tak Cruise Terminal,0,0,0,0,0,0,0,0,Sunday
2020-11-15,Macau Ferry Terminal,0,0,0,0,0,0,0,0,Sunday
2020-11-15,Tuen Mun Ferry Terminal,0,0,0,0,0,0,0,0,Sunday
2020-11-15,Total,1745,124,46,1915,1594,88,56,1738,Sunday
2020-11-16,Airport,366,14,17,397,424,13,14,451,Monday
2020-11-16,Hung Hom,0,0,0,0,0,0,0,0,Monday
2020-11-16,Lo Wu,0,0,0,0,0,0,0,0,Monday
2020-11-16,Lok Ma Chau Spur Line,0,0,0,0,0,0,0,0,Monday
2020-11-16,Lok Ma Chau,0,0,0,0,0,0,0,0,Monday
2020-11-16,Man Kam To,0,0,0,0,0,0,0,0,Monday
2020-11-16,Sha Tau Kok,0,0,0,0,0,0,0,0,Monday
2020-11-16,Shenzhen Bay,550,91,3,644,1046,109,0,1155,Monday
2020-11-16,China Ferry Terminal,0,0,0,0,0,0,0,0,Monday
2020-11-16,Harbour Control,0,0,0,0,0,0,0,0,Monday
2020-11-16,Kai Tak Cruise Terminal,0,0,0,0,0,0,0,0,Monday
2020-11-16,Macau Ferry Terminal,0,0,0,0,0,0,0,0,Monday
2020-11-16,Tuen Mun Ferry Terminal,0,0,0,0,0,0,0,0,Monday
2020-11-16,Total,954,110,22,1086,1666,135,18,1819,Monday
2020-11-17,Airport,385,4,26,415,611,14,32,657,Tuesday
2020-11-17,Express Rail Link West Kowloon,0,0,0,0,0,0,0,0,Tuesday
2020-11-17,Hung Hom,0,0,0,0,0,0,0,0,Tuesday
2020-11-17,Lo Wu,0,0,0,0,0,0,0,0,Tuesday
2020-11-17,Lok Ma Chau Spur Line,0,0,0,0,0,0,0,0,Tuesday
2020-11-17,Heung Yuen Wai,0,0,0,0,0,0,0,0,Tuesday
2020-11-17,Hong Kong-Zhuhai-Macao Bridge,21,6,6,33,213,12,5,230,Tuesday
2020-11-17,Lok Ma Chau,0,0,0,0,0,0,0,0,Tuesday
2020-11-17,Man Kam To,0,0,0,0,0,0,0,0,Tuesday
2020-11-17,Sha Tau Kok,0,0,0,0,0,0,0,0,Tuesday
2020-11-17,Shenzhen Bay,490,86,3,579,1340,166,1,1507,Tuesday
2020-11-17,China Ferry Terminal,0,0,0,0,0,0,0,0,Tuesday
2020-11-17,Harbour Control,0,0,0,0,0,0,0,0,Tuesday
2020-11-17,Kai Tak Cruise Terminal,0,0,0,0,0,0,0,0,Tuesday
2020-11-17,Macau Ferry Terminal,0,0,0,0,0,0,0,0,Tuesday
2020-11-17,Tuen Mun Ferry Terminal,0,0,0,0,0,0,0,0,Tuesday
2020-11-17,Total,896,96,35,1027,2164,192,38,2394,Tuesday
2020-11-18,Airport,609,6,27,642,763,5,86,854,Wednesday
2020-11-18,Hung Hom,0,0,0,0,0,0,0,0,Wednesday
2020-11-18,Lo Wu,0,0,0,0,0,0,0,0,Wednesday
2020-11-18,Lok Ma Chau Spur Line,0,0,0,0,0,0,0,0,Wednesday
2020-11-18,Heung Yuen Wai,0,0,0,0,0,0,0,0,Wednesday
2020-11-18,Hong Kong-Zhuhai-Macao Bridge,14,3,19,36,159,10,6,175,Wednesday
2020-11-18,Lok Ma Chau,0,0,0,0,0,0,0,0,Wednesday
2020-11-18,Man Kam To,0,0,0,0,0,0,0,0,Wednesday
2020-11-18,Sha Tau Kok,0,0,0,0,0,0,0,0,Wednesday
2020-11-18,Shenzhen Bay,407,86,0,493,1039,156,8,1203,Wednesday
2020-11-18,China Ferry Terminal,0,0,0,0,0,0,0,0,Wednesday
2020-11-18,Harbour Control,0,0,0,0,0,0,0,0,Wednesday
2020-11-18,Kai Tak Cruise Terminal,0,0,0,0,0,0,0,0,Wednesday
2020-11-18,Macau Ferry Terminal,0,0,0,0,0,0,0,0,Wednesday
2020-11-18,Tuen Mun Ferry Terminal,0,0,0,0,0,0,0,0,Wednesday
2020-11-18,Total,1030,95,46,1171,1961,171,100,2232,Wednesday
2020-11-19,Airport,568,2,30,600,550,5,36,591,Thursday
2020-11-19,Express Rail Link West Kowloon,0,0,0,0,0,0,0,0,Thursday
2020-11-19,Hung Hom,0,0,0,0,0,0,0,0,Thursday
2020-11-19,Lo Wu,0,0,0,0,0,0,0,0,Thursday
2020-11-19,Lok Ma Chau Spur Line,0,0,0,0,0,0,0,0,Thursday
2020-11-19,Heung Yuen Wai,0,0,0,0,0,0,0,0,Thursday
2020-11-19,Hong Kong-Zhuhai-Macao Bridge,19,0,3,22,144,15,6,165,Thursday
2020-11-19,Lok Ma Chau,0,0,0,0,0,0,0,0,Thursday
2020-11-19,Man Kam To,0,0,0,0,0,0,0,0,Thursday
2020-11-19,Sha Tau Kok,0,0,0,0,0,0,0,0,Thursday
2020-11-19,Shenzhen Bay,359,95,0,454,985,128,3,1116,Thursday
2020-11-19,China Ferry Terminal,0,0,0,0,0,0,0,0,Thursday
2020-11-19,Harbour Control,0,0,0,0,0,0,0,0,Thursday
2020-11-19,Kai Tak Cruise Terminal,0,0,0,0,0,0,0,0,Thursday
2020-11-19,Tuen Mun Ferry Terminal,0,0,0,0,0,0,0,0,Thursday
2020-11-19,Total,946,97,33,1076,1679,148,45,1872,Thursday
2020-11-20,Airport,766,12,34,812,976,27,56,1059,Friday
2020-11-20,Express Rail Link West Kowloon,0,0,0,0,0,0,0,0,Friday
2020-11-20,Hung Hom,0,0,0,0,0,0,0,0,Friday
2020-11-20,Lo Wu,0,0,0,0,0,0,0,0,Friday
2020-11-20,Lok Ma Chau Spur Line,0,0,0,0,0,0,0,0,Friday
2020-11-20,Heung Yuen Wai,0,0,0,0,0,0,0,0,Friday
2020-11-20,Hong Kong-Zhuhai-Macao Bridge,22,2,4,28,178,15,3,196,Friday
2020-11-20,Lok Ma Chau,0,0,0,0,0,0,0,0,Friday
2020-11-20,Man Kam To,0,0,0,0,0,0,0,0,Friday
2020-11-20,Sha Tau Kok,0,0,0,0,0,0,0,0,Friday
2020-11-20,Shenzhen Bay,490,73,1,564,1073,138,4,1215,Friday
2020-11-20,China Ferry Terminal,0,0,0,0,0,0,0,0,Friday
2020-11-20,Harbour Control,0,0,0,0,0,0,0,0,Friday
2020-11-20,Kai Tak Cruise Terminal,0,0,0,0,0,0,0,0,Friday
2020-11-20,Macau Ferry Terminal,0,0,0,0,0,0,0,0,Friday
2020-11-20,Tuen Mun Ferry Terminal,0,0,0,0,0,0,0,0,Friday
2020-11-20,Total,1278,87,39,1404,2227,180,63,2470,Friday
2020-11-21,Airport,999,3,41,1043,957,21,35,1013,Saturday
2020-11-21,Hung Hom,0,0,0,0,0,0,0,0,Saturday
2020-11-21,Lo Wu,0,0,0,0,0,0,0,0,Saturday
2020-11-21,Lok Ma Chau Spur Line,0,0,0,0,0,0,0,0,Saturday
2020-11-21,Heung Yuen Wai,0,0,0,0,0,0,0,0,Saturday
2020-11-21,Hong Kong-Zhuhai-Macao Bridge,22,7,2,31,151,13,4,168,Saturday
2020-11-21,Lok Ma Chau,0,0,0,0,0,0,0,0,Saturday
2020-11-21,Man Kam To,0,0,0,0,0,0,0,0,Saturday
2020-11-21,Sha Tau Kok,0,0,0,0,0,0,0,0,Saturday
2020-11-21,Shenzhen Bay,521,113,3,637,858,140,4,1002,Saturday
2020-11-21,China Ferry Terminal,0,0,0,0,0,0,0,0,Saturday
2020-11-21,Harbour Control,0,0,0,0,0,0,0,0,Saturday
2020-11-21,Macau Ferry Terminal,0,0,0,0,0,0,0,0,Saturday
2020-11-21,Tuen Mun Ferry Terminal,0,0,0,0,0,0,0,0,Saturday
2020-11-21,Total,1542,123,46,1711,1966,174,43,2183,Saturday
2020-11-22,Airport,1044,5,27,1076,904,21,70,995,Sunday
2020-11-22,Express Rail Link West Kowloon,0,0,0,0,0,0,0,0,Sunday
2020-11-22,Hung Hom,0,0,0,0,0,0,0,0,Sunday
2020-11-22,Lo Wu,0,0,0,0,0,0,0,0,Sunday
2020-11-22,Lok Ma Chau Spur Line,0,0,0,0,0,0,0,0,Sunday
2020-11-22,Heung Yuen Wai,0,0,0,0,0,0,0,0,Sunday
2020-11-22,Lok Ma Chau,0,0,0,0,0,0,0,0,Sunday
2020-11-22,Man Kam To,0,0,0,0,0,0,0,0,Sunday
2020-11-22,Sha Tau Kok,0,0,0,0,0,0,0,0,Sunday
2020-11-22,Shenzhen Bay,460,93,3,556,710,123,5,838,Sunday
2020-11-22,China Ferry Terminal,0,0,0,0,0,0,0,0,Sunday
2020-11-22,Harbour Control,0,0,0,0,0,0,0,0,Sunday
2020-11-22,Kai Tak Cruise Terminal,0,0,0,0,0,0,0,0,Sunday
2020-11-22,Macau Ferry Terminal,0,0,0,0,0,0,0,0,Sunday
2020-11-22,Tuen Mun Ferry Terminal,0,0,0,0,0,0,0,0,Sunday
2020-11-22,Total,1527,102,35,1664,1734,158,77,1969,Sunday
2020-11-23,Airport,452,3,14,469,384,1,36,421,Monday
2020-11-23,Express Rail Link West Kowloon,0,0,0,0,0,0,0,0,Monday
2020-11-23,Hung Hom,0,0,0,0,0,0,0,0,Monday
2020-11-23,Lo Wu,0,0,0,0,0,0,0,0,Monday
2020-11-23,Lok Ma Chau Spur Line,0,0,0,0,0,0,0,0,Monday
2020-11-23,Heung Yuen Wai,0,0,0,0,0,0,0,0,Monday
2020-11-23,Hong Kong-Zhuhai-Macao Bridge,408,2,8,418,124,12,1,137,Monday
2020-11-23,Lok Ma Chau,0,0,0,0,0,0,0,0,Monday
2020-11-23,Man Kam To,0,0,0,0,0,0,0,0,Monday
2020-11-23,Sha Tau Kok,0,0,0,0,0,0,0,0,Monday
2020-11-23,Shenzhen Bay,2479,97,2,2578,776,104,1,881,Monday
2020-11-23,China Ferry Terminal,0,0,0,0,0,0,0,0,Monday
2020-11-23,Harbour Control,0,0,0,0,0,0,0,0,Monday
2020-11-23,Kai Tak Cruise Terminal,0,0,0,0,0,0,0,0,Monday
2020-11-23,Macau Ferry Terminal,0,0,0,0,0,0,0,0,Monday
2020-11-23,Tuen Mun Ferry Terminal,0,0,0,0,0,0,0,0,Monday
2020-11-23,Total,3339,102,24,3465,1284,117,38,1439,Monday
2020-11-24,Airport,386,3,19,408,781,15,34,830,Tuesday
2020-11-24,Hung Hom,0,0,0,0,0,0,0,0,Tuesday
2020-11-24,Lo Wu,0,0,0,0,0,0,0,0,Tuesday
2020-11-24,Lok Ma Chau Spur Line,0,0,0,0,0,0,0,0,Tuesday
2020-11-24,Heung Yuen Wai,0,0,0,0,0,0,0,0,Tuesday
2020-11-24,Hong Kong-Zhuhai-Macao Bridge,108,2,4,114,206,14,8,228,Tuesday
2020-11-24,Lok Ma Chau,0,0,0,0,0,0,0,0,Tuesday
2020-11-24,Man Kam To,0,0,0,0,0,0,0,0,Tuesday
2020-11-24,Sha Tau Kok,0,0,0,0,0,0,0,0,Tuesday
2020-11-24,Shenzhen Bay,1224,67,2,1293,1093,172,2,1267,Tuesday
2020-11-24,China Ferry Terminal,0,0,0,0,0,0,0,0,Tuesday
2020-11-24,Harbour Control,0,0,0,0,0,0,0,0,Tuesday
2020-11-24,Kai Tak Cruise Terminal,0,0,0,0,0,0,0,0,Tuesday
2020-11-24,Macau Ferry Terminal,0,0,0,0,0,0,0,0,Tuesday
2020-11-24,Tuen Mun Ferry Terminal,0,0,0,0,0,0,0,0,Tuesday
2020-11-24,Total,1718,72,25,1815,2080,201,44,2325,Tuesday
2020-11-25,Airport,520,4,16,540,625,15,31,671,Wednesday
2020-11-25,Express Rail Link West Kowloon,0,0,0,0,0,0,0,0,Wednesday
2020-11-25,Hung Hom,0,0,0,0,0,0,0,0,Wednesday
2020-11-25,Lo Wu,0,0,0,0,0,0,0,0,Wednesday
2020-11-25,Lok Ma Chau Spur Line,0,0,0,0,0,0,0,0,Wednesday
2020-11-25,Heung Yuen Wai,0,0,0,0,0,0,0,0,Wednesday
2020-11-25,Hong Kong-Zhuhai-Macao Bridge,150,6,5,161,200,16,4,220,Wednesday
2020-11-25,Lok Ma Chau,0,0,0,0,0,0,0,0,Wednesday
2020-11-25,Man Kam To,0,0,0,0,0,0,0,0,Wednesday
2020-11-25,Sha Tau Kok,0,0,0,0,0,0,0,0,Wednesday
2020-11-25,Shenzhen Bay,1229,57,6,1292,1074,187,2,1263,Wednesday
2020-11-25,China Ferry Terminal,0,0,0,0,0,0,0,0,Wednesday
2020-11-25,Harbour Control,0,0,0,0,0,0,0,0,Wednesday
2020-11-25,Macau Ferry Terminal,0,0,0,0,0,0,0,0,Wednesday
2020-11-25,Tuen Mun Ferry Terminal,0,0,0,0,0,0,0,0,Wednesday
2020-11-25,Total,1899,67,27,1993,1899,218,37,2154,Wednesday
2020-11-26,Airport,708,2,19,729,651,13,41,705,Thursday
2020-11-26,Express Rail Link West Kowloon,0,0,0,0,0,0,0,0,Thursday
2020-11-26,Hung Hom,0,0,0,0,0,0,0,0,Thursday
2020-11-26,Lo Wu,0,0,0,0,0,0,0,0,Thursday
2020-11-26,Lok Ma Chau Spur Line,0,0,0,0,0,0,0,0,Thursday
2020-11-26,Heung Yuen Wai,0,0,0,0,0,0,0,0,Thursday
2020-11-26,Hong Kong-Zhuhai-Macao Bridge,93,2,6,101,186,6,3,195,Thursday
2020-11-26,Lok Ma Chau,0,0,0,0,0,0,0,0,Thursday
2020-11-26,Man Kam To,0,0,0,0,0,0,0,0,Thursday
2020-11-26,Sha Tau Kok,0,0,0,0,0,0,0,0,Thursday
2020-11-26,Shenzhen Bay,902,76,2,980,1146,140,10,1296,Thursday
2020-11-26,China Ferry Terminal,0,0,0,0,0,0,0,0,Thursday
2020-11-26,Harbour Control,0,0,0,0,0,0,0,0,Thursday
2020-11-26,Kai Tak Cruise Terminal,0,0,0,0,0,0,0,0,Thursday
2020-11-26,Macau Ferry Terminal,0,0,0,0,0,0,0,0,Thursday
2020-11-26,Tuen Mun Ferry Terminal,0,0,0,0,0,0,0,0,Thursday
2020-11-26,Total,1703,80,27,1810,1983,159,54,2196,Thursday
2020-11-27,Airport,1007,6,28,1041,1003,24,38,1065,Friday
2020-11-27,Express Rail Link West Kowloon,0,0,0,0,0,0,0,0,Friday
2020-11-27,Hung Hom,0,0,0,0,0,0,0,0,Friday
2020-11-27,Lo Wu,0,0,0,0,0,0,0,0,Friday
2020-11-27,Heung Yuen Wai,0,0,0,0,0,0,0,0,Friday
2020-11-27,Lok Ma Chau,0,0,0,0,0,0,0,0,Friday
2020-11-27,Man Kam To,0,0,0,0,0,0,0,0,Friday
2020-11-27,Sha Tau Kok,0,0,0,0,0,0,0,0,Friday
2020-11-27,Shenzhen Bay,859,72,2,933,1235,170,4,1409,Friday
2020-11-27,China Ferry Terminal,0,0,0,0,0,0,0,0,Friday
2020-11-27,Harbour Control,0,0,0,0,0,0,0,0,Friday
2020-11-27,Kai Tak Cruise Terminal,0,0,0,0,0,0,0,0,Friday
2020-11-27,Macau Ferry Terminal,0,0,0,0,0,0,0,0,Friday
2020-11-27,Tuen Mun Ferry Terminal,0,0,0,0,0,0,0,0,Friday
2020-11-27,Total,1980,81,39,2100,2447,202,44,2693,Friday
2020-11-28,Airport,1039,9,15,1063,971,15,46,1032,Friday
2020-11-28,Express Rail Link West Kowloon,0,0,0,0,0,0,0,0,Friday
2020-11-28,Hung Hom,0,0,0,0,0,0,0,0,Friday
2020-11-28,Lo Wu,0,0,0,0,0,0,0,0,Friday
2020-11-28,Lok Ma Chau Spur Line,0,0,0,0,0,0,0,0,Friday
2020-11-28,Heung Yuen Wai,0,0,0,0,0,0,0,0,Friday
2020-11-28,Hong Kong-Zhuhai-Macao Bridge,76,2,1,79,233,9,5,247,Friday
2020-11-28,Lok Ma Chau,0,0,0,0,0,0,0,0,Friday
2020-11-28,Man Kam To,0,0,0,0,0,0,0,0,Friday
2020-11-28,Sha Tau Kok,0,0,0,0,0,0,0,0,Friday
2020-11-28,Shenzhen Bay,865,75,8,948,1002,135,3,1140,Friday
2020-11-28,China Ferry Terminal,0,0,0,0,0,0,0,0,Friday
2020-11-28,Harbour Control,0,0,0,0,0,0,0,0,Friday
2020-11-28,Kai Tak Cruise Terminal,0,0,0,0,0,0,0,0,Friday
2020-11-28,Macau Ferry Terminal,0,0,0,0,0,0,0,0,Friday
2020-11-28,Tuen Mun Ferry Terminal,0,0,0,0,0,0,0,0,Friday
2020-11-28,Total,1980,86,24,2090,2206,159,54,2419,Friday
2020-11-29,Airport,1278,4,33,1315,1338,15,54,1407,Sunday
2020-11-29,Hung Hom,0,0,0,0,0,0,0,0,Sunday
2020-11-29,Lo Wu,0,0,0,0,0,0,0,0,Sunday
2020-11-29,Lok Ma Chau Spur Line,0,0,0,0,0,0,0,0,Sunday
2020-11-29,Heung Yuen Wai,0,0,0,0,0,0,0,0,Sunday
2020-11-29,Hong Kong-Zhuhai-Macao Bridge,125,4,6,135,141,11,2,154,Sunday
2020-11-29,Lok Ma Chau,0,0,0,0,0,0,0,0,Sunday
2020-11-29,Man Kam To,0,0,0,0,0,0,0,0,Sunday
2020-11-29,Sha Tau Kok,0,0,0,0,0,0,0,0,Sunday
2020-11-29,Shenzhen Bay,1140,88,9,1237,760,126,5,891,Sunday
2020-11-29,China Ferry Terminal,0,0,0,0,0,0,0,0,Sunday
2020-11-29,Harbour Control,0,0,0,0,0,0,0,0,Sunday
2020-11-29,Kai Tak Cruise Terminal,0,0,0,0,0,0,0,0,Sunday
2020-11-29,Macau Ferry Terminal,0,0,0,0,0,0,0,0,Sunday
2020-11-29,Tuen Mun Ferry Terminal,0,0,0,0,0,0,0,0,Sunday
2020-11-29,Total,2543,96,48,2687,2239,152,61,2452,Sunday
2020-11-30,Airport,787,0,22,809,679,1,56,736,Monday
2020-11-30,Express Rail Link West Kowloon,0,0,0,0,0,0,0,0,Monday
2020-11-30,Hung Hom,0,0,0,0,0,0,0,0,Monday
2020-11-30,Lo Wu,0,0,0,0,0,0,0,0,Monday
2020-11-30,Lok Ma Chau Spur Line,0,0,0,0,0,0,0,0,Monday
2020-11-30,Heung Yuen Wai,0,0,0,0,0,0,0,0,Monday
2020-11-30,Hong Kong-Zhuhai-Macao Bridge,158,4,2,164,177,10,0,187,Monday
2020-11-30,Lok Ma Chau,0,0,0,0,0,0,0,0,Monday
2020-11-30,Man Kam To,0,0,0,0,0,0,0,0,Monday
2020-11-30,Sha Tau Kok,0,0,0,0,0,0,0,0,Monday
2020-11-30,Shenzhen Bay,1190,69,1,1260,914,94,2,1010,Monday
2020-11-30,China Ferry Terminal,0,0,0,0,0,0,0,0,Monday
2020-11-30,Harbour Control,0,0,0,0,0,0,0,0,Monday
2020-11-30,Macau Ferry Terminal,0,0,0,0,0,0,0,0,Monday
2020-11-30,Tuen Mun Ferry Terminal,0,0,0,0,0,0,0,0,Monday
2020-11-30,Total,2135,73,25,2233,1770,105,58,1933,Monday
2020-12-01,Airport,746,4,21,771,1344,23,30,1397,Tuesday
2020-12-01,Express Rail Link West Kowloon,0,0,0,0,0,0,0,0,Tuesday
2020-12-01,Hung Hom,0,0,0,0,0,0,0,0,Tuesday
2020-12-01,Lo Wu,0,0,0,0,0,0,0,0,Tuesday
2020-12-01,Lok Ma Chau Spur Line,0,0,0,0,0,0,0,0,Tuesday
2020-12-01,Heung Yuen Wai,0,0,0,0,0,0,0,0,Tuesday
2020-12-01,Hong Kong-Zhuhai-Macao Bridge,80,3,3,86,279,15,9,303,Tuesday
2020-12-01,Lok Ma Chau,0,0,0,0,0,0,0,0,Tuesday
2020-12-01,Man Kam To,0,0,0,0,0,0,0,0,Tuesday
2020-12-01,Sha Tau Kok,0,0,0,0,0,0,0,0,Tuesday
2020-12-01,Shenzhen Bay,742,57,2,801,2704,357,6,3067,Tuesday
2020-12-01,China Ferry Terminal,0,0,0,0,0,0,0,0,Tuesday
2020-12-01,Harbour Control,0,0,0,0,0,0,0,0,Tuesday
2020-12-01,Kai Tak Cruise Terminal,0,0,0,0,0,0,0,0,Tuesday
2020-12-01,Macau Ferry Terminal,0,0,0,0,0,0,0,0,Tuesday
2020-12-01,Tuen Mun Ferry Terminal,0,0,0,0,0,0,0,0,Tuesday
2020-12-01,Total,1568,64,26,1658,4327,395,45,4767,Tuesday
2020-12-02,Airport,587,1,28,616,918,18,55,991,Wednesday
2020-12-02,Hung Hom,0,0,0,0,0,0,0,0,Wednesday
2020-12-02,Lo Wu,0,0,0,0,0,0,0,0,Wednesday
2020-12-02,Lok Ma Chau Spur Line,0,0,0,0,0,0,0,0,Wednesday
2020-12-02,Heung Yuen Wai,0,0,0,0,0,0,0,0,Wednesday
2020-12-02,Hong Kong-Zhuhai-Macao Bridge,84,2,23,109,280,18,8,306,Wednesday
2020-12-02,Lok Ma Chau,0,0,0,0,0,0,0,0,Wednesday
2020-12-02,Man Kam To,0,0,0,0,0,0,0,0,Wednesday
2020-12-02,Sha Tau Kok,0,0,0,0,0,0,0,0,Wednesday
2020-12-02,Shenzhen Bay,676,63,2,741,3060,436,13,3509,Wednesday
2020-12-02,China Ferry Terminal,0,0,0,0,0,0,0,0,Wednesday
2020-12-02,Harbour Control,0,0,0,0,0,0,0,0,Wednesday
2020-12-02,Macau Ferry Terminal,0,0,0,0,0,0,0,0,Wednesday
2020-12-02,Tuen Mun Ferry Terminal,0,0,0,0,0,0,0,0,Wednesday
2020-12-02,Total,1347,66,53,1466,4258,472,76,4806,Wednesday
2020-12-03,Airport,841,2,38,881,919,4,34,957,Thursday
2020-12-03,Hung Hom,0,0,0,0,0,0,0,0,Thursday
2020-12-03,Lo Wu,0,0,0,0,0,0,0,0,Thursday
2020-12-03,Lok Ma Chau Spur Line,0,0,0,0,0,0,0,0,Thursday
2020-12-03,Heung Yuen Wai,0,0,0,0,0,0,0,0,Thursday
2020-12-03,Hong Kong-Zhuhai-Macao Bridge,71,4,2,77,271,12,11,294,Thursday
2020-12-03,Lok Ma Chau,0,0,0,0,0,0,0,0,Thursday
2020-12-03,Man Kam To,0,0,0,0,0,0,0,0,Thursday
2020-12-03,Sha Tau Kok,0,0,0,0,0,0,0,0,Thursday
2020-12-03,Shenzhen Bay,688,56,2,746,2948,410,10,3368,Thursday
2020-12-03,China Ferry Terminal,0,0,0,0,0,0,0,0,Thursday
2020-12-03,Harbour Control,0,0,0,0,0,0,0,0,Thursday
2020-12-03,Kai Tak Cruise Terminal,0,0,0,0,0,0,0,0,Thursday
2020-12-03,Macau Ferry Terminal,0,0,0,0,0,0,0,0,Thursday
2020-12-03,Tuen Mun Ferry Terminal,0,0,0,0,0,0,0,0,Thursday
2020-12-03,Total,1600,62,42,1704,4138,426,55,4619,Thursday
2020-12-04,Airport,1258,7,34,1299,1423,23,40,1486,Friday
2020-12-04,Express Rail Link West Kowloon,0,0,0,0,0,0,0,0,Friday
2020-12-04,Hung Hom,0,0,0,0,0,0,0,0,Friday
2020-12-04,Lo Wu,0,0,0,0,0,0,0,0,Friday
2020-12-04,Lok Ma Chau Spur Line,0,0,0,0,0,0,0,0,Friday
2020-12-04,Heung Yuen Wai,0,0,0,0,0,0,0,0,Friday
2020-12-04,Hong Kong-Zhuhai-Macao Bridge,97,8,7,112,275,16,4,295,Friday
2020-12-04,Lok Ma Chau,0,0,0,0,0,0,0,0,Friday
2020-12-04,Man Kam To,0,0,0,0,0,0,0,0,Friday
2020-12-04,Sha Tau Kok,0,0,0,0,0,0,0,0,Friday
2020-12-04,Shenzhen Bay,518,52,4,574,2790,371,5,3166,Friday
2020-12-04,China Ferry Terminal,0,0,0,0,0,0,0,0,Friday
2020-12-04,Harbour Control,0,0,0,0,0,0,0,0,Friday
2020-12-04,Kai Tak Cruise Terminal,0,0,0,0,0,0,0,0,Friday
2020-12-04,Macau Ferry Terminal,0,0,0,0,0,0,0,0,Friday
2020-12-04,Tuen Mun Ferry Terminal,0,0,0,0,0,0,0,0,Friday
2020-12-04,Total,1873,67,45,1985,4488,410,49,4947,Friday
2020-12-05,Airport,922,0,18,940,1559,30,39,1628,Saturday
2020-12-05,Hung Hom,0,0,0,0,0,0,0,0,Saturday
2020-12-05,Lo Wu,0,0,0,0,0,0,0,0,Saturday
2020-12-05,Lok Ma Chau Spur Line,0,0,0,0,0,0,0,0,Saturday
2020-12-05,Heung Yuen Wai,0,0,0,0,0,0,0,0,Saturday
2020-12-05,Hong Kong-Zhuhai-Macao Bridge,63,3,2,68,297,12,7,316,Saturday
2020-12-05,Lok Ma Chau,0,0,0,0,0,0,0,0,Saturday
2020-12-05,Man Kam To,0,0,0,0,0,0,0,0,Saturday
2020-12-05,Sha Tau Kok,0,0,0,0,0,0,0,0,Saturday
2020-12-05,Shenzhen Bay,623,80,4,707,2554,314,6,2874,Saturday
2020-12-05,China Ferry Terminal,0,0,0,0,0,0,0,0,Saturday
2020-12-05,Harbour Control,0,0,0,0,0,0,0,0,Saturday
2020-12-05,Kai Tak Cruise Terminal,0,0,0,0,0,0,0,0,Saturday
2020-12-05,Macau Ferry Terminal,0,0,0,0,0,0,0,0,Saturday
2020-12-05,Tuen Mun Ferry Terminal,0,0,0,0,0,0,0,0,Saturday
2020-12-05,Total,1608,83,24,1715,4410,356,52,4818,Saturday
2020-12-06,Airport,1837,6,40,1883,1407,24,55,1486,Sunday
2020-12-06,Express Rail Link West Kowloon,0,0,0,0,0,0,0,0,Sunday
2020-12-06,Hung Hom,0,0,0,0,0,0,0,0,Sunday
2020-12-06,Lo Wu,0,0,0,0,0,0,0,0,Sunday
2020-12-06,Lok Ma Chau Spur Line,0,0,0,0,0,0,0,0,Sunday
2020-12-06,Heung Yuen Wai,0,0,0,0,0,0,0,0,Sunday
2020-12-06,Hong Kong-Zhuhai-Macao Bridge,68,2,2,72,258,17,3,278,Sunday
2020-12-06,Lok Ma Chau,0,0,0,0,0,0,0,0,Sunday
2020-12-06,Man Kam To,0,0,0,0,0,0,0,0,Sunday
2020-12-06,Sha Tau Kok,0,0,0,0,0,0,0,0,Sunday
2020-12-06,Shenzhen Bay,616,79,2,697,1761,205,0,1966,Sunday
2020-12-06,China Ferry Terminal,0,0,0,0,0,0,0,0,Sunday
2020-12-06,Harbour Control,0,0,0,0,0,0,0,0,Sunday
2020-12-06,Macau Ferry Terminal,0,0,0,0,0,0,0,0,Sunday
2020-12-06,Tuen Mun Ferry Terminal,0,0,0,0,0,0,0,0,Sunday
2020-12-06,Total,2521,87,44,2652,3426,246,58,3730,Sunday
2020-12-07,Airport,1470,2,64,1536,839,9,30,878,Monday
2020-12-07,Express Rail Link West Kowloon,0,0,0,0,0,0,0,0,Monday
2020-12-07,Hung Hom,0,0,0,0,0,0,0,0,Monday
2020-12-07,Lo Wu,0,0,0,0,0,0,0,0,Monday
2020-12-07,Lok Ma Chau Spur Line,0,0,0,0,0,0,0,0,Monday
2020-12-07,Heung Yuen Wai,0,0,0,0,0,0,0,0,Monday
2020-12-07,Hong Kong-Zhuhai-Macao Bridge,157,8,9,174,255,16,4,275,Monday
2020-12-07,Lok Ma Chau,0,0,0,0,0,0,0,0,Monday
2020-12-07,Man Kam To,0,0,0,0,0,0,0,0,Monday
2020-12-07,Sha Tau Kok,0,0,0,0,0,0,0,0,Monday
2020-12-07,Shenzhen Bay,1023,63,2,1088,1354,133,3,1490,Monday
2020-12-07,China Ferry Terminal,0,0,0,0,0,0,0,0,Monday
2020-12-07,Harbour Control,0,0,0,0,0,0,0,0,Monday
2020-12-07,Kai Tak Cruise Terminal,0,0,0,0,0,0,0,0,Monday
2020-12-07,Macau Ferry Terminal,0,0,0,0,0,0,0,0,Monday
2020-12-07,Tuen Mun Ferry Terminal,0,0,0,0,0,0,0,0,Monday
2020-12-07,Total,2650,73,75,2798,2448,158,37,2643,Monday
2020-12-08,Airport,823,4,20,847,1444,30,45,1519,Tuesday
2020-12-08,Hung Hom,0,0,0,0,0,0,0,0,Tuesday
2020-12-08,Lo Wu,0,0,0,0,0,0,0,0,Tuesday
2021-01-10,Hung Hom,0,0,0,0,0,0,0,0,Sunday
2020-12-08,Heung Yuen Wai,0,0,0,0,0,0,0,0,Tuesday
2020-12-08,Lok Ma Chau,0,0,0,0,0,0,0,0,Tuesday
2020-12-08,Man Kam To,0,0,0,0,0,0,0,0,Tuesday
2020-12-08,Sha Tau Kok,0,0,0,0,0,0,0,0,Tuesday
2020-12-08,Shenzhen Bay,708,64,4,776,1834,197,7,2038,Tuesday
2020-12-08,China Ferry Terminal,0,0,0,0,0,0,0,0,Tuesday
2020-12-08,Harbour Control,0,0,0,0,0,0,0,0,Tuesday
2020-12-08,Kai Tak Cruise Terminal,0,0,0,0,0,0,0,0,Tuesday
2020-12-08,Macau Ferry Terminal,0,0,0,0,0,0,0,0,Tuesday
2020-12-08,Tuen Mun Ferry Terminal,0,0,0,0,0,0,0,0,Tuesday
2020-12-08,Total,1604,70,30,1704,3577,235,53,3865,Tuesday
2020-12-09,Airport,899,1,43,943,1108,10,73,1191,Wednesday
2020-12-09,Express Rail Link West Kowloon,0,0,0,0,0,0,0,0,Wednesday
2020-12-09,Hung Hom,0,0,0,0,0,0,0,0,Wednesday
2020-12-09,Lo Wu,0,0,0,0,0,0,0,0,Wednesday
2020-12-09,Lok Ma Chau Spur Line,0,0,0,0,0,0,0,0,Wednesday
2020-12-09,Heung Yuen Wai,0,0,0,0,0,0,0,0,Wednesday
2020-12-09,Hong Kong-Zhuhai-Macao Bridge,72,1,7,80,310,14,3,327,Wednesday
2020-12-09,Lok Ma Chau,0,0,0,0,0,0,0,0,Wednesday
2020-12-09,Man Kam To,0,0,0,0,0,0,0,0,Wednesday
2020-12-09,Sha Tau Kok,0,0,0,0,0,0,0,0,Wednesday
2020-12-09,Shenzhen Bay,610,58,3,671,1865,182,1,2048,Wednesday
2020-12-09,China Ferry Terminal,0,0,0,0,0,0,0,0,Wednesday
2020-12-09,Harbour Control,0,0,0,0,0,0,0,0,Wednesday
2020-12-09,Kai Tak Cruise Terminal,0,0,0,0,0,0,0,0,Wednesday
2020-12-09,Macau Ferry Terminal,0,0,0,0,0,0,0,0,Wednesday
2020-12-09,Tuen Mun Ferry Terminal,0,0,0,0,0,0,0,0,Wednesday
2020-12-09,Total,1581,60,53,1694,3283,206,77,3566,Wednesday
2020-12-10,Airport,793,3,39,835,1307,10,142,1459,Thursday
2020-12-10,Hung Hom,0,0,0,0,0,0,0,0,Thursday
2020-12-10,Lo Wu,0,0,0,0,0,0,0,0,Thursday
2020-12-10,Lok Ma Chau Spur Line,0,0,0,0,0,0,0,0,Thursday
2020-12-10,Heung Yuen Wai,0,0,0,0,0,0,0,0,Thursday
2020-12-10,Hong Kong-Zhuhai-Macao Bridge,74,2,87,163,294,9,6,309,Thursday
2020-12-10,Lok Ma Chau,0,0,0,0,0,0,0,0,Thursday
2020-12-10,Man Kam To,0,0,0,0,0,0,0,0,Thursday
2020-12-10,Sha Tau Kok,0,0,0,0,0,0,0,0,Thursday
2020-12-10,Shenzhen Bay,606,69,3,678,1978,220,2,2200,Thursday
2020-12-10,China Ferry Terminal,0,0,0,0,0,0,0,0,Thursday
2020-12-10,Harbour Control,0,0,0,0,0,0,0,0,Thursday
2020-12-10,Kai Tak Cruise Terminal,0,0,0,0,0,0,0,0,Thursday
2020-12-10,Macau Ferry Terminal,0,0,0,0,0,0,0,0,Thursday
2020-12-10,Tuen Mun Ferry Terminal,0,0,0,0,0,0,0,0,Thursday
2020-12-10,Total,1473,74,129,1676,3579,239,150,3968,Thursday
2020-12-11,Airport,1050,2,57,1109,1514,22,45,1581,Friday
2020-12-11,Express Rail Link West Kowloon,0,0,0,0,0,0,0,0,Friday
2020-12-11,Hung Hom,0,0,0,0,0,0,0,0,Friday
2020-12-11,Lo Wu,0,0,0,0,0,0,0,0,Friday
2020-12-11,Lok Ma Chau Spur Line,0,0,0,0,0,0,0,0,Friday
2020-12-11,Heung Yuen Wai,0,0,0,0,0,0,0,0,Friday
2020-12-11,Hong Kong-Zhuhai-Macao Bridge,105,3,7,115,262,9,4,275,Friday
2020-12-11,Lok Ma Chau,0,0,0,0,0,0,0,0,Friday
2020-12-11,Man Kam To,0,0,0,0,0,0,0,0,Friday
2020-12-11,Sha Tau Kok,0,0,0,0,0,0,0,0,Friday
2020-12-11,Shenzhen Bay,524,52,3,579,2134,228,5,2367,Friday
2020-12-11,China Ferry Terminal,0,0,0,0,0,0,0,0,Friday
2020-12-11,Harbour Control,0,0,0,0,0,0,0,0,Friday
2020-12-11,Macau Ferry Terminal,0,0,0,0,0,0,0,0,Friday
2020-12-11,Tuen Mun Ferry Terminal,0,0,0,0,0,0,0,0,Friday
2020-12-11,Total,1679,57,67,1803,3910,259,54,4223,Friday
2020-12-12,Airport,543,4,13,560,1558,17,27,1602,Saturday
2020-12-12,Express Rail Link West Kowloon,0,0,0,0,0,0,0,0,Saturday
2020-12-12,Hung Hom,0,0,0,0,0,0,0,0,Saturday
2020-12-12,Lo Wu,0,0,0,0,0,0,0,0,Saturday
2020-12-12,Lok Ma Chau Spur Line,0,0,0,0,0,0,0,0,Saturday
2020-12-12,Heung Yuen Wai,0,0,0,0,0,0,0,0,Saturday
2020-12-12,Hong Kong-Zhuhai-Macao Bridge,61,3,5,69,267,14,5,286,Saturday
2020-12-12,Lok Ma Chau,0,0,0,0,0,0,0,0,Saturday
2020-12-12,Man Kam To,0,0,0,0,0,0,0,0,Saturday
2020-12-12,Sha Tau Kok,0,0,0,0,0,0,0,0,Saturday
2020-12-12,Shenzhen Bay,494,63,5,562,1994,219,3,2216,Saturday
2020-12-12,China Ferry Terminal,0,0,0,0,0,0,0,0,Saturday
2020-12-12,Harbour Control,0,0,0,0,0,0,0,0,Saturday
2020-12-12,Kai Tak Cruise Terminal,0,0,0,0,0,0,0,0,Saturday
2020-12-12,Macau Ferry Terminal,0,0,0,0,0,0,0,0,Saturday
2020-12-12,Tuen Mun Ferry Terminal,0,0,0,0,0,0,0,0,Saturday
2020-12-12,Total,1098,70,23,1191,3819,250,35,4104,Saturday
2020-12-13,Airport,1012,2,37,1051,1490,28,50,1568,Sunday
2020-12-13,Hung Hom,0,0,0,0,0,0,0,0,Sunday
2020-12-13,Lo Wu,0,0,0,0,0,0,0,0,Sunday
2020-12-13,Lok Ma Chau Spur Line,0,0,0,0,0,0,0,0,Sunday
2020-12-13,Heung Yuen Wai,0,0,0,0,0,0,0,0,Sunday
2020-12-13,Hong Kong-Zhuhai-Macao Bridge,33,3,4,40,304,18,5,327,Sunday
2020-12-13,Lok Ma Chau,0,0,0,0,0,0,0,0,Sunday
2020-12-13,Man Kam To,0,0,0,0,0,0,0,0,Sunday
2020-12-13,Sha Tau Kok,0,0,0,0,0,0,0,0,Sunday
2020-12-13,Shenzhen Bay,513,58,1,572,1426,167,1,1594,Sunday
2020-12-13,China Ferry Terminal,0,0,0,0,0,0,0,0,Sunday
2020-12-13,Kai Tak Cruise Terminal,0,0,0,0,0,0,0,0,Sunday
2020-12-13,Macau Ferry Terminal,0,0,0,0,0,0,0,0,Sunday
2020-12-13,Total,1558,63,42,1663,3220,213,56,3489,Sunday
2020-12-14,Airport,318,4,21,343,873,15,67,955,Monday
2020-12-14,Express Rail Link West Kowloon,0,0,0,0,0,0,0,0,Monday
2020-12-14,Hung Hom,0,0,0,0,0,0,0,0,Monday
2020-12-14,Lo Wu,0,0,0,0,0,0,0,0,Monday
2020-12-14,Lok Ma Chau Spur Line,0,0,0,0,0,0,0,0,Monday
2020-12-14,Heung Yuen Wai,0,0,0,0,0,0,0,0,Monday
2020-12-14,Hong Kong-Zhuhai-Macao Bridge,151,9,5,165,224,15,1,240,Monday
2020-12-14,Lok Ma Chau,0,0,0,0,0,0,0,0,Monday
2020-12-14,Man Kam To,0,0,0,0,0,0,0,0,Monday
2020-12-14,Sha Tau Kok,0,0,0,0,0,0,0,0,Monday
2020-12-14,Shenzhen Bay,984,60,1,1045,1315,129,2,1446,Monday
2020-12-14,China Ferry Terminal,0,0,0,0,0,0,0,0,Monday
2020-12-14,Harbour Control,0,0,0,0,0,0,0,0,Monday
2020-12-14,Kai Tak Cruise Terminal,0,0,0,0,0,0,0,0,Monday
2020-12-14,Macau Ferry Terminal,0,0,0,0,0,0,0,0,Monday
2020-12-14,Tuen Mun Ferry Terminal,0,0,0,0,0,0,0,0,Monday
2020-12-14,Total,1453,73,27,1553,2412,159,70,2641,Monday
2020-12-15,Airport,531,10,28,569,1440,38,41,1519,Tuesday
2020-12-15,Hung Hom,0,0,0,0,0,0,0,0,Tuesday
2020-12-15,Lo Wu,0,0,0,0,0,0,0,0,Tuesday
2020-12-15,Lok Ma Chau Spur Line,0,0,0,0,0,0,0,0,Tuesday
2020-12-15,Heung Yuen Wai,0,0,0,0,0,0,0,0,Tuesday
2020-12-15,Hong Kong-Zhuhai-Macao Bridge,83,5,5,93,260,17,6,283,Tuesday
2020-12-15,Lok Ma Chau,0,0,0,0,0,0,0,0,Tuesday
2020-12-15,Man Kam To,0,0,0,0,0,0,0,0,Tuesday
2020-12-15,Sha Tau Kok,0,0,0,0,0,0,0,0,Tuesday
2020-12-15,Shenzhen Bay,668,71,1,740,2015,192,6,2213,Tuesday
2020-12-15,China Ferry Terminal,0,0,0,0,0,0,0,0,Tuesday
2020-12-15,Harbour Control,0,0,0,0,0,0,0,0,Tuesday
2020-12-15,Kai Tak Cruise Terminal,0,0,0,0,0,0,0,0,Tuesday
2020-12-15,Macau Ferry Terminal,0,0,0,0,0,0,0,0,Tuesday
2020-12-15,Tuen Mun Ferry Terminal,0,0,0,0,0,0,0,0,Tuesday
2020-12-15,Total,1282,86,34,1402,3715,247,53,4015,Tuesday
2020-12-16,Airport,509,5,24,538,1131,12,50,1193,Wednesday
2020-12-16,Express Rail Link West Kowloon,0,0,0,0,0,0,0,0,Wednesday
2020-12-16,Hung Hom,0,0,0,0,0,0,0,0,Wednesday
2020-12-16,Lo Wu,0,0,0,0,0,0,0,0,Wednesday
2020-12-16,Lok Ma Chau Spur Line,0,0,0,0,0,0,0,0,Wednesday
2020-12-16,Heung Yuen Wai,0,0,0,0,0,0,0,0,Wednesday
2020-12-16,Hong Kong-Zhuhai-Macao Bridge,107,2,17,126,246,14,2,262,Wednesday
2020-12-16,Lok Ma Chau,0,0,0,0,0,0,0,0,Wednesday
2020-12-16,Man Kam To,0,0,0,0,0,0,0,0,Wednesday
2020-12-16,Sha Tau Kok,0,0,0,0,0,0,0,0,Wednesday
2020-12-16,Shenzhen Bay,693,60,1,754,2042,222,3,2267,Wednesday
2020-12-16,China Ferry Terminal,0,0,0,0,0,0,0,0,Wednesday
2020-12-16,Harbour Control,0,0,0,0,0,0,0,0,Wednesday
2020-12-16,Kai Tak Cruise Terminal,0,0,0,0,0,0,0,0,Wednesday
2020-12-16,Macau Ferry Terminal,0,0,0,0,0,0,0,0,Wednesday
2020-12-16,Total,1309,67,42,1418,3419,248,55,3722,Wednesday
2020-12-17,Airport,622,1,31,654,1224,10,58,1292,Thursday
2020-12-17,Express Rail Link West Kowloon,0,0,0,0,0,0,0,0,Thursday
2020-12-17,Hung Hom,0,0,0,0,0,0,0,0,Thursday
2020-12-17,Lo Wu,0,0,0,0,0,0,0,0,Thursday
2020-12-17,Lok Ma Chau Spur Line,0,0,0,0,0,0,0,0,Thursday
2020-12-17,Heung Yuen Wai,0,0,0,0,0,0,0,0,Thursday
2020-12-17,Hong Kong-Zhuhai-Macao Bridge,122,2,4,128,257,16,0,273,Thursday
2020-12-17,Lok Ma Chau,0,0,0,0,0,0,0,0,Thursday
2020-12-17,Man Kam To,0,0,0,0,0,0,0,0,Thursday
2020-12-17,Sha Tau Kok,0,0,0,0,0,0,0,0,Thursday
2020-12-17,Shenzhen Bay,535,48,1,584,1687,190,1,1878,Thursday
2020-12-17,China Ferry Terminal,0,0,0,0,0,0,0,0,Thursday
2020-12-17,Harbour Control,0,0,0,0,0,0,0,0,Thursday
2020-12-17,Kai Tak Cruise Terminal,0,0,0,0,0,0,0,0,Thursday
2020-12-17,Macau Ferry Terminal,0,0,0,0,0,0,0,0,Thursday
2020-12-17,Tuen Mun Ferry Terminal,0,0,0,0,0,0,0,0,Thursday
2020-12-17,Total,1279,51,36,1366,3168,216,59,3443,Thursday
2020-12-18,Airport,775,7,27,809,1514,25,50,1589,Friday
2020-12-18,Express Rail Link West Kowloon,0,0,0,0,0,0,0,0,Friday
2020-12-18,Hung Hom,0,0,0,0,0,0,0,0,Friday
2020-12-18,Lo Wu,0,0,0,0,0,0,0,0,Friday
2020-12-18,Lok Ma Chau Spur Line,0,0,0,0,0,0,0,0,Friday
2020-12-18,Heung Yuen Wai,0,0,0,0,0,0,0,0,Friday
2020-12-18,Lok Ma Chau,0,0,0,0,0,0,0,0,Friday
2020-12-18,Man Kam To,0,0,0,0,0,0,0,0,Friday
2020-12-18,Sha Tau Kok,0,0,0,0,0,0,0,0,Friday
2020-12-18,Shenzhen Bay,886,68,3,957,1511,173,4,1688,Friday
2020-12-18,China Ferry Terminal,0,0,0,0,0,0,0,0,Friday
2020-12-18,Harbour Control,0,0,0,0,0,0,0,0,Friday
2020-12-18,Kai Tak Cruise Terminal,0,0,0,0,0,0,0,0,Friday
2020-12-18,Macau Ferry Terminal,0,0,0,0,0,0,0,0,Friday
2020-12-18,Tuen Mun Ferry Terminal,0,0,0,0,0,0,0,0,Friday
2020-12-18,Total,1852,78,39,1969,3284,203,55,3542,Friday
2020-12-19,Airport,678,3,16,697,1474,14,40,1528,Saturday
2020-12-19,Express Rail Link West Kowloon,0,0,0,0,0,0,0,0,Saturday
2020-12-19,Hung Hom,0,0,0,0,0,0,0,0,Saturday
2020-12-19,Heung Yuen Wai,0,0,0,0,0,0,0,0,Saturday
2020-12-19,Lok Ma Chau,0,0,0,0,0,0,0,0,Saturday
2020-12-19,Man Kam To,0,0,0,0,0,0,0,0,Saturday
2020-12-19,Sha Tau Kok,0,0,0,0,0,0,0,0,Saturday
2020-12-19,Shenzhen Bay,649,55,2,706,1415,162,2,1579,Saturday
2020-12-19,China Ferry Terminal,0,0,0,0,0,0,0,0,Saturday
2020-12-19,Harbour Control,0,0,0,0,0,0,0,0,Saturday
2020-12-19,Kai Tak Cruise Terminal,0,0,0,0,0,0,0,0,Saturday
2020-12-19,Macau Ferry Terminal,0,0,0,0,0,0,0,0,Saturday
2020-12-19,Tuen Mun Ferry Terminal,0,0,0,0,0,0,0,0,Saturday
2020-12-19,Total,1446,58,22,1526,3110,194,46,3350,Saturday
2020-12-20,Airport,1088,6,39,1133,1280,28,50,1358,Sunday
2020-12-20,Express Rail Link West Kowloon,0,0,0,0,0,0,0,0,Sunday
2020-12-20,Hung Hom,0,0,0,0,0,0,0,0,Sunday
2020-12-20,Lo Wu,0,0,0,0,0,0,0,0,Sunday
2020-12-20,Lok Ma Chau Spur Line,0,0,0,0,0,0,0,0,Sunday
2020-12-20,Heung Yuen Wai,0,0,0,0,0,0,0,0,Sunday
2020-12-20,Hong Kong-Zhuhai-Macao Bridge,89,2,3,94,236,19,4,259,Sunday
2020-12-20,Lok Ma Chau,0,0,0,0,0,0,0,0,Sunday
2020-12-20,Man Kam To,0,0,0,0,0,0,0,0,Sunday
2020-12-20,Sha Tau Kok,0,0,0,0,0,0,0,0,Sunday
2020-12-20,Shenzhen Bay,630,73,3,706,1000,119,3,1122,Sunday
2020-12-20,China Ferry Terminal,0,0,0,0,0,0,0,0,Sunday
2020-12-20,Harbour Control,0,0,0,0,0,0,0,0,Sunday
2020-12-20,Kai Tak Cruise Terminal,0,0,0,0,0,0,0,0,Sunday
2020-12-20,Macau Ferry Terminal,0,0,0,0,0,0,0,0,Sunday
2020-12-20,Tuen Mun Ferry Terminal,0,0,0,0,0,0,0,0,Sunday
2020-12-20,Total,1807,81,45,1933,2516,166,57,2739,Sunday
2020-12-21,Airport,231,3,16,250,680,14,25,719,Monday
2020-12-21,Hung Hom,0,0,0,0,0,0,0,0,Monday
2020-12-21,Lo Wu,0,0,0,0,0,0,0,0,Monday
2020-12-21,Lok Ma Chau Spur Line,0,0,0,0,0,0,0,0,Monday
2020-12-21,Heung Yuen Wai,0,0,0,0,0,0,0,0,Monday
2020-12-21,Hong Kong-Zhuhai-Macao Bridge,198,3,4,205,238,8,3,249,Monday
2020-12-21,Lok Ma Chau,0,0,0,0,0,0,0,0,Monday
2020-12-21,Man Kam To,0,0,0,0,0,0,0,0,Monday
2020-12-21,Sha Tau Kok,0,0,0,0,0,0,0,0,Monday
2020-12-21,Shenzhen Bay,1181,60,1,1242,872,88,3,963,Monday
2020-12-21,China Ferry Terminal,0,0,0,0,0,0,0,0,Monday
2020-12-21,Harbour Control,0,0,0,0,0,0,0,0,Monday
2020-12-21,Kai Tak Cruise Terminal,0,0,0,0,0,0,0,0,Monday
2020-12-21,Macau Ferry Terminal,0,0,0,0,0,0,0,0,Monday
2020-12-21,Tuen Mun Ferry Terminal,0,0,0,0,0,0,0,0,Monday
2020-12-21,Total,1610,66,21,1697,1790,110,31,1931,Monday
2020-12-22,Airport,602,3,21,626,1059,23,24,1106,Tuesday
2020-12-22,Express Rail Link West Kowloon,0,0,0,0,0,0,0,0,Tuesday
2020-12-22,Hung Hom,0,0,0,0,0,0,0,0,Tuesday
2020-12-22,Lo Wu,0,0,0,0,0,0,0,0,Tuesday
2020-12-22,Lok Ma Chau Spur Line,0,0,0,0,0,0,0,0,Tuesday
2020-12-22,Heung Yuen Wai,0,0,0,0,0,0,0,0,Tuesday
2020-12-22,Hong Kong-Zhuhai-Macao Bridge,70,6,8,84,277,7,7,291,Tuesday
2020-12-22,Lok Ma Chau,0,0,0,0,0,0,0,0,Tuesday
2020-12-22,Man Kam To,0,0,0,0,0,0,0,0,Tuesday
2020-12-22,Sha Tau Kok,0,0,0,0,0,0,0,0,Tuesday
2020-12-22,Shenzhen Bay,1161,59,3,1223,2040,201,5,2246,Tuesday
2020-12-22,China Ferry Terminal,0,0,0,0,0,0,0,0,Tuesday
2020-12-22,Harbour Control,0,0,0,0,0,0,0,0,Tuesday
2020-12-22,Kai Tak Cruise Terminal,0,0,0,0,0,0,0,0,Tuesday
2020-12-22,Macau Ferry Terminal,0,0,0,0,0,0,0,0,Tuesday
2020-12-22,Total,1833,68,32,1933,3376,231,36,3643,Tuesday
2020-12-23,Airport,371,7,9,387,630,13,42,685,Wednesday
2020-12-23,Express Rail Link West Kowloon,0,0,0,0,0,0,0,0,Wednesday
2020-12-23,Hung Hom,0,0,0,0,0,0,0,0,Wednesday
2020-12-23,Lo Wu,0,0,0,0,0,0,0,0,Wednesday
2020-12-23,Lok Ma Chau Spur Line,0,0,0,0,0,0,0,0,Wednesday
2020-12-23,Heung Yuen Wai,0,0,0,0,0,0,0,0,Wednesday
2020-12-23,Hong Kong-Zhuhai-Macao Bridge,102,1,7,110,247,13,7,267,Wednesday
2020-12-23,Lok Ma Chau,0,0,0,0,0,0,0,0,Wednesday
2020-12-23,Man Kam To,0,0,0,0,0,0,0,0,Wednesday
2020-12-23,Sha Tau Kok,0,0,0,0,0,0,0,0,Wednesday
2020-12-23,Shenzhen Bay,1131,72,2,1205,2643,272,2,2917,Wednesday
2020-12-23,China Ferry Terminal,0,0,0,0,0,0,0,0,Wednesday
2020-12-23,Harbour Control,0,0,0,0,0,0,0,0,Wednesday
2020-12-23,Kai Tak Cruise Terminal,0,0,0,0,0,0,0,0,Wednesday
2020-12-23,Macau Ferry Terminal,0,0,0,0,0,0,0,0,Wednesday
2020-12-23,Tuen Mun Ferry Terminal,0,0,0,0,0,0,0,0,Wednesday
2020-12-23,Total,1604,80,18,1702,3520,298,51,3869,Wednesday
2020-12-24,Airport,337,2,23,362,665,6,36,707,Thursday
2020-12-24,Express Rail Link West Kowloon,0,0,0,0,0,0,0,0,Thursday
2020-12-24,Hung Hom,0,0,0,0,0,0,0,0,Thursday
2020-12-24,Lo Wu,0,0,0,0,0,0,0,0,Thursday
2020-12-24,Lok Ma Chau Spur Line,0,0,0,0,0,0,0,0,Thursday
2020-12-24,Heung Yuen Wai,0,0,0,0,0,0,0,0,Thursday
2020-12-24,Lok Ma Chau,0,0,0,0,0,0,0,0,Thursday
2020-12-24,Man Kam To,0,0,0,0,0,0,0,0,Thursday
2020-12-24,Sha Tau Kok,0,0,0,0,0,0,0,0,Thursday
2020-12-24,Shenzhen Bay,1005,66,4,1075,2400,254,2,2656,Thursday
2020-12-24,China Ferry Terminal,0,0,0,0,0,0,0,0,Thursday
2020-12-24,Macau Ferry Terminal,0,0,0,0,0,0,0,0,Thursday
2020-12-24,Tuen Mun Ferry Terminal,0,0,0,0,0,0,0,0,Thursday
2020-12-24,Total,1410,70,27,1507,3313,270,45,3628,Thursday
2020-12-25,Airport,367,1,11,379,787,32,26,845,Friday
2020-12-25,Express Rail Link West Kowloon,0,0,0,0,0,0,0,0,Friday
2020-12-25,Hung Hom,0,0,0,0,0,0,0,0,Friday
2020-12-25,Lo Wu,0,0,0,0,0,0,0,0,Friday
2020-12-25,Lok Ma Chau Spur Line,0,0,0,0,0,0,0,0,Friday
2020-12-25,Heung Yuen Wai,0,0,0,0,0,0,0,0,Friday
2020-12-25,Hong Kong-Zhuhai-Macao Bridge,35,0,1,36,217,10,5,232,Friday
2020-12-25,Lok Ma Chau,0,0,0,0,0,0,0,0,Friday
2020-12-25,Man Kam To,0,0,0,0,0,0,0,0,Friday
2020-12-25,Sha Tau Kok,0,0,0,0,0,0,0,0,Friday
2020-12-25,Shenzhen Bay,531,44,1,576,1671,205,2,1878,Friday
2020-12-25,China Ferry Terminal,0,0,0,0,0,0,0,0,Friday
2020-12-25,Harbour Control,0,0,0,0,0,0,0,0,Friday
2020-12-25,Kai Tak Cruise Terminal,0,0,0,0,0,0,0,0,Friday
2020-12-25,Macau Ferry Terminal,0,0,0,0,0,0,0,0,Friday
2020-12-25,Tuen Mun Ferry Terminal,0,0,0,0,0,0,0,0,Friday
2020-12-25,Total,933,45,13,991,2675,247,33,2955,Friday
2020-12-26,Airport,186,3,5,194,602,8,29,639,Saturday
2020-12-26,Hung Hom,0,0,0,0,0,0,0,0,Saturday
2020-12-26,Lo Wu,0,0,0,0,0,0,0,0,Saturday
2020-12-26,Lok Ma Chau Spur Line,0,0,0,0,0,0,0,0,Saturday
2020-12-26,Heung Yuen Wai,0,0,0,0,0,0,0,0,Saturday
2020-12-26,Hong Kong-Zhuhai-Macao Bridge,39,4,1,44,224,4,1,229,Saturday
2020-12-26,Lok Ma Chau,0,0,0,0,0,0,0,0,Saturday
2020-12-26,Man Kam To,0,0,0,0,0,0,0,0,Saturday
2020-12-26,Sha Tau Kok,0,0,0,0,0,0,0,0,Saturday
2020-12-26,Shenzhen Bay,620,48,3,671,1051,129,1,1181,Saturday
2020-12-26,China Ferry Terminal,0,0,0,0,0,0,0,0,Saturday
2020-12-26,Harbour Control,0,0,0,0,0,0,0,0,Saturday
2020-12-26,Kai Tak Cruise Terminal,0,0,0,0,0,0,0,0,Saturday
2020-12-26,Macau Ferry Terminal,0,0,0,0,0,0,0,0,Saturday
2020-12-26,Tuen Mun Ferry Terminal,0,0,0,0,0,0,0,0,Saturday
2020-12-26,Total,845,55,9,909,1877,141,31,2049,Saturday
2020-12-27,Airport,515,1,27,543,925,16,43,984,Sunday
2020-12-27,Express Rail Link West Kowloon,0,0,0,0,0,0,0,0,Sunday
2020-12-27,Hung Hom,0,0,0,0,0,0,0,0,Sunday
2020-12-27,Lo Wu,0,0,0,0,0,0,0,0,Sunday
2020-12-27,Lok Ma Chau Spur Line,0,0,0,0,0,0,0,0,Sunday
2020-12-27,Heung Yuen Wai,0,0,0,0,0,0,0,0,Sunday
2020-12-27,Hong Kong-Zhuhai-Macao Bridge,64,1,1,66,223,11,6,240,Sunday
2020-12-27,Lok Ma Chau,0,0,0,0,0,0,0,0,Sunday
2020-12-27,Man Kam To,0,0,0,0,0,0,0,0,Sunday
2020-12-27,Sha Tau Kok,0,0,0,0,0,0,0,0,Sunday
2020-12-27,Shenzhen Bay,563,49,3,615,806,85,0,891,Sunday
2020-12-27,China Ferry Terminal,0,0,0,0,0,0,0,0,Sunday
2020-12-27,Harbour Control,0,0,0,0,0,0,0,0,Sunday
2020-12-27,Kai Tak Cruise Terminal,0,0,0,0,0,0,0,0,Sunday
2020-12-27,Macau Ferry Terminal,0,0,0,0,0,0,0,0,Sunday
2020-12-27,Tuen Mun Ferry Terminal,0,0,0,0,0,0,0,0,Sunday
2020-12-27,Total,1142,51,31,1224,1954,112,49,2115,Sunday
2020-12-28,Airport,222,2,12,236,595,10,28,633,Monday
2020-12-28,Hung Hom,0,0,0,0,0,0,0,0,Monday
2020-12-28,Lo Wu,0,0,0,0,0,0,0,0,Monday
2020-12-28,Lok Ma Chau Spur Line,0,0,0,0,0,0,0,0,Monday
2020-12-28,Heung Yuen Wai,0,0,0,0,0,0,0,0,Monday
2020-12-28,Hong Kong-Zhuhai-Macao Bridge,126,0,2,128,240,9,4,253,Monday
2020-12-28,Lok Ma Chau,0,0,0,0,0,0,0,0,Monday
2020-12-28,Man Kam To,0,0,0,0,0,0,0,0,Monday
2020-12-28,Sha Tau Kok,0,0,0,0,0,0,0,0,Monday
2020-12-28,Shenzhen Bay,1156,50,2,1208,1125,90,0,1215,Monday
2020-12-28,China Ferry Terminal,0,0,0,0,0,0,0,0,Monday
2020-12-28,Harbour Control,0,0,0,0,0,0,0,0,Monday
2020-12-28,Kai Tak Cruise Terminal,0,0,0,0,0,0,0,0,Monday
2020-12-28,Macau Ferry Terminal,0,0,0,0,0,0,0,0,Monday
2020-12-28,Tuen Mun Ferry Terminal,0,0,0,0,0,0,0,0,Monday
2020-12-28,Total,1504,52,16,1572,1960,109,32,2101,Monday
2020-12-29,Airport,408,4,9,421,943,38,31,1012,Tuesday
2020-12-29,Express Rail Link West Kowloon,0,0,0,0,0,0,0,0,Tuesday
2020-12-29,Hung Hom,0,0,0,0,0,0,0,0,Tuesday
2020-12-29,Lo Wu,0,0,0,0,0,0,0,0,Tuesday
2020-12-29,Lok Ma Chau Spur Line,0,0,0,0,0,0,0,0,Tuesday
2020-12-29,Heung Yuen Wai,0,0,0,0,0,0,0,0,Tuesday
2020-12-29,Hong Kong-Zhuhai-Macao Bridge,90,4,1,95,247,16,2,265,Tuesday
2020-12-29,Lok Ma Chau,0,0,0,0,0,0,0,0,Tuesday
2020-12-29,Man Kam To,0,0,0,0,0,0,0,0,Tuesday
2020-12-29,Sha Tau Kok,0,0,0,0,0,0,0,0,Tuesday
2020-12-29,Shenzhen Bay,731,39,3,773,1709,181,4,1894,Tuesday
2020-12-29,Harbour Control,0,0,0,0,0,0,0,0,Tuesday
2020-12-29,Kai Tak Cruise Terminal,0,0,0,0,0,0,0,0,Tuesday
2020-12-29,Macau Ferry Terminal,0,0,0,0,0,0,0,0,Tuesday
2020-12-29,Tuen Mun Ferry Terminal,0,0,0,0,0,0,0,0,Tuesday
2020-12-29,Total,1229,47,13,1289,2899,235,37,3171,Tuesday
2020-12-30,Airport,648,3,23,674,656,3,48,707,Wednesday
2020-12-30,Express Rail Link West Kowloon,0,0,0,0,0,0,0,0,Wednesday
2020-12-30,Hung Hom,0,0,0,0,0,0,0,0,Wednesday
2020-12-30,Lo Wu,0,0,0,0,0,0,0,0,Wednesday
2020-12-30,Heung Yuen Wai,0,0,0,0,0,0,0,0,Wednesday
2020-12-30,Hong Kong-Zhuhai-Macao Bridge,75,1,3,79,220,12,4,236,Wednesday
2020-12-30,Lok Ma Chau,0,0,0,0,0,0,0,0,Wednesday
2020-12-30,Man Kam To,0,0,0,0,0,0,0,0,Wednesday
2020-12-30,Sha Tau Kok,0,0,0,0,0,0,0,0,Wednesday
2020-12-30,Shenzhen Bay,745,58,3,806,1896,179,0,2075,Wednesday
2020-12-30,China Ferry Terminal,0,0,0,0,0,0,0,0,Wednesday
2020-12-30,Harbour Control,0,0,0,0,0,0,0,0,Wednesday
2020-12-30,Kai Tak Cruise Terminal,0,0,0,0,0,0,0,0,Wednesday
2020-12-30,Macau Ferry Terminal,0,0,0,0,0,0,0,0,Wednesday
2020-12-30,Total,1468,62,29,1559,2772,194,52,3018,Wednesday
2020-12-31,Airport,317,1,17,335,751,5,42,798,Thursday
2020-12-31,Express Rail Link West Kowloon,0,0,0,0,0,0,0,0,Thursday
2020-12-31,Hung Hom,0,0,0,0,0,0,0,0,Thursday
2020-12-31,Lo Wu,0,0,0,0,0,0,0,0,Thursday
2020-12-31,Lok Ma Chau Spur Line,0,0,0,0,0,0,0,0,Thursday
2020-12-31,Heung Yuen Wai,0,0,0,0,0,0,0,0,Thursday
2020-12-31,Hong Kong-Zhuhai-Macao Bridge,56,1,1,58,215,16,2,233,Thursday
2020-12-31,Lok Ma Chau,0,0,0,0,0,0,0,0,Thursday
2020-12-31,Man Kam To,0,0,0,0,0,0,0,0,Thursday
2020-12-31,Sha Tau Kok,0,0,0,0,0,0,0,0,Thursday
2020-12-31,Shenzhen Bay,633,50,4,687,2281,218,7,2506,Thursday
2020-12-31,China Ferry Terminal,0,0,0,0,0,0,0,0,Thursday
2020-12-31,Harbour Control,0,0,0,0,0,0,0,0,Thursday
2020-12-31,Kai Tak Cruise Terminal,0,0,0,0,0,0,0,0,Thursday
2020-12-31,Macau Ferry Terminal,0,0,0,0,0,0,0,0,Thursday
2020-12-31,Tuen Mun Ferry Terminal,0,0,0,0,0,0,0,0,Thursday
2020-12-31,Total,1006,52,22,1080,3247,239,51,3537,Thursday
2021-01-01,Airport,341,0,9,350,803,17,28,848,Friday
2021-01-01,Express Rail Link West Kowloon,0,0,0,0,0,0,0,0,Friday
2021-01-01,Hung Hom,0,0,0,0,0,0,0,0,Friday
2021-01-01,Lo Wu,0,0,0,0,0,0,0,0,Friday
2021-01-01,Lok Ma Chau Spur Line,0,0,0,0,0,0,0,0,Friday
2021-01-01,Heung Yuen Wai,0,0,0,0,0,0,0,0,Friday
2021-01-01,Lok Ma Chau,0,0,0,0,0,0,0,0,Friday
2021-01-01,Man Kam To,0,0,0,0,0,0,0,0,Friday
2021-01-01,Sha Tau Kok,0,0,0,0,0,0,0,0,Friday
2021-01-01,Shenzhen Bay,346,43,1,390,2433,221,4,2658,Friday
2021-01-01,China Ferry Terminal,0,0,0,0,0,0,0,0,Friday
2021-01-01,Harbour Control,0,0,0,0,0,0,0,0,Friday
2021-01-01,Kai Tak Cruise Terminal,0,0,0,0,0,0,0,0,Friday
2021-01-01,Macau Ferry Terminal,0,0,0,0,0,0,0,0,Friday
2021-01-01,Tuen Mun Ferry Terminal,0,0,0,0,0,0,0,0,Friday
2021-01-01,Total,732,45,10,787,3446,245,32,3723,Friday
2021-01-02,Airport,363,10,10,383,940,22,33,995,Saturday
2021-01-02,Express Rail Link West Kowloon,0,0,0,0,0,0,0,0,Saturday
2021-01-02,Hung Hom,0,0,0,0,0,0,0,0,Saturday
2021-01-02,Lo Wu,0,0,0,0,0,0,0,0,Saturday
2021-01-02,Lok Ma Chau Spur Line,0,0,0,0,0,0,0,0,Saturday
2021-01-02,Heung Yuen Wai,0,0,0,0,0,0,0,0,Saturday
2021-01-02,Hong Kong-Zhuhai-Macao Bridge,37,1,0,38,228,10,0,238,Saturday
2021-01-02,Lok Ma Chau,0,0,0,0,0,0,0,0,Saturday
2021-01-02,Man Kam To,0,0,0,0,0,0,0,0,Saturday
2021-01-02,Sha Tau Kok,0,0,0,0,0,0,0,0,Saturday
2021-01-02,Shenzhen Bay,542,67,2,611,2735,251,2,2988,Saturday
2021-01-02,China Ferry Terminal,0,0,0,0,0,0,0,0,Saturday
2021-01-02,Harbour Control,0,0,0,0,0,0,0,0,Saturday
2021-01-02,Kai Tak Cruise Terminal,0,0,0,0,0,0,0,0,Saturday
2021-01-02,Macau Ferry Terminal,0,0,0,0,0,0,0,0,Saturday
2021-01-02,Tuen Mun Ferry Terminal,0,0,0,0,0,0,0,0,Saturday
2021-01-02,Total,942,78,12,1032,3903,283,35,4221,Saturday
2021-01-03,Airport,880,4,36,920,1146,31,44,1221,Sunday
2021-01-03,Hung Hom,0,0,0,0,0,0,0,0,Sunday
2021-01-03,Lo Wu,0,0,0,0,0,0,0,0,Sunday
2021-01-03,Lok Ma Chau Spur Line,0,0,0,0,0,0,0,0,Sunday
2021-01-03,Heung Yuen Wai,0,0,0,0,0,0,0,0,Sunday
2021-01-03,Hong Kong-Zhuhai-Macao Bridge,92,0,3,95,272,17,6,295,Sunday
2021-01-03,Lok Ma Chau,0,0,0,0,0,0,0,0,Sunday
2021-01-03,Man Kam To,0,0,0,0,0,0,0,0,Sunday
2021-01-03,Sha Tau Kok,0,0,0,0,0,0,0,0,Sunday
2021-01-03,Shenzhen Bay,798,38,2,838,3274,325,8,3607,Sunday
2021-01-03,China Ferry Terminal,0,0,0,0,0,0,0,0,Sunday
2021-01-03,Harbour Control,0,0,0,0,0,0,0,0,Sunday
2021-01-03,Kai Tak Cruise Terminal,0,0,0,0,0,0,0,0,Sunday
2021-01-03,Macau Ferry Terminal,0,0,0,0,0,0,0,0,Sunday
2021-01-03,Tuen Mun Ferry Terminal,0,0,0,0,0,0,0,0,Sunday
2021-01-03,Total,1770,42,41,1853,4692,373,58,5123,Sunday
2021-01-04,Airport,445,1,12,458,455,2,41,498,Monday
2021-01-04,Express Rail Link West Kowloon,0,0,0,0,0,0,0,0,Monday
2021-01-04,Hung Hom,0,0,0,0,0,0,0,0,Monday
2021-01-04,Lo Wu,0,0,0,0,0,0,0,0,Monday
2021-01-04,Lok Ma Chau Spur Line,0,0,0,0,0,0,0,0,Monday
2021-01-04,Heung Yuen Wai,0,0,0,0,0,0,0,0,Monday
2021-01-04,Hong Kong-Zhuhai-Macao Bridge,166,3,2,171,299,14,2,315,Monday
2021-01-04,Lok Ma Chau,0,0,0,0,0,0,0,0,Monday
2021-01-04,Man Kam To,0,0,0,0,0,0,0,0,Monday
2021-01-04,Sha Tau Kok,0,0,0,0,0,0,0,0,Monday
2021-01-04,Shenzhen Bay,1311,64,2,1377,3455,401,4,3860,Monday
2021-01-04,China Ferry Terminal,0,0,0,0,0,0,0,0,Monday
2021-01-04,Kai Tak Cruise Terminal,0,0,0,0,0,0,0,0,Monday
2021-01-04,Macau Ferry Terminal,0,0,0,0,0,0,0,0,Monday
2021-01-04,Tuen Mun Ferry Terminal,0,0,0,0,0,0,0,0,Monday
2021-01-04,Total,1922,68,16,2006,4209,417,47,4673,Monday
2021-01-05,Airport,534,2,17,553,1184,36,49,1269,Tuesday
2021-01-05,Express Rail Link West Kowloon,0,0,0,0,0,0,0,0,Tuesday
2021-01-05,Hung Hom,0,0,0,0,0,0,0,0,Tuesday
2021-01-05,Lo Wu,0,0,0,0,0,0,0,0,Tuesday
2021-01-05,Lok Ma Chau Spur Line,0,0,0,0,0,0,0,0,Tuesday
2021-01-05,Heung Yuen Wai,0,0,0,0,0,0,0,0,Tuesday
2021-01-05,Lok Ma Chau,0,0,0,0,0,0,0,0,Tuesday
2021-01-05,Man Kam To,0,0,0,0,0,0,0,0,Tuesday
2021-01-05,Sha Tau Kok,0,0,0,0,0,0,0,0,Tuesday
2021-01-05,Shenzhen Bay,703,69,1,773,992,96,4,1092,Tuesday
2021-01-05,China Ferry Terminal,0,0,0,0,0,0,0,0,Tuesday
2021-01-05,Harbour Control,0,0,0,0,0,0,0,0,Tuesday
2021-01-05,Kai Tak Cruise Terminal,0,0,0,0,0,0,0,0,Tuesday
2021-01-05,Macau Ferry Terminal,0,0,0,0,0,0,0,0,Tuesday
2021-01-05,Tuen Mun Ferry Terminal,0,0,0,0,0,0,0,0,Tuesday
2021-01-05,Total,1323,74,22,1419,2381,148,58,2587,Tuesday
2021-01-06,Airport,591,2,17,610,697,14,42,753,Wednesday
2021-01-06,Express Rail Link West Kowloon,0,0,0,0,0,0,0,0,Wednesday
2021-01-06,Hung Hom,0,0,0,0,0,0,0,0,Wednesday
2021-01-06,Lo Wu,0,0,0,0,0,0,0,0,Wednesday
2021-01-06,Lok Ma Chau Spur Line,0,0,0,0,0,0,0,0,Wednesday
2021-01-06,Heung Yuen Wai,0,0,0,0,0,0,0,0,Wednesday
2021-01-06,Hong Kong-Zhuhai-Macao Bridge,94,3,2,99,244,6,2,252,Wednesday
2021-01-06,Lok Ma Chau,0,0,0,0,0,0,0,0,Wednesday
2021-01-06,Man Kam To,0,0,0,0,0,0,0,0,Wednesday
2021-01-06,Sha Tau Kok,0,0,0,0,0,0,0,0,Wednesday
2021-01-06,Shenzhen Bay,691,59,1,751,1175,113,9,1297,Wednesday
2021-01-06,China Ferry Terminal,0,0,0,0,0,0,0,0,Wednesday
2021-01-06,Harbour Control,0,0,0,0,0,0,0,0,Wednesday
2021-01-06,Kai Tak Cruise Terminal,0,0,0,0,0,0,0,0,Wednesday
2021-01-06,Macau Ferry Terminal,0,0,0,0,0,0,0,0,Wednesday
2021-01-06,Tuen Mun Ferry Terminal,0,0,0,0,0,0,0,0,Wednesday
2021-01-06,Total,1376,64,20,1460,2116,133,53,2302,Wednesday
2021-01-07,Airport,666,7,23,696,739,9,48,796,Thursday
2021-01-07,Hung Hom,0,0,0,0,0,0,0,0,Thursday
2021-01-07,Lo Wu,0,0,0,0,0,0,0,0,Thursday
2021-01-07,Lok Ma Chau Spur Line,0,0,0,0,0,0,0,0,Thursday
2021-01-07,Heung Yuen Wai,0,0,0,0,0,0,0,0,Thursday
2021-01-07,Hong Kong-Zhuhai-Macao Bridge,53,0,7,60,215,8,2,225,Thursday
2021-01-07,Lok Ma Chau,0,0,0,0,0,0,0,0,Thursday
2021-01-07,Man Kam To,0,0,0,0,0,0,0,0,Thursday
2021-01-07,Sha Tau Kok,0,0,0,0,0,0,0,0,Thursday
2021-01-07,Shenzhen Bay,517,53,2,572,1132,109,2,1243,Thursday
2021-01-07,China Ferry Terminal,0,0,0,0,0,0,0,0,Thursday
2021-01-07,Harbour Control,0,0,0,0,0,0,0,0,Thursday
2021-01-07,Kai Tak Cruise Terminal,0,0,0,0,0,0,0,0,Thursday
2021-01-07,Macau Ferry Terminal,0,0,0,0,0,0,0,0,Thursday
2021-01-07,Tuen Mun Ferry Terminal,0,0,0,0,0,0,0,0,Thursday
2021-01-07,Total,1236,60,32,1328,2086,126,52,2264,Thursday
2021-01-08,Airport,661,1,26,688,1084,30,46,1160,Friday
2021-01-08,Express Rail Link West Kowloon,0,0,0,0,0,0,0,0,Friday
2021-01-08,Hung Hom,0,0,0,0,0,0,0,0,Friday
2021-01-08,Lo Wu,0,0,0,0,0,0,0,0,Friday
2021-01-08,Lok Ma Chau Spur Line,0,0,0,0,0,0,0,0,Friday
2021-01-08,Heung Yuen Wai,0,0,0,0,0,0,0,0,Friday
2021-01-08,Hong Kong-Zhuhai-Macao Bridge,90,3,0,93,212,12,1,225,Friday
2021-01-08,Lok Ma Chau,0,0,0,0,0,0,0,0,Friday
2021-01-08,Man Kam To,0,0,0,0,0,0,0,0,Friday
2021-01-08,Sha Tau Kok,0,0,0,0,0,0,0,0,Friday
2021-01-08,Shenzhen Bay,669,80,4,753,1447,114,5,1566,Friday
2021-01-08,China Ferry Terminal,0,0,0,0,0,0,0,0,Friday
2021-01-08,Harbour Control,0,0,0,0,0,0,0,0,Friday
2021-01-08,Kai Tak Cruise Terminal,0,0,0,0,0,0,0,0,Friday
2021-01-08,Macau Ferry Terminal,0,0,0,0,0,0,0,0,Friday
2021-01-08,Total,1420,84,30,1534,2743,156,52,2951,Friday
2021-01-09,Airport,653,11,6,670,1052,28,50,1130,Saturday
2021-01-09,Express Rail Link West Kowloon,0,0,0,0,0,0,0,0,Saturday
2021-01-09,Hung Hom,0,0,0,0,0,0,0,0,Saturday
2021-01-09,Lo Wu,0,0,0,0,0,0,0,0,Saturday
2021-01-09,Lok Ma Chau Spur Line,0,0,0,0,0,0,0,0,Saturday
2021-01-09,Heung Yuen Wai,0,0,0,0,0,0,0,0,Saturday
2021-01-09,Hong Kong-Zhuhai-Macao Bridge,65,3,5,73,187,5,2,194,Saturday
2021-01-09,Lok Ma Chau,0,0,0,0,0,0,0,0,Saturday
2021-01-09,Man Kam To,0,0,0,0,0,0,0,0,Saturday
2021-01-09,Sha Tau Kok,0,0,0,0,0,0,0,0,Saturday
2021-01-09,Shenzhen Bay,605,92,1,698,1606,133,4,1743,Saturday
2021-01-09,China Ferry Terminal,0,0,0,0,0,0,0,0,Saturday
2021-01-09,Harbour Control,0,0,0,0,0,0,0,0,Saturday
2021-01-09,Kai Tak Cruise Terminal,0,0,0,0,0,0,0,0,Saturday
2021-01-09,Macau Ferry Terminal,0,0,0,0,0,0,0,0,Saturday
2021-01-09,Tuen Mun Ferry Terminal,0,0,0,0,0,0,0,0,Saturday
2021-01-09,Total,1323,106,12,1441,2845,166,56,3067,Saturday
2021-01-10,Airport,912,6,19,937,1243,39,60,1342,Sunday
2021-01-10,Express Rail Link West Kowloon,0,0,0,0,0,0,0,0,Sunday
2021-01-10,Lok Ma Chau Spur Line,0,0,0,0,0,0,0,0,Sunday
2021-01-10,Heung Yuen Wai,0,0,0,0,0,0,0,0,Sunday
2021-01-10,Lok Ma Chau,0,0,0,0,0,0,0,0,Sunday
2021-01-10,Man Kam To,0,0,0,0,0,0,0,0,Sunday
2021-01-10,Sha Tau Kok,0,0,0,0,0,0,0,0,Sunday
2021-01-10,Shenzhen Bay,788,90,1,879,1536,155,1,1692,Sunday
2021-01-10,China Ferry Terminal,0,0,0,0,0,0,0,0,Sunday
2021-01-10,Harbour Control,0,0,0,0,0,0,0,0,Sunday
2021-01-10,Kai Tak Cruise Terminal,0,0,0,0,0,0,0,0,Sunday
2021-01-10,Macau Ferry Terminal,0,0,0,0,0,0,0,0,Sunday
2021-01-10,Tuen Mun Ferry Terminal,0,0,0,0,0,0,0,0,Sunday
2021-01-10,Total,1799,99,25,1923,2984,202,64,3250,Sunday
2021-01-11,Airport,306,0,12,318,536,4,37,577,Monday
2021-01-11,Express Rail Link West Kowloon,0,0,0,0,0,0,0,0,Monday
2021-01-11,Hung Hom,0,0,0,0,0,0,0,0,Monday
2021-01-11,Lo Wu,0,0,0,0,0,0,0,0,Monday
2021-01-11,Lok Ma Chau Spur Line,0,0,0,0,0,0,0,0,Monday
2021-01-11,Heung Yuen Wai,0,0,0,0,0,0,0,0,Monday
2021-01-11,Hong Kong-Zhuhai-Macao Bridge,214,3,3,220,231,12,2,245,Monday
2021-01-11,Lok Ma Chau,0,0,0,0,0,0,0,0,Monday
2021-01-11,Man Kam To,0,0,0,0,0,0,0,0,Monday
2021-01-11,Sha Tau Kok,0,0,0,0,0,0,0,0,Monday
2021-01-11,Shenzhen Bay,1382,69,0,1451,1199,119,0,1318,Monday
2021-01-11,China Ferry Terminal,0,0,0,0,0,0,0,0,Monday
2021-01-11,Harbour Control,0,0,0,0,0,0,0,0,Monday
2021-01-11,Kai Tak Cruise Terminal,0,0,0,0,0,0,0,0,Monday
2021-01-11,Macau Ferry Terminal,0,0,0,0,0,0,0,0,Monday
2021-01-11,Tuen Mun Ferry Terminal,0,0,0,0,0,0,0,0,Monday
2021-01-11,Total,1902,72,15,1989,1966,135,39,2140,Monday
2021-01-12,Airport,436,3,13,452,1247,30,36,1313,Tuesday
2021-01-12,Hung Hom,0,0,0,0,0,0,0,0,Tuesday
2021-01-12,Lo Wu,0,0,0,0,0,0,0,0,Tuesday
2021-01-12,Lok Ma Chau Spur Line,0,0,0,0,0,0,0,0,Tuesday
2021-01-12,Heung Yuen Wai,0,0,0,0,0,0,0,0,Tuesday
2021-01-12,Hong Kong-Zhuhai-Macao Bridge,70,3,1,74,232,6,3,241,Tuesday
2021-01-12,Lok Ma Chau,0,0,0,0,0,0,0,0,Tuesday
2021-01-12,Man Kam To,0,0,0,0,0,0,0,0,Tuesday
2021-01-12,Sha Tau Kok,0,0,0,0,0,0,0,0,Tuesday
2021-01-12,Shenzhen Bay,1065,56,1,1122,1720,129,2,1851,Tuesday
2021-01-12,China Ferry Terminal,0,0,0,0,0,0,0,0,Tuesday
2021-01-12,Harbour Control,0,0,0,0,0,0,0,0,Tuesday
2021-01-12,Kai Tak Cruise Terminal,0,0,0,0,0,0,0,0,Tuesday
2021-01-12,Macau Ferry Terminal,0,0,0,0,0,0,0,0,Tuesday
2021-01-12,Tuen Mun Ferry Terminal,0,0,0,0,0,0,0,0,Tuesday
2021-01-12,Total,1571,62,15,1648,3199,165,41,3405,Tuesday
2021-01-13,Airport,388,1,14,403,838,14,30,882,Wednesday
2021-01-13,Express Rail Link West Kowloon,0,0,0,0,0,0,0,0,Wednesday
2021-01-13,Hung Hom,0,0,0,0,0,0,0,0,Wednesday
2021-01-13,Lo Wu,0,0,0,0,0,0,0,0,Wednesday
2021-01-13,Lok Ma Chau Spur Line,0,0,0,0,0,0,0,0,Wednesday
2021-01-13,Heung Yuen Wai,0,0,0,0,0,0,0,0,Wednesday
2021-01-13,Hong Kong-Zhuhai-Macao Bridge,75,2,3,80,232,9,3,244,Wednesday
2021-01-13,Lok Ma Chau,0,0,0,0,0,0,0,0,Wednesday
2021-01-13,Man Kam To,0,0,0,0,0,0,0,0,Wednesday
2021-01-13,Sha Tau Kok,0,0,0,0,0,0,0,0,Wednesday
2021-01-13,Shenzhen Bay,860,67,1,928,1469,123,3,1595,Wednesday
2021-01-13,China Ferry Terminal,0,0,0,0,0,0,0,0,Wednesday
2021-01-13,Harbour Control,0,0,0,0,0,0,0,0,Wednesday
2021-01-13,Kai Tak Cruise Terminal,0,0,0,0,0,0,0,0,Wednesday
2021-01-13,Macau Ferry Terminal,0,0,0,0,0,0,0,0,Wednesday
2021-01-13,Total,1323,70,18,1411,2539,146,36,2721,Wednesday
2021-01-14,Airport,431,2,13,446,978,12,73,1063,Thursday
2021-01-14,Express Rail Link West Kowloon,0,0,0,0,0,0,0,0,Thursday
2021-01-14,Hung Hom,0,0,0,0,0,0,0,0,Thursday
2021-01-14,Lo Wu,0,0,0,0,0,0,0,0,Thursday
2021-01-14,Lok Ma Chau Spur Line,0,0,0,0,0,0,0,0,Thursday
2021-01-14,Heung Yuen Wai,0,0,0,0,0,0,0,0,Thursday
2021-01-14,Hong Kong-Zhuhai-Macao Bridge,76,2,3,81,225,8,3,236,Thursday
2021-01-14,Lok Ma Chau,0,0,0,0,0,0,0,0,Thursday
2021-01-14,Man Kam To,0,0,0,0,0,0,0,0,Thursday
2021-01-14,Sha Tau Kok,0,0,0,0,0,0,0,0,Thursday
2021-01-14,Shenzhen Bay,1040,56,1,1097,1871,116,3,1990,Thursday
2021-01-14,China Ferry Terminal,0,0,0,0,0,0,0,0,Thursday
2021-01-14,Harbour Control,0,0,0,0,0,0,0,0,Thursday
2021-01-14,Kai Tak Cruise Terminal,0,0,0,0,0,0,0,0,Thursday
2021-01-14,Macau Ferry Terminal,0,0,0,0,0,0,0,0,Thursday
2021-01-14,Tuen Mun Ferry Terminal,0,0,0,0,0,0,0,0,Thursday
2021-01-14,Total,1547,60,17,1624,3074,136,79,3289,Thursday
2021-01-15,Airport,532,1,30,563,1220,24,47,1291,Friday
2021-01-15,Express Rail Link West Kowloon,0,0,0,0,0,0,0,0,Friday
2021-01-15,Hung Hom,0,0,0,0,0,0,0,0,Friday
2021-01-15,Lo Wu,0,0,0,0,0,0,0,0,Friday
2021-01-15,Lok Ma Chau Spur Line,0,0,0,0,0,0,0,0,Friday
2021-01-15,Heung Yuen Wai,0,0,0,0,0,0,0,0,Friday
2021-01-15,Lok Ma Chau,0,0,0,0,0,0,0,0,Friday
2021-01-15,Man Kam To,0,0,0,0,0,0,0,0,Friday
2021-01-15,Sha Tau Kok,0,0,0,0,0,0,0,0,Friday
2021-01-15,Shenzhen Bay,1190,79,2,1271,2054,133,3,2190,Friday
2021-01-15,Harbour Control,0,0,0,0,0,0,0,0,Friday
2021-01-15,Macau Ferry Terminal,0,0,0,0,0,0,0,0,Friday
2021-01-15,Tuen Mun Ferry Terminal,0,0,0,0,0,0,0,0,Friday
2021-01-15,Total,1825,83,37,1945,3525,160,54,3739,Friday
2021-01-16,Airport,525,10,25,560,1166,16,24,1206,Saturday
2021-01-16,Express Rail Link West Kowloon,0,0,0,0,0,0,0,0,Saturday
2021-01-16,Hung Hom,0,0,0,0,0,0,0,0,Saturday
2021-01-16,Lo Wu,0,0,0,0,0,0,0,0,Saturday
2021-01-16,Lok Ma Chau Spur Line,0,0,0,0,0,0,0,0,Saturday
2021-01-16,Heung Yuen Wai,0,0,0,0,0,0,0,0,Saturday
2021-01-16,Hong Kong-Zhuhai-Macao Bridge,93,3,8,104,246,10,2,258,Saturday
2021-01-16,Lok Ma Chau,0,0,0,0,0,0,0,0,Saturday
2021-01-16,Man Kam To,0,0,0,0,0,0,0,0,Saturday
2021-01-16,Sha Tau Kok,0,0,0,0,0,0,0,0,Saturday
2021-01-16,Shenzhen Bay,965,128,1,1094,1926,116,0,2042,Saturday
2021-01-16,China Ferry Terminal,0,0,0,0,0,0,0,0,Saturday
2021-01-16,Harbour Control,0,0,0,0,0,0,0,0,Saturday
2021-01-16,Kai Tak Cruise Terminal,0,0,0,0,0,0,0,0,Saturday
2021-01-16,Macau Ferry Terminal,0,0,0,0,0,0,0,0,Saturday
2021-01-16,Tuen Mun Ferry Terminal,0,0,0,0,0,0,0,0,Saturday
2021-01-16,Total,1583,141,34,1758,3338,142,26,3506,Saturday
2021-01-17,Airport,642,4,29,675,1212,25,30,1267,Sunday
2021-01-17,Hung Hom,0,0,0,0,0,0,0,0,Sunday
2021-01-17,Lo Wu,0,0,0,0,0,0,0,0,Sunday
2021-01-17,Lok Ma Chau Spur Line,0,0,0,0,0,0,0,0,Sunday
2021-01-17,Heung Yuen Wai,0,0,0,0,0,0,0,0,Sunday
2021-01-17,Hong Kong-Zhuhai-Macao Bridge,93,5,2,100,223,7,3,233,Sunday
2021-01-17,Lok Ma Chau,0,0,0,0,0,0,0,0,Sunday
2021-01-17,Man Kam To,0,0,0,0,0,0,0,0,Sunday
2021-01-17,Sha Tau Kok,0,0,0,0,0,0,0,0,Sunday
2021-01-17,Shenzhen Bay,864,84,2,950,1683,110,1,1794,Sunday
2021-01-17,China Ferry Terminal,0,0,0,0,0,0,0,0,Sunday
2021-01-17,Harbour Control,0,0,0,0,0,0,0,0,Sunday
2021-01-17,Kai Tak Cruise Terminal,0,0,0,0,0,0,0,0,Sunday
2021-01-17,Macau Ferry Terminal,0,0,0,0,0,0,0,0,Sunday
2021-01-17,Tuen Mun Ferry Terminal,0,0,0,0,0,0,0,0,Sunday
2021-01-17,Total,1599,93,33,1725,3118,142,34,3294,Sunday
2021-01-18,Airport,337,1,8,346,478,6,17,501,Monday
2021-01-18,Express Rail Link West Kowloon,0,0,0,0,0,0,0,0,Monday
2021-01-18,Hung Hom,0,0,0,0,0,0,0,0,Monday
2021-01-18,Lo Wu,0,0,0,0,0,0,0,0,Monday
2021-01-18,Lok Ma Chau Spur Line,0,0,0,0,0,0,0,0,Monday
2021-01-18,Heung Yuen Wai,0,0,0,0,0,0,0,0,Monday
2021-01-18,Hong Kong-Zhuhai-Macao Bridge,151,4,4,159,192,8,1,201,Monday
2021-01-18,Lok Ma Chau,0,0,0,0,0,0,0,0,Monday
2021-01-18,Man Kam To,0,0,0,0,0,0,0,0,Monday
2021-01-18,Sha Tau Kok,0,0,0,0,0,0,0,0,Monday
2021-01-18,Shenzhen Bay,1350,79,1,1430,1586,138,2,1726,Monday
2021-01-18,China Ferry Terminal,0,0,0,0,0,0,0,0,Monday
2021-01-18,Harbour Control,0,0,0,0,0,0,0,0,Monday
2021-01-18,Kai Tak Cruise Terminal,0,0,0,0,0,0,0,0,Monday
2021-01-18,Macau Ferry Terminal,0,0,0,0,0,0,0,0,Monday
2021-01-18,Total,1838,84,13,1935,2256,152,20,2428,Monday
2021-01-19,Airport,488,3,15,506,1175,20,53,1248,Tuesday
2021-01-19,Express Rail Link West Kowloon,0,0,0,0,0,0,0,0,Tuesday
2021-01-19,Hung Hom,0,0,0,0,0,0,0,0,Tuesday
2021-01-19,Lo Wu,0,0,0,0,0,0,0,0,Tuesday
2021-01-19,Lok Ma Chau Spur Line,0,0,0,0,0,0,0,0,Tuesday
2021-01-19,Heung Yuen Wai,0,0,0,0,0,0,0,0,Tuesday
2021-01-19,Hong Kong-Zhuhai-Macao Bridge,87,4,13,104,220,8,1,229,Tuesday
2021-01-19,Lok Ma Chau,0,0,0,0,0,0,0,0,Tuesday
2021-01-19,Man Kam To,0,0,0,0,0,0,0,0,Tuesday
2021-01-19,Sha Tau Kok,0,0,0,0,0,0,0,0,Tuesday
2021-01-19,Shenzhen Bay,846,81,3,930,1466,123,4,1593,Tuesday
2021-01-19,China Ferry Terminal,0,0,0,0,0,0,0,0,Tuesday
2021-01-19,Harbour Control,0,0,0,0,0,0,0,0,Tuesday
2021-01-19,Kai Tak Cruise Terminal,0,0,0,0,0,0,0,0,Tuesday
2021-01-19,Macau Ferry Terminal,0,0,0,0,0,0,0,0,Tuesday
2021-01-19,Tuen Mun Ferry Terminal,0,0,0,0,0,0,0,0,Tuesday
2021-01-19,Total,1421,88,31,1540,2861,151,58,3070,Tuesday
2021-01-20,Airport,538,2,11,551,540,3,21,564,Wednesday
2021-01-20,Hung Hom,0,0,0,0,0,0,0,0,Wednesday
2021-01-20,Lo Wu,0,0,0,0,0,0,0,0,Wednesday
2021-01-20,Lok Ma Chau Spur Line,0,0,0,0,0,0,0,0,Wednesday
2021-01-20,Heung Yuen Wai,0,0,0,0,0,0,0,0,Wednesday
2021-01-20,Hong Kong-Zhuhai-Macao Bridge,113,7,8,128,189,10,5,204,Wednesday
2021-01-20,Lok Ma Chau,0,0,0,0,0,0,0,0,Wednesday
2021-01-20,Man Kam To,0,0,0,0,0,0,0,0,Wednesday
2021-01-20,Sha Tau Kok,0,0,0,0,0,0,0,0,Wednesday
2021-01-20,Shenzhen Bay,1054,88,2,1144,1581,118,2,1701,Wednesday
2021-01-20,China Ferry Terminal,0,0,0,0,0,0,0,0,Wednesday
2021-01-20,Harbour Control,0,0,0,0,0,0,0,0,Wednesday
2021-01-20,Kai Tak Cruise Terminal,0,0,0,0,0,0,0,0,Wednesday
2021-01-20,Macau Ferry Terminal,0,0,0,0,0,0,0,0,Wednesday
2021-01-20,Tuen Mun Ferry Terminal,0,0,0,0,0,0,0,0,Wednesday
2021-01-20,Total,1705,97,21,1823,2310,131,28,2469,Wednesday
2021-01-21,Airport,392,5,18,415,912,31,41,984,Thursday
2021-01-21,Express Rail Link West Kowloon,0,0,0,0,0,0,0,0,Thursday
2021-01-21,Lo Wu,0,0,0,0,0,0,0,0,Thursday
2021-01-21,Lok Ma Chau Spur Line,0,0,0,0,0,0,0,0,Thursday
2021-01-21,Heung Yuen Wai,0,0,0,0,0,0,0,0,Thursday
2021-01-21,Lok Ma Chau,0,0,0,0,0,0,0,0,Thursday
2021-01-21,Man Kam To,0,0,0,0,0,0,0,0,Thursday
2021-01-21,Sha Tau Kok,0,0,0,0,0,0,0,0,Thursday
2021-01-21,Shenzhen Bay,741,92,2,835,1121,85,1,1207,Thursday
2021-01-21,China Ferry Terminal,0,0,0,0,0,0,0,0,Thursday
2021-01-21,Harbour Control,0,0,0,0,0,0,0,0,Thursday
2021-01-21,Kai Tak Cruise Terminal,0,0,0,0,0,0,0,0,Thursday
2021-01-21,Macau Ferry Terminal,0,0,0,0,0,0,0,0,Thursday
2021-01-21,Tuen Mun Ferry Terminal,0,0,0,0,0,0,0,0,Thursday
2021-01-21,Total,1233,100,25,1358,2234,128,42,2404,Thursday
2021-01-22,Airport,453,1,12,466,709,3,49,761,Friday
2021-01-22,Express Rail Link West Kowloon,0,0,0,0,0,0,0,0,Friday
2021-01-22,Hung Hom,0,0,0,0,0,0,0,0,Friday
2021-01-22,Lo Wu,0,0,0,0,0,0,0,0,Friday
2021-01-22,Lok Ma Chau Spur Line,0,0,0,0,0,0,0,0,Friday
2021-01-22,Heung Yuen Wai,0,0,0,0,0,0,0,0,Friday
2021-01-22,Hong Kong-Zhuhai-Macao Bridge,91,6,9,106,174,5,1,180,Friday
2021-01-22,Lok Ma Chau,0,0,0,0,0,0,0,0,Friday
2021-01-22,Man Kam To,0,0,0,0,0,0,0,0,Friday
2021-01-22,Sha Tau Kok,0,0,0,0,0,0,0,0,Friday
2021-01-22,Shenzhen Bay,1058,76,5,1139,1002,82,3,1087,Friday
2021-01-22,China Ferry Terminal,0,0,0,0,0,0,0,0,Friday
2021-01-22,Harbour Control,0,0,0,0,0,0,0,0,Friday
2021-01-22,Kai Tak Cruise Terminal,0,0,0,0,0,0,0,0,Friday
2021-01-22,Macau Ferry Terminal,0,0,0,0,0,0,0,0,Friday
2021-01-22,Tuen Mun Ferry Terminal,0,0,0,0,0,0,0,0,Friday
2021-01-22,Total,1602,83,26,1711,1885,90,53,2028,Friday
2021-01-23,Airport,466,11,21,498,1008,17,39,1064,Saturday
2021-01-23,Hung Hom,0,0,0,0,0,0,0,0,Saturday
2021-01-23,Lo Wu,0,0,0,0,0,0,0,0,Saturday
2021-01-23,Lok Ma Chau Spur Line,0,0,0,0,0,0,0,0,Saturday
2021-01-23,Heung Yuen Wai,0,0,0,0,0,0,0,0,Saturday
2021-01-23,Hong Kong-Zhuhai-Macao Bridge,103,2,3,108,153,7,0,160,Saturday
2021-01-23,Lok Ma Chau,0,0,0,0,0,0,0,0,Saturday
2021-01-23,Man Kam To,0,0,0,0,0,0,0,0,Saturday
2021-01-23,Sha Tau Kok,0,0,0,0,0,0,0,0,Saturday
2021-01-23,Shenzhen Bay,1101,108,5,1214,959,71,1,1031,Saturday
2021-01-23,China Ferry Terminal,0,0,0,0,0,0,0,0,Saturday
2021-01-23,Harbour Control,0,0,0,0,0,0,0,0,Saturday
2021-01-23,Kai Tak Cruise Terminal,0,0,0,0,0,0,0,0,Saturday
2021-01-23,Macau Ferry Terminal,0,0,0,0,0,0,0,0,Saturday
2021-01-23,Tuen Mun Ferry Terminal,0,0,0,0,0,0,0,0,Saturday
2021-01-23,Total,1670,121,29,1820,2120,95,40,2255,Saturday
2021-01-24,Airport,660,5,32,697,1163,11,44,1218,Sunday
2021-01-24,Express Rail Link West Kowloon,0,0,0,0,0,0,0,0,Sunday
2021-01-24,Hung Hom,0,0,0,0,0,0,0,0,Sunday
2021-01-24,Lo Wu,0,0,0,0,0,0,0,0,Sunday
2021-01-24,Lok Ma Chau Spur Line,0,0,0,0,0,0,0,0,Sunday
2021-01-24,Heung Yuen Wai,0,0,0,0,0,0,0,0,Sunday
2021-01-24,Hong Kong-Zhuhai-Macao Bridge,123,8,2,133,128,7,0,135,Sunday
2021-01-24,Lok Ma Chau,0,0,0,0,0,0,0,0,Sunday
2021-01-24,Man Kam To,0,0,0,0,0,0,0,0,Sunday
2021-01-24,Sha Tau Kok,0,0,0,0,0,0,0,0,Sunday
2021-01-24,Shenzhen Bay,1109,126,4,1239,504,37,0,541,Sunday
2021-01-24,China Ferry Terminal,0,0,0,0,0,0,0,0,Sunday
2021-01-24,Harbour Control,0,0,0,0,0,0,0,0,Sunday
2021-01-24,Kai Tak Cruise Terminal,0,0,0,0,0,0,0,0,Sunday
2021-01-24,Macau Ferry Terminal,0,0,0,0,0,0,0,0,Sunday
2021-01-24,Tuen Mun Ferry Terminal,0,0,0,0,0,0,0,0,Sunday
2021-01-24,Total,1892,139,38,2069,1795,55,44,1894,Sunday
2021-01-25,Airport,362,0,8,370,436,3,22,461,Monday
2021-01-25,Hung Hom,0,0,0,0,0,0,0,0,Monday
2021-01-25,Lo Wu,0,0,0,0,0,0,0,0,Monday
2021-01-25,Lok Ma Chau Spur Line,0,0,0,0,0,0,0,0,Monday
2021-01-25,Heung Yuen Wai,0,0,0,0,0,0,0,0,Monday
2021-01-25,Hong Kong-Zhuhai-Macao Bridge,75,5,5,85,98,6,0,104,Monday
2021-01-25,Lok Ma Chau,0,0,0,0,0,0,0,0,Monday
2021-01-25,Man Kam To,0,0,0,0,0,0,0,0,Monday
2021-01-25,Sha Tau Kok,0,0,0,0,0,0,0,0,Monday
2021-01-25,Shenzhen Bay,889,86,4,979,637,32,1,670,Monday
2021-01-25,China Ferry Terminal,0,0,0,0,0,0,0,0,Monday
2021-01-25,Harbour Control,0,0,0,0,0,0,0,0,Monday
2021-01-25,Kai Tak Cruise Terminal,0,0,0,0,0,0,0,0,Monday
2021-01-25,Macau Ferry Terminal,0,0,0,0,0,0,0,0,Monday
2021-01-25,Tuen Mun Ferry Terminal,0,0,0,0,0,0,0,0,Monday
2021-01-25,Total,1326,91,17,1434,1171,41,23,1235,Monday
2021-01-26,Airport,496,3,10,509,814,7,45,866,Tuesday
2021-01-26,Express Rail Link West Kowloon,0,0,0,0,0,0,0,0,Tuesday
2021-01-26,Hung Hom,0,0,0,0,0,0,0,0,Tuesday
2021-01-26,Lo Wu,0,0,0,0,0,0,0,0,Tuesday
2021-01-26,Lok Ma Chau Spur Line,0,0,0,0,0,0,0,0,Tuesday
2021-01-26,Heung Yuen Wai,0,0,0,0,0,0,0,0,Tuesday
2021-01-26,Hong Kong-Zhuhai-Macao Bridge,115,1,2,118,146,14,0,160,Tuesday
2021-01-26,Lok Ma Chau,0,0,0,0,0,0,0,0,Tuesday
2021-01-26,Man Kam To,0,0,0,0,0,0,0,0,Tuesday
2021-01-26,Sha Tau Kok,0,0,0,0,0,0,0,0,Tuesday
2021-01-26,Shenzhen Bay,871,89,1,961,639,61,4,704,Tuesday
2021-01-26,Harbour Control,0,0,0,0,0,0,0,0,Tuesday
2021-01-26,Kai Tak Cruise Terminal,0,0,0,0,0,0,0,0,Tuesday
2021-01-26,Macau Ferry Terminal,0,0,0,0,0,0,0,0,Tuesday
2021-01-26,Tuen Mun Ferry Terminal,0,0,0,0,0,0,0,0,Tuesday
2021-01-26,Total,1482,93,13,1588,1599,82,49,1730,Tuesday
2021-01-27,Airport,591,2,16,609,522,3,32,557,Wednesday
2021-01-27,Hung Hom,0,0,0,0,0,0,0,0,Wednesday
2021-01-27,Lo Wu,0,0,0,0,0,0,0,0,Wednesday
2021-01-27,Lok Ma Chau Spur Line,0,0,0,0,0,0,0,0,Wednesday
2021-01-27,Heung Yuen Wai,0,0,0,0,0,0,0,0,Wednesday
2021-01-27,Hong Kong-Zhuhai-Macao Bridge,106,5,7,118,133,4,4,141,Wednesday
2021-01-27,Lok Ma Chau,0,0,0,0,0,0,0,0,Wednesday
2021-01-27,Man Kam To,0,0,0,0,0,0,0,0,Wednesday
2021-01-27,Sha Tau Kok,0,0,0,0,0,0,0,0,Wednesday
2021-01-27,Shenzhen Bay,1068,103,1,1172,618,35,1,654,Wednesday
2021-01-27,China Ferry Terminal,0,0,0,0,0,0,0,0,Wednesday
2021-01-27,Harbour Control,0,0,0,0,0,0,0,0,Wednesday
2021-01-27,Kai Tak Cruise Terminal,0,0,0,0,0,0,0,0,Wednesday
2021-01-27,Macau Ferry Terminal,0,0,0,0,0,0,0,0,Wednesday
2021-01-27,Tuen Mun Ferry Terminal,0,0,0,0,0,0,0,0,Wednesday
2021-01-27,Total,1765,110,24,1899,1273,42,37,1352,Wednesday
2021-01-28,Airport,559,9,10,578,913,11,57,981,Thursday
2021-01-28,Express Rail Link West Kowloon,0,0,0,0,0,0,0,0,Thursday
2021-01-28,Hung Hom,0,0,0,0,0,0,0,0,Thursday
2021-01-28,Lo Wu,0,0,0,0,0,0,0,0,Thursday
2021-01-28,Lok Ma Chau Spur Line,0,0,0,0,0,0,0,0,Thursday
2021-01-28,Heung Yuen Wai,0,0,0,0,0,0,0,0,Thursday
2021-01-28,Hong Kong-Zhuhai-Macao Bridge,101,3,7,111,83,3,0,86,Thursday
2021-01-28,Lok Ma Chau,0,0,0,0,0,0,0,0,Thursday
2021-01-28,Man Kam To,0,0,0,0,0,0,0,0,Thursday
2021-01-28,Sha Tau Kok,0,0,0,0,0,0,0,0,Thursday
2021-01-28,Shenzhen Bay,1027,79,4,1110,531,48,1,580,Thursday
2021-01-28,China Ferry Terminal,0,0,0,0,0,0,0,0,Thursday
2021-01-28,Harbour Control,0,0,0,0,0,0,0,0,Thursday
2021-01-28,Kai Tak Cruise Terminal,0,0,0,0,0,0,0,0,Thursday
2021-01-28,Tuen Mun Ferry Terminal,0,0,0,0,0,0,0,0,Thursday
2021-01-28,Total,1687,91,21,1799,1527,62,58,1647,Thursday
2021-01-29,Airport,549,0,14,563,723,4,30,757,Friday
2021-01-29,Express Rail Link West Kowloon,0,0,0,0,0,0,0,0,Friday
2021-01-29,Hung Hom,0,0,0,0,0,0,0,0,Friday
2021-01-29,Lo Wu,0,0,0,0,0,0,0,0,Friday
2021-01-29,Lok Ma Chau Spur Line,0,0,0,0,0,0,0,0,Friday
2021-01-29,Heung Yuen Wai,0,0,0,0,0,0,0,0,Friday
2021-01-29,Hong Kong-Zhuhai-Macao Bridge,131,3,0,134,60,3,1,64,Friday
2021-01-29,Lok Ma Chau,0,0,0,0,0,0,0,0,Friday
2021-01-29,Man Kam To,0,0,0,0,0,0,0,0,Friday
2021-01-29,Sha Tau Kok,0,0,0,0,0,0,0,0,Friday
2021-01-29,Shenzhen Bay,1288,69,1,1358,313,34,1,348,Friday
2021-01-29,China Ferry Terminal,0,0,0,0,0,0,0,0,Friday
2021-01-29,Harbour Control,0,0,0,0,0,0,0,0,Friday
2021-01-29,Kai Tak Cruise Terminal,0,0,0,0,0,0,0,0,Friday
2021-01-29,Macau Ferry Terminal,0,0,0,0,0,0,0,0,Friday
2021-01-29,Tuen Mun Ferry Terminal,0,0,0,0,0,0,0,0,Friday
2021-01-29,Total,1968,72,15,2055,1096,41,32,1169,Friday
2021-01-30,Airport,467,6,9,482,700,4,23,727,Saturday
2021-01-30,Hung Hom,0,0,0,0,0,0,0,0,Saturday
2021-01-30,Lo Wu,0,0,0,0,0,0,0,0,Saturday
2021-01-30,Lok Ma Chau Spur Line,0,0,0,0,0,0,0,0,Saturday
2021-01-30,Heung Yuen Wai,0,0,0,0,0,0,0,0,Saturday
2021-01-30,Hong Kong-Zhuhai-Macao Bridge,128,2,2,132,61,2,0,63,Saturday
2021-01-30,Lok Ma Chau,0,0,0,0,0,0,0,0,Saturday
2021-01-30,Man Kam To,0,0,0,0,0,0,0,0,Saturday
2021-01-30,Sha Tau Kok,0,0,0,0,0,0,0,0,Saturday
2021-01-30,Shenzhen Bay,1288,77,2,1367,342,24,4,370,Saturday
2021-01-30,China Ferry Terminal,0,0,0,0,0,0,0,0,Saturday
2021-01-30,Harbour Control,0,0,0,0,0,0,0,0,Saturday
2021-01-30,Kai Tak Cruise Terminal,0,0,0,0,0,0,0,0,Saturday
2021-01-30,Macau Ferry Terminal,0,0,0,0,0,0,0,0,Saturday
2021-01-30,Tuen Mun Ferry Terminal,0,0,0,0,0,0,0,0,Saturday
2021-01-30,Total,1883,85,13,1981,1103,30,27,1160,Saturday
2021-01-31,Airport,628,1,23,652,549,8,23,580,Sunday
2021-01-31,Express Rail Link West Kowloon,0,0,0,0,0,0,0,0,Sunday
2021-01-31,Hung Hom,0,0,0,0,0,0,0,0,Sunday
2021-01-31,Lo Wu,0,0,0,0,0,0,0,0,Sunday
2021-01-31,Lok Ma Chau Spur Line,0,0,0,0,0,0,0,0,Sunday
2021-01-31,Heung Yuen Wai,0,0,0,0,0,0,0,0,Sunday
2021-01-31,Hong Kong-Zhuhai-Macao Bridge,134,8,2,144,45,5,0,50,Sunday
2021-01-31,Lok Ma Chau,0,0,0,0,0,0,0,0,Sunday
2021-01-31,Man Kam To,0,0,0,0,0,0,0,0,Sunday
2021-01-31,Sha Tau Kok,0,0,0,0,0,0,0,0,Sunday
2021-01-31,Shenzhen Bay,1244,58,2,1304,244,22,2,268,Sunday
2021-01-31,China Ferry Terminal,0,0,0,0,0,0,0,0,Sunday
2021-01-31,Harbour Control,0,0,0,0,0,0,0,0,Sunday
2021-01-31,Kai Tak Cruise Terminal,0,0,0,0,0,0,0,0,Sunday
2021-01-31,Macau Ferry Terminal,0,0,0,0,0,0,0,0,Sunday
2021-01-31,Tuen Mun Ferry Terminal,0,0,0,0,0,0,0,0,Sunday
2021-01-31,Total,2006,67,27,2100,838,35,25,898,Sunday
2021-02-01,Airport,303,1,20,324,458,1,16,475,Monday
2021-02-06,Sha Tau Kok,0,0,0,0,0,0,0,0,Saturday
2021-02-01,Hung Hom,0,0,0,0,0,0,0,0,Monday
2021-02-01,Lo Wu,0,0,0,0,0,0,0,0,Monday
2021-02-01,Lok Ma Chau Spur Line,0,0,0,0,0,0,0,0,Monday
2021-02-01,Heung Yuen Wai,0,0,0,0,0,0,0,0,Monday
2021-02-01,Lok Ma Chau,0,0,0,0,0,0,0,0,Monday
2021-02-01,Man Kam To,0,0,0,0,0,0,0,0,Monday
2021-02-01,Sha Tau Kok,0,0,0,0,0,0,0,0,Monday
2021-02-01,Shenzhen Bay,660,53,2,715,253,17,0,270,Monday
2021-02-01,China Ferry Terminal,0,0,0,0,0,0,0,0,Monday
2021-02-01,Harbour Control,0,0,0,0,0,0,0,0,Monday
2021-02-01,Kai Tak Cruise Terminal,0,0,0,0,0,0,0,0,Monday
2021-02-01,Macau Ferry Terminal,0,0,0,0,0,0,0,0,Monday
2021-02-01,Tuen Mun Ferry Terminal,0,0,0,0,0,0,0,0,Monday
2021-02-01,Total,1045,54,24,1123,746,19,17,782,Monday
2021-02-02,Airport,428,2,19,449,627,10,42,679,Tuesday
2021-02-02,Express Rail Link West Kowloon,0,0,0,0,0,0,0,0,Tuesday
2021-02-02,Hung Hom,0,0,0,0,0,0,0,0,Tuesday
2021-02-02,Lo Wu,0,0,0,0,0,0,0,0,Tuesday
2021-02-02,Lok Ma Chau Spur Line,0,0,0,0,0,0,0,0,Tuesday
2021-02-02,Heung Yuen Wai,0,0,0,0,0,0,0,0,Tuesday
2021-02-02,Hong Kong-Zhuhai-Macao Bridge,99,1,4,104,47,2,1,50,Tuesday
2021-02-02,Lok Ma Chau,0,0,0,0,0,0,0,0,Tuesday
2021-02-02,Man Kam To,0,0,0,0,0,0,0,0,Tuesday
2021-02-02,Sha Tau Kok,0,0,0,0,0,0,0,0,Tuesday
2021-02-02,Shenzhen Bay,903,62,0,965,330,37,1,368,Tuesday
2021-02-02,China Ferry Terminal,0,0,0,0,0,0,0,0,Tuesday
2021-02-02,Harbour Control,0,0,0,0,0,0,0,0,Tuesday
2021-02-02,Kai Tak Cruise Terminal,0,0,0,0,0,0,0,0,Tuesday
2021-02-02,Macau Ferry Terminal,0,0,0,0,0,0,0,0,Tuesday
2021-02-02,Tuen Mun Ferry Terminal,0,0,0,0,0,0,0,0,Tuesday
2021-02-02,Total,1430,65,23,1518,1004,49,44,1097,Tuesday
2021-02-03,Airport,331,4,12,347,226,2,20,248,Wednesday
2021-02-03,Hung Hom,0,0,0,0,0,0,0,0,Wednesday
2021-02-03,Lo Wu,0,0,0,0,0,0,0,0,Wednesday
2021-02-03,Lok Ma Chau Spur Line,0,0,0,0,0,0,0,0,Wednesday
2021-02-03,Heung Yuen Wai,0,0,0,0,0,0,0,0,Wednesday
2021-02-03,Hong Kong-Zhuhai-Macao Bridge,149,3,3,155,38,2,0,40,Wednesday
2021-02-03,Lok Ma Chau,0,0,0,0,0,0,0,0,Wednesday
2021-02-03,Man Kam To,0,0,0,0,0,0,0,0,Wednesday
2021-02-03,Sha Tau Kok,0,0,0,0,0,0,0,0,Wednesday
2021-02-03,Shenzhen Bay,1540,69,1,1610,555,34,5,594,Wednesday
2021-02-03,China Ferry Terminal,0,0,0,0,0,0,0,0,Wednesday
2021-02-03,Harbour Control,0,0,0,0,0,0,0,0,Wednesday
2021-02-03,Kai Tak Cruise Terminal,0,0,0,0,0,0,0,0,Wednesday
2021-02-03,Macau Ferry Terminal,0,0,0,0,0,0,0,0,Wednesday
2021-02-03,Tuen Mun Ferry Terminal,0,0,0,0,0,0,0,0,Wednesday
2021-02-03,Total,2020,76,16,2112,819,38,25,882,Wednesday
2021-02-04,Airport,343,4,8,355,574,5,23,602,Thursday
2021-02-04,Express Rail Link West Kowloon,0,0,0,0,0,0,0,0,Thursday
2021-02-04,Hung Hom,0,0,0,0,0,0,0,0,Thursday
2021-02-04,Lo Wu,0,0,0,0,0,0,0,0,Thursday
2021-02-04,Lok Ma Chau Spur Line,0,0,0,0,0,0,0,0,Thursday
2021-02-04,Heung Yuen Wai,0,0,0,0,0,0,0,0,Thursday
2021-02-04,Hong Kong-Zhuhai-Macao Bridge,146,3,1,150,33,5,1,39,Thursday
2021-02-04,Lok Ma Chau,0,0,0,0,0,0,0,0,Thursday
2021-02-04,Man Kam To,0,0,0,0,0,0,0,0,Thursday
2021-02-04,Sha Tau Kok,0,0,0,0,0,0,0,0,Thursday
2021-02-04,Shenzhen Bay,1255,59,1,1315,434,35,0,469,Thursday
2021-02-04,China Ferry Terminal,0,0,0,0,0,0,0,0,Thursday
2021-02-04,Harbour Control,0,0,0,0,0,0,0,0,Thursday
2021-02-04,Kai Tak Cruise Terminal,0,0,0,0,0,0,0,0,Thursday
2021-02-04,Macau Ferry Terminal,0,0,0,0,0,0,0,0,Thursday
2021-02-04,Tuen Mun Ferry Terminal,0,0,0,0,0,0,0,0,Thursday
2021-02-04,Total,1744,66,10,1820,1041,45,24,1110,Thursday
2021-02-05,Airport,439,0,21,460,560,8,34,602,Friday
2021-02-05,Hung Hom,0,0,0,0,0,0,0,0,Friday
2021-02-05,Lo Wu,0,0,0,0,0,0,0,0,Friday
2021-02-05,Lok Ma Chau Spur Line,0,0,0,0,0,0,0,0,Friday
2021-02-05,Heung Yuen Wai,0,0,0,0,0,0,0,0,Friday
2021-02-05,Hong Kong-Zhuhai-Macao Bridge,301,4,9,314,67,7,0,74,Friday
2021-02-05,Lok Ma Chau,0,0,0,0,0,0,0,0,Friday
2021-02-05,Man Kam To,0,0,0,0,0,0,0,0,Friday
2021-02-05,Sha Tau Kok,0,0,0,0,0,0,0,0,Friday
2021-02-05,Shenzhen Bay,2128,72,0,2200,316,44,0,360,Friday
2021-02-05,China Ferry Terminal,0,0,0,0,0,0,0,0,Friday
2021-02-05,Harbour Control,0,0,0,0,0,0,0,0,Friday
2021-02-05,Kai Tak Cruise Terminal,0,0,0,0,0,0,0,0,Friday
2021-02-05,Macau Ferry Terminal,0,0,0,0,0,0,0,0,Friday
2021-02-05,Tuen Mun Ferry Terminal,0,0,0,0,0,0,0,0,Friday
2021-02-05,Total,2868,76,30,2974,943,59,34,1036,Friday
2021-02-06,Airport,486,2,20,508,592,2,43,637,Saturday
2021-02-06,Express Rail Link West Kowloon,0,0,0,0,0,0,0,0,Saturday
2021-02-06,Hung Hom,0,0,0,0,0,0,0,0,Saturday
2021-02-06,Lo Wu,0,0,0,0,0,0,0,0,Saturday
2021-02-06,Lok Ma Chau Spur Line,0,0,0,0,0,0,0,0,Saturday
2021-02-06,Heung Yuen Wai,0,0,0,0,0,0,0,0,Saturday
2021-02-06,Hong Kong-Zhuhai-Macao Bridge,289,7,2,298,52,0,0,52,Saturday
2021-02-06,Lok Ma Chau,0,0,0,0,0,0,0,0,Saturday
2021-02-06,Man Kam To,0,0,0,0,0,0,0,0,Saturday
2021-02-06,China Ferry Terminal,0,0,0,0,0,0,0,0,Saturday
2021-02-06,Harbour Control,0,0,0,0,0,0,0,0,Saturday
2021-02-06,Macau Ferry Terminal,0,0,0,0,0,0,0,0,Saturday
2021-02-06,Tuen Mun Ferry Terminal,0,0,0,0,0,0,0,0,Saturday
2021-02-06,Total,2635,88,23,2746,908,30,45,983,Saturday
2021-02-07,Airport,569,7,22,598,557,4,42,603,Sunday
2021-02-07,Express Rail Link West Kowloon,0,0,0,0,0,0,0,0,Sunday
2021-02-07,Hung Hom,0,0,0,0,0,0,0,0,Sunday
2021-02-07,Lo Wu,0,0,0,0,0,0,0,0,Sunday
2021-02-07,Lok Ma Chau Spur Line,0,0,0,0,0,0,0,0,Sunday
2021-02-07,Heung Yuen Wai,0,0,0,0,0,0,0,0,Sunday
2021-02-07,Hong Kong-Zhuhai-Macao Bridge,205,4,1,210,49,3,0,52,Sunday
2021-02-07,Lok Ma Chau,0,0,0,0,0,0,0,0,Sunday
2021-02-07,Man Kam To,0,0,0,0,0,0,0,0,Sunday
2021-02-07,Sha Tau Kok,0,0,0,0,0,0,0,0,Sunday
2021-02-07,Shenzhen Bay,1749,76,2,1827,228,25,1,254,Sunday
2021-02-07,China Ferry Terminal,0,0,0,0,0,0,0,0,Sunday
2021-02-07,Harbour Control,0,0,0,0,0,0,0,0,Sunday
2021-02-07,Kai Tak Cruise Terminal,0,0,0,0,0,0,0,0,Sunday
2021-02-07,Macau Ferry Terminal,0,0,0,0,0,0,0,0,Sunday
2021-02-07,Tuen Mun Ferry Terminal,0,0,0,0,0,0,0,0,Sunday
2021-02-07,Total,2523,87,25,2635,834,32,43,909,Sunday
2021-02-08,Airport,202,0,4,206,408,1,14,423,Monday
2021-02-08,Hung Hom,0,0,0,0,0,0,0,0,Monday
2021-02-08,Lo Wu,0,0,0,0,0,0,0,0,Monday
2021-02-08,Lok Ma Chau Spur Line,0,0,0,0,0,0,0,0,Monday
2021-02-08,Heung Yuen Wai,0,0,0,0,0,0,0,0,Monday
2021-02-08,Hong Kong-Zhuhai-Macao Bridge,132,3,2,137,63,1,0,64,Monday
2021-02-08,Lok Ma Chau,0,0,0,0,0,0,0,0,Monday
2021-02-08,Man Kam To,0,0,0,0,0,0,0,0,Monday
2021-02-08,Sha Tau Kok,0,0,0,0,0,0,0,0,Monday
2021-02-08,Shenzhen Bay,1120,80,4,1204,205,13,4,222,Monday
2021-02-08,China Ferry Terminal,0,0,0,0,0,0,0,0,Monday
2021-02-08,Harbour Control,0,0,0,0,0,0,0,0,Monday
2021-02-08,Kai Tak Cruise Terminal,0,0,0,0,0,0,0,0,Monday
2021-02-08,Macau Ferry Terminal,0,0,0,0,0,0,0,0,Monday
2021-02-08,Tuen Mun Ferry Terminal,0,0,0,0,0,0,0,0,Monday
2021-02-08,Total,1454,83,10,1547,676,15,18,709,Monday
2021-02-09,Airport,391,1,8,400,590,5,41,636,Tuesday
2021-02-09,Express Rail Link West Kowloon,0,0,0,0,0,0,0,0,Tuesday
2021-02-09,Hung Hom,0,0,0,0,0,0,0,0,Tuesday
2021-02-09,Lo Wu,0,0,0,0,0,0,0,0,Tuesday
2021-02-09,Lok Ma Chau Spur Line,0,0,0,0,0,0,0,0,Tuesday
2021-02-09,Heung Yuen Wai,0,0,0,0,0,0,0,0,Tuesday
2021-02-09,Hong Kong-Zhuhai-Macao Bridge,167,3,3,173,50,4,1,55,Tuesday
2021-02-09,Lok Ma Chau,0,0,0,0,0,0,0,0,Tuesday
2021-02-09,Man Kam To,0,0,0,0,0,0,0,0,Tuesday
2021-02-09,Sha Tau Kok,0,0,0,0,0,0,0,0,Tuesday
2021-02-09,Shenzhen Bay,1246,74,1,1321,255,30,2,287,Tuesday
2021-02-09,China Ferry Terminal,0,0,0,0,0,0,0,0,Tuesday
2021-02-09,Harbour Control,0,0,0,0,0,0,0,0,Tuesday
2021-02-09,Kai Tak Cruise Terminal,0,0,0,0,0,0,0,0,Tuesday
2021-02-09,Macau Ferry Terminal,0,0,0,0,0,0,0,0,Tuesday
2021-02-09,Total,1804,78,12,1894,895,39,44,978,Tuesday
2021-02-10,Airport,580,3,6,589,409,0,33,442,Wednesday
2021-02-10,Express Rail Link West Kowloon,0,0,0,0,0,0,0,0,Wednesday
2021-02-10,Hung Hom,0,0,0,0,0,0,0,0,Wednesday
2021-02-10,Lo Wu,0,0,0,0,0,0,0,0,Wednesday
2021-02-10,Lok Ma Chau Spur Line,0,0,0,0,0,0,0,0,Wednesday
2021-02-10,Heung Yuen Wai,0,0,0,0,0,0,0,0,Wednesday
2021-02-10,Hong Kong-Zhuhai-Macao Bridge,158,2,3,163,45,5,0,50,Wednesday
2021-02-10,Lok Ma Chau,0,0,0,0,0,0,0,0,Wednesday
2021-02-10,Man Kam To,0,0,0,0,0,0,0,0,Wednesday
2021-02-10,Sha Tau Kok,0,0,0,0,0,0,0,0,Wednesday
2021-02-10,Shenzhen Bay,1052,79,1,1132,282,27,1,310,Wednesday
2021-02-10,China Ferry Terminal,0,0,0,0,0,0,0,0,Wednesday
2021-02-10,Harbour Control,0,0,0,0,0,0,0,0,Wednesday
2021-02-10,Kai Tak Cruise Terminal,0,0,0,0,0,0,0,0,Wednesday
2021-02-10,Macau Ferry Terminal,0,0,0,0,0,0,0,0,Wednesday
2021-02-10,Tuen Mun Ferry Terminal,0,0,0,0,0,0,0,0,Wednesday
2021-02-10,Total,1790,84,10,1884,736,32,34,802,Wednesday
2021-02-11,Airport,288,0,8,296,517,0,16,533,Thursday
2021-02-11,Express Rail Link West Kowloon,0,0,0,0,0,0,0,0,Thursday
2021-02-11,Hung Hom,0,0,0,0,0,0,0,0,Thursday
2021-02-11,Lo Wu,0,0,0,0,0,0,0,0,Thursday
2021-02-11,Lok Ma Chau Spur Line,0,0,0,0,0,0,0,0,Thursday
2021-02-11,Heung Yuen Wai,0,0,0,0,0,0,0,0,Thursday
2021-02-11,Lok Ma Chau,0,0,0,0,0,0,0,0,Thursday
2021-02-11,Man Kam To,0,0,0,0,0,0,0,0,Thursday
2021-02-11,Sha Tau Kok,0,0,0,0,0,0,0,0,Thursday
2021-02-11,Shenzhen Bay,390,42,0,432,213,21,2,236,Thursday
2021-02-11,China Ferry Terminal,0,0,0,0,0,0,0,0,Thursday
2021-02-11,Harbour Control,0,0,0,0,0,0,0,0,Thursday
2021-02-11,Kai Tak Cruise Terminal,0,0,0,0,0,0,0,0,Thursday
2021-02-11,Macau Ferry Terminal,0,0,0,0,0,0,0,0,Thursday
2021-02-11,Tuen Mun Ferry Terminal,0,0,0,0,0,0,0,0,Thursday
2021-02-11,Total,763,45,8,816,770,21,18,809,Thursday
2021-02-12,Airport,295,1,14,310,510,3,21,534,Friday
2021-02-12,Hung Hom,0,0,0,0,0,0,0,0,Friday
2021-02-12,Lo Wu,0,0,0,0,0,0,0,0,Friday
2021-02-12,Lok Ma Chau Spur Line,0,0,0,0,0,0,0,0,Friday
2021-02-12,Heung Yuen Wai,0,0,0,0,0,0,0,0,Friday
2021-02-12,Lok Ma Chau,0,0,0,0,0,0,0,0,Friday
2021-02-12,Man Kam To,0,0,0,0,0,0,0,0,Friday
2021-02-12,Sha Tau Kok,0,0,0,0,0,0,0,0,Friday
2021-02-12,Shenzhen Bay,151,18,1,170,183,16,0,199,Friday
2021-02-12,China Ferry Terminal,0,0,0,0,0,0,0,0,Friday
2021-02-12,Harbour Control,0,0,0,0,0,0,0,0,Friday
2021-02-12,Kai Tak Cruise Terminal,0,0,0,0,0,0,0,0,Friday
2021-02-12,Macau Ferry Terminal,0,0,0,0,0,0,0,0,Friday
2021-02-12,Tuen Mun Ferry Terminal,0,0,0,0,0,0,0,0,Friday
2021-02-12,Total,480,21,15,516,719,20,21,760,Friday
2021-02-13,Airport,247,0,3,250,410,0,28,438,Saturday
2021-02-13,Express Rail Link West Kowloon,0,0,0,0,0,0,0,0,Saturday
2021-02-13,Hung Hom,0,0,0,0,0,0,0,0,Saturday
2021-02-13,Lo Wu,0,0,0,0,0,0,0,0,Saturday
2021-02-13,Lok Ma Chau Spur Line,0,0,0,0,0,0,0,0,Saturday
2021-02-13,Heung Yuen Wai,0,0,0,0,0,0,0,0,Saturday
2021-02-13,Hong Kong-Zhuhai-Macao Bridge,34,2,3,39,46,3,0,49,Saturday
2021-02-13,Lok Ma Chau,0,0,0,0,0,0,0,0,Saturday
2021-02-13,Man Kam To,0,0,0,0,0,0,0,0,Saturday
2021-02-13,Sha Tau Kok,0,0,0,0,0,0,0,0,Saturday
2021-02-13,Shenzhen Bay,305,43,1,349,221,25,3,249,Saturday
2021-02-13,China Ferry Terminal,0,0,0,0,0,0,0,0,Saturday
2021-02-13,Harbour Control,0,0,0,0,0,0,0,0,Saturday
2021-02-13,Kai Tak Cruise Terminal,0,0,0,0,0,0,0,0,Saturday
2021-02-13,Macau Ferry Terminal,0,0,0,0,0,0,0,0,Saturday
2021-02-13,Tuen Mun Ferry Terminal,0,0,0,0,0,0,0,0,Saturday
2021-02-13,Total,586,45,7,638,677,28,31,736,Saturday
2021-02-14,Airport,519,4,34,557,493,22,25,540,Sunday
2021-02-14,Hung Hom,0,0,0,0,0,0,0,0,Sunday
2021-02-14,Lo Wu,0,0,0,0,0,0,0,0,Sunday
2021-02-14,Lok Ma Chau Spur Line,0,0,0,0,0,0,0,0,Sunday
2021-02-14,Heung Yuen Wai,0,0,0,0,0,0,0,0,Sunday
2021-02-14,Hong Kong-Zhuhai-Macao Bridge,67,3,4,74,87,5,1,93,Sunday
2021-02-14,Lok Ma Chau,0,0,0,0,0,0,0,0,Sunday
2021-02-14,Man Kam To,0,0,0,0,0,0,0,0,Sunday
2021-02-14,Sha Tau Kok,0,0,0,0,0,0,0,0,Sunday
2021-02-14,Shenzhen Bay,772,69,1,842,434,45,1,480,Sunday
2021-02-14,China Ferry Terminal,0,0,0,0,0,0,0,0,Sunday
2021-02-14,Harbour Control,0,0,0,0,0,0,0,0,Sunday
2021-02-14,Kai Tak Cruise Terminal,0,0,0,0,0,0,0,0,Sunday
2021-02-14,Macau Ferry Terminal,0,0,0,0,0,0,0,0,Sunday
2021-02-14,Tuen Mun Ferry Terminal,0,0,0,0,0,0,0,0,Sunday
2021-02-14,Total,1358,76,39,1473,1014,72,27,1113,Sunday
2021-02-15,Airport,393,6,12,411,530,11,22,563,Monday
2021-02-15,Express Rail Link West Kowloon,0,0,0,0,0,0,0,0,Monday
2021-02-15,Hung Hom,0,0,0,0,0,0,0,0,Monday
2021-02-15,Lo Wu,0,0,0,0,0,0,0,0,Monday
2021-02-15,Lok Ma Chau Spur Line,0,0,0,0,0,0,0,0,Monday
2021-02-15,Heung Yuen Wai,0,0,0,0,0,0,0,0,Monday
2021-02-15,Hong Kong-Zhuhai-Macao Bridge,126,1,2,129,127,4,0,131,Monday
2021-02-15,Lok Ma Chau,0,0,0,0,0,0,0,0,Monday
2021-02-15,Man Kam To,0,0,0,0,0,0,0,0,Monday
2021-02-15,Sha Tau Kok,0,0,0,0,0,0,0,0,Monday
2021-02-15,Shenzhen Bay,1357,85,3,1445,594,45,1,640,Monday
2021-02-15,China Ferry Terminal,0,0,0,0,0,0,0,0,Monday
2021-02-15,Harbour Control,0,0,0,0,0,0,0,0,Monday
2021-02-15,Kai Tak Cruise Terminal,0,0,0,0,0,0,0,0,Monday
2021-02-15,Macau Ferry Terminal,0,0,0,0,0,0,0,0,Monday
2021-02-15,Total,1876,92,17,1985,1251,60,23,1334,Monday
2021-02-16,Airport,484,9,10,503,957,8,63,1028,Tuesday
2021-02-16,Express Rail Link West Kowloon,0,0,0,0,0,0,0,0,Tuesday
2021-02-16,Hung Hom,0,0,0,0,0,0,0,0,Tuesday
2021-02-16,Lo Wu,0,0,0,0,0,0,0,0,Tuesday
2021-02-16,Lok Ma Chau Spur Line,0,0,0,0,0,0,0,0,Tuesday
2021-02-16,Heung Yuen Wai,0,0,0,0,0,0,0,0,Tuesday
2021-02-16,Hong Kong-Zhuhai-Macao Bridge,118,7,2,127,179,10,1,190,Tuesday
2021-02-16,Lok Ma Chau,0,0,0,0,0,0,0,0,Tuesday
2021-02-16,Man Kam To,0,0,0,0,0,0,0,0,Tuesday
2021-02-16,Sha Tau Kok,0,0,0,0,0,0,0,0,Tuesday
2021-02-16,Shenzhen Bay,1388,108,1,1497,714,53,0,767,Tuesday
2021-02-16,China Ferry Terminal,0,0,0,0,0,0,0,0,Tuesday
2021-02-16,Harbour Control,0,0,0,0,0,0,0,0,Tuesday
2021-02-16,Kai Tak Cruise Terminal,0,0,0,0,0,0,0,0,Tuesday
2021-02-16,Macau Ferry Terminal,0,0,0,0,0,0,0,0,Tuesday
2021-02-16,Tuen Mun Ferry Terminal,0,0,0,0,0,0,0,0,Tuesday
2021-02-16,Total,1990,124,13,2127,1850,71,64,1985,Tuesday
2021-02-17,Airport,439,2,17,458,636,10,27,673,Wednesday
2021-02-17,Express Rail Link West Kowloon,0,0,0,0,0,0,0,0,Wednesday
2021-02-17,Hung Hom,0,0,0,0,0,0,0,0,Wednesday
2021-02-17,Lo Wu,0,0,0,0,0,0,0,0,Wednesday
2021-02-17,Lok Ma Chau Spur Line,0,0,0,0,0,0,0,0,Wednesday
2021-02-17,Heung Yuen Wai,0,0,0,0,0,0,0,0,Wednesday
2021-02-17,Lok Ma Chau,0,0,0,0,0,0,0,0,Wednesday
2021-02-17,Man Kam To,0,0,0,0,0,0,0,0,Wednesday
2021-02-23,Airport,499,1,7,507,702,18,19,739,Tuesday
2021-02-17,Shenzhen Bay,1877,155,1,2033,933,105,1,1039,Wednesday
2021-02-17,China Ferry Terminal,0,0,0,0,0,0,0,0,Wednesday
2021-02-17,Harbour Control,0,0,0,0,0,0,0,0,Wednesday
2021-02-17,Kai Tak Cruise Terminal,0,0,0,0,0,0,0,0,Wednesday
2021-02-17,Macau Ferry Terminal,0,0,0,0,0,0,0,0,Wednesday
2021-02-17,Tuen Mun Ferry Terminal,0,0,0,0,0,0,0,0,Wednesday
2021-02-17,Total,2437,167,19,2623,1766,124,29,1919,Wednesday
2021-02-18,Airport,508,8,19,535,928,10,114,1052,Thursday
2021-02-18,Hung Hom,0,0,0,0,0,0,0,0,Thursday
2021-02-18,Lo Wu,0,0,0,0,0,0,0,0,Thursday
2021-02-18,Lok Ma Chau Spur Line,0,0,0,0,0,0,0,0,Thursday
2021-02-18,Heung Yuen Wai,0,0,0,0,0,0,0,0,Thursday
2021-02-18,Hong Kong-Zhuhai-Macao Bridge,138,3,84,225,197,10,1,208,Thursday
2021-02-18,Lok Ma Chau,0,0,0,0,0,0,0,0,Thursday
2021-02-18,Man Kam To,0,0,0,0,0,0,0,0,Thursday
2021-02-18,Sha Tau Kok,0,0,0,0,0,0,0,0,Thursday
2021-02-18,Shenzhen Bay,2062,104,0,2166,1092,91,1,1184,Thursday
2021-02-18,China Ferry Terminal,0,0,0,0,0,0,0,0,Thursday
2021-02-18,Harbour Control,0,0,0,0,0,0,0,0,Thursday
2021-02-18,Kai Tak Cruise Terminal,0,0,0,0,0,0,0,0,Thursday
2021-02-18,Macau Ferry Terminal,0,0,0,0,0,0,0,0,Thursday
2021-02-18,Tuen Mun Ferry Terminal,0,0,0,0,0,0,0,0,Thursday
2021-02-18,Total,2708,115,103,2926,2217,111,116,2444,Thursday
2021-02-19,Airport,511,5,14,530,707,6,33,746,Friday
2021-02-19,Express Rail Link West Kowloon,0,0,0,0,0,0,0,0,Friday
2021-02-19,Hung Hom,0,0,0,0,0,0,0,0,Friday
2021-02-19,Lo Wu,0,0,0,0,0,0,0,0,Friday
2021-02-19,Lok Ma Chau Spur Line,0,0,0,0,0,0,0,0,Friday
2021-02-19,Heung Yuen Wai,0,0,0,0,0,0,0,0,Friday
2021-02-19,Hong Kong-Zhuhai-Macao Bridge,215,12,2,229,211,9,2,222,Friday
2021-02-19,Lok Ma Chau,0,0,0,0,0,0,0,0,Friday
2021-02-19,Man Kam To,0,0,0,0,0,0,0,0,Friday
2021-02-19,Sha Tau Kok,0,0,0,0,0,0,0,0,Friday
2021-02-19,Shenzhen Bay,2771,219,1,2991,979,82,0,1061,Friday
2021-02-19,China Ferry Terminal,0,0,0,0,0,0,0,0,Friday
2021-02-19,Harbour Control,0,0,0,0,0,0,0,0,Friday
2021-02-19,Kai Tak Cruise Terminal,0,0,0,0,0,0,0,0,Friday
2021-02-19,Macau Ferry Terminal,0,0,0,0,0,0,0,0,Friday
2021-02-19,Tuen Mun Ferry Terminal,0,0,0,0,0,0,0,0,Friday
2021-02-19,Total,3497,236,17,3750,1897,97,35,2029,Friday
2021-02-20,Airport,736,4,14,754,721,10,34,765,Saturday
2021-02-20,Hung Hom,0,0,0,0,0,0,0,0,Saturday
2021-02-20,Lo Wu,0,0,0,0,0,0,0,0,Saturday
2021-02-20,Lok Ma Chau Spur Line,0,0,0,0,0,0,0,0,Saturday
2021-02-20,Heung Yuen Wai,0,0,0,0,0,0,0,0,Saturday
2021-02-20,Hong Kong-Zhuhai-Macao Bridge,323,12,2,337,183,16,0,199,Saturday
2021-02-20,Lok Ma Chau,0,0,0,0,0,0,0,0,Saturday
2021-02-20,Man Kam To,0,0,0,0,0,0,0,0,Saturday
2021-02-20,Sha Tau Kok,0,0,0,0,0,0,0,0,Saturday
2021-02-20,Shenzhen Bay,3154,257,4,3415,966,74,1,1041,Saturday
2021-02-20,China Ferry Terminal,0,0,0,0,0,0,0,0,Saturday
2021-02-20,Harbour Control,0,0,0,0,0,0,0,0,Saturday
2021-02-20,Kai Tak Cruise Terminal,0,0,0,0,0,0,0,0,Saturday
2021-02-20,Macau Ferry Terminal,0,0,0,0,0,0,0,0,Saturday
2021-02-20,Tuen Mun Ferry Terminal,0,0,0,0,0,0,0,0,Saturday
2021-02-20,Total,4213,273,20,4506,1870,100,35,2005,Saturday
2021-02-21,Airport,814,5,23,842,825,24,36,885,Sunday
2021-02-21,Express Rail Link West Kowloon,0,0,0,0,0,0,0,0,Sunday
2021-02-21,Hung Hom,0,0,0,0,0,0,0,0,Sunday
2021-02-21,Lo Wu,0,0,0,0,0,0,0,0,Sunday
2021-02-21,Lok Ma Chau Spur Line,0,0,0,0,0,0,0,0,Sunday
2021-02-21,Heung Yuen Wai,0,0,0,0,0,0,0,0,Sunday
2021-02-21,Hong Kong-Zhuhai-Macao Bridge,596,9,1,606,207,14,3,224,Sunday
2021-02-21,Lok Ma Chau,0,0,0,0,0,0,0,0,Sunday
2021-02-21,Man Kam To,0,0,0,0,0,0,0,0,Sunday
2021-02-21,Sha Tau Kok,0,0,0,0,0,0,0,0,Sunday
2021-02-21,Shenzhen Bay,3588,259,10,3857,745,83,2,830,Sunday
2021-02-21,China Ferry Terminal,0,0,0,0,0,0,0,0,Sunday
2021-02-21,Harbour Control,0,0,0,0,0,0,0,0,Sunday
2021-02-21,Macau Ferry Terminal,0,0,0,0,0,0,0,0,Sunday
2021-02-21,Tuen Mun Ferry Terminal,0,0,0,0,0,0,0,0,Sunday
2021-02-21,Total,4998,273,34,5305,1777,121,41,1939,Sunday
2021-02-22,Airport,296,6,19,321,564,12,31,607,Monday
2021-02-22,Express Rail Link West Kowloon,0,0,0,0,0,0,0,0,Monday
2021-02-22,Hung Hom,0,0,0,0,0,0,0,0,Monday
2021-02-22,Lo Wu,0,0,0,0,0,0,0,0,Monday
2021-02-22,Lok Ma Chau Spur Line,0,0,0,0,0,0,0,0,Monday
2021-02-22,Heung Yuen Wai,0,0,0,0,0,0,0,0,Monday
2021-02-22,Hong Kong-Zhuhai-Macao Bridge,165,7,4,176,272,6,1,279,Monday
2021-02-22,Lok Ma Chau,0,0,0,0,0,0,0,0,Monday
2021-02-22,Man Kam To,0,0,0,0,0,0,0,0,Monday
2021-02-22,Sha Tau Kok,0,0,0,0,0,0,0,0,Monday
2021-02-22,Shenzhen Bay,3252,221,4,3477,1215,45,5,1265,Monday
2021-02-22,China Ferry Terminal,0,0,0,0,0,0,0,0,Monday
2021-02-22,Harbour Control,0,0,0,0,0,0,0,0,Monday
2021-02-22,Kai Tak Cruise Terminal,0,0,0,0,0,0,0,0,Monday
2021-02-22,Macau Ferry Terminal,0,0,0,0,0,0,0,0,Monday
2021-02-22,Tuen Mun Ferry Terminal,0,0,0,0,0,0,0,0,Monday
2021-02-22,Total,3713,234,27,3974,2051,63,37,2151,Monday
2021-02-23,Hung Hom,0,0,0,0,0,0,0,0,Tuesday
2021-02-23,Lo Wu,0,0,0,0,0,0,0,0,Tuesday
2021-02-23,Lok Ma Chau Spur Line,0,0,0,0,0,0,0,0,Tuesday
2021-02-23,Heung Yuen Wai,0,0,0,0,0,0,0,0,Tuesday
2021-02-23,Hong Kong-Zhuhai-Macao Bridge,170,8,3,181,228,9,4,241,Tuesday
2021-02-23,Lok Ma Chau,0,0,0,0,0,0,0,0,Tuesday
2021-02-23,Man Kam To,0,0,0,0,0,0,0,0,Tuesday
2021-02-23,Sha Tau Kok,0,0,0,0,0,0,0,0,Tuesday
2021-02-23,Shenzhen Bay,2718,163,4,2885,969,87,0,1056,Tuesday
2021-02-23,China Ferry Terminal,0,0,0,0,0,0,0,0,Tuesday
2021-02-23,Harbour Control,0,0,0,0,0,0,0,0,Tuesday
2021-02-23,Kai Tak Cruise Terminal,0,0,0,0,0,0,0,0,Tuesday
2021-02-23,Macau Ferry Terminal,0,0,0,0,0,0,0,0,Tuesday
2021-02-23,Tuen Mun Ferry Terminal,0,0,0,0,0,0,0,0,Tuesday
2021-02-23,Total,3387,172,14,3573,1899,114,23,2036,Tuesday
2021-02-24,Airport,571,1,14,586,480,9,22,511,Wednesday
2021-02-24,Hung Hom,0,0,0,0,0,0,0,0,Wednesday
2021-02-24,Lo Wu,0,0,0,0,0,0,0,0,Wednesday
2021-02-24,Lok Ma Chau Spur Line,0,0,0,0,0,0,0,0,Wednesday
2021-02-24,Heung Yuen Wai,0,0,0,0,0,0,0,0,Wednesday
2021-02-24,Hong Kong-Zhuhai-Macao Bridge,146,7,2,155,194,13,1,208,Wednesday
2021-02-24,Lok Ma Chau,0,0,0,0,0,0,0,0,Wednesday
2021-02-24,Man Kam To,0,0,0,0,0,0,0,0,Wednesday
2021-02-24,Sha Tau Kok,0,0,0,0,0,0,0,0,Wednesday
2021-02-24,Shenzhen Bay,1799,135,1,1935,805,90,5,900,Wednesday
2021-02-24,China Ferry Terminal,0,0,0,0,0,0,0,0,Wednesday
2021-02-24,Harbour Control,0,0,0,0,0,0,0,0,Wednesday
2021-02-24,Kai Tak Cruise Terminal,0,0,0,0,0,0,0,0,Wednesday
2021-02-24,Macau Ferry Terminal,0,0,0,0,0,0,0,0,Wednesday
2021-02-24,Tuen Mun Ferry Terminal,0,0,0,0,0,0,0,0,Wednesday
2021-02-24,Total,2516,143,17,2676,1479,112,28,1619,Wednesday
2021-02-25,Airport,418,1,28,447,646,1,82,729,Thursday
2021-02-25,Express Rail Link West Kowloon,0,0,0,0,0,0,0,0,Thursday
2021-02-25,Hung Hom,0,0,0,0,0,0,0,0,Thursday
2021-02-25,Lo Wu,0,0,0,0,0,0,0,0,Thursday
2021-02-25,Lok Ma Chau Spur Line,0,0,0,0,0,0,0,0,Thursday
2021-02-25,Heung Yuen Wai,0,0,0,0,0,0,0,0,Thursday
2021-02-25,Hong Kong-Zhuhai-Macao Bridge,129,6,47,182,119,4,0,123,Thursday
2021-02-25,Lok Ma Chau,0,0,0,0,0,0,0,0,Thursday
2021-02-25,Man Kam To,0,0,0,0,0,0,0,0,Thursday
2021-02-25,Sha Tau Kok,0,0,0,0,0,0,0,0,Thursday
2021-02-25,Shenzhen Bay,1503,129,0,1632,591,47,0,638,Thursday
2021-02-25,China Ferry Terminal,0,0,0,0,0,0,0,0,Thursday
2021-02-25,Harbour Control,0,0,0,0,0,0,0,0,Thursday
2021-02-25,Kai Tak Cruise Terminal,0,0,0,0,0,0,0,0,Thursday
2021-02-25,Macau Ferry Terminal,0,0,0,0,0,0,0,0,Thursday
2021-02-25,Tuen Mun Ferry Terminal,0,0,0,0,0,0,0,0,Thursday
2021-02-25,Total,2050,136,75,2261,1356,52,82,1490,Thursday
2021-02-26,Airport,457,2,19,478,627,8,35,670,Friday
2021-02-26,Hung Hom,0,0,0,0,0,0,0,0,Friday
2021-02-26,Lo Wu,0,0,0,0,0,0,0,0,Friday
2021-02-26,Lok Ma Chau Spur Line,0,0,0,0,0,0,0,0,Friday
2021-02-26,Heung Yuen Wai,0,0,0,0,0,0,0,0,Friday
2021-02-26,Hong Kong-Zhuhai-Macao Bridge,119,1,5,125,145,7,2,154,Friday
2021-02-26,Lok Ma Chau,0,0,0,0,0,0,0,0,Friday
2021-02-26,Man Kam To,0,0,0,0,0,0,0,0,Friday
2021-02-26,Sha Tau Kok,0,0,0,0,0,0,0,0,Friday
2021-02-26,Shenzhen Bay,1444,119,0,1563,460,62,2,524,Friday
2021-02-26,China Ferry Terminal,0,0,0,0,0,0,0,0,Friday
2021-02-26,Harbour Control,0,0,0,0,0,0,0,0,Friday
2021-02-26,Kai Tak Cruise Terminal,0,0,0,0,0,0,0,0,Friday
2021-02-26,Macau Ferry Terminal,0,0,0,0,0,0,0,0,Friday
2021-02-26,Tuen Mun Ferry Terminal,0,0,0,0,0,0,0,0,Friday
2021-02-26,Total,2020,122,24,2166,1232,77,39,1348,Friday
2021-02-27,Airport,450,5,11,466,637,13,17,667,Saturday
2021-02-27,Express Rail Link West Kowloon,0,0,0,0,0,0,0,0,Saturday
2021-02-27,Hung Hom,0,0,0,0,0,0,0,0,Saturday
2021-02-27,Lo Wu,0,0,0,0,0,0,0,0,Saturday
2021-02-27,Lok Ma Chau Spur Line,0,0,0,0,0,0,0,0,Saturday
2021-02-27,Heung Yuen Wai,0,0,0,0,0,0,0,0,Saturday
2021-02-27,Hong Kong-Zhuhai-Macao Bridge,263,12,2,277,149,15,2,166,Saturday
2021-02-27,Lok Ma Chau,0,0,0,0,0,0,0,0,Saturday
2021-02-27,Man Kam To,0,0,0,0,0,0,0,0,Saturday
2021-02-27,Sha Tau Kok,0,0,0,0,0,0,0,0,Saturday
2021-02-27,Shenzhen Bay,3215,265,4,3484,879,96,1,976,Saturday
2021-02-27,China Ferry Terminal,0,0,0,0,0,0,0,0,Saturday
2021-02-27,Harbour Control,0,0,0,0,0,0,0,0,Saturday
2021-02-27,Macau Ferry Terminal,0,0,0,0,0,0,0,0,Saturday
2021-02-27,Tuen Mun Ferry Terminal,0,0,0,0,0,0,0,0,Saturday
2021-02-27,Total,3928,282,17,4227,1665,124,20,1809,Saturday
2021-02-28,Airport,807,9,17,833,1061,31,42,1134,Sunday
2021-02-28,Express Rail Link West Kowloon,0,0,0,0,0,0,0,0,Sunday
2021-02-28,Hung Hom,0,0,0,0,0,0,0,0,Sunday
2021-02-28,Lo Wu,0,0,0,0,0,0,0,0,Sunday
2021-02-28,Lok Ma Chau Spur Line,0,0,0,0,0,0,0,0,Sunday
2021-02-28,Heung Yuen Wai,0,0,0,0,0,0,0,0,Sunday
2021-02-28,Hong Kong-Zhuhai-Macao Bridge,410,22,2,434,129,15,3,147,Sunday
2021-02-28,Lok Ma Chau,0,0,0,0,0,0,0,0,Sunday
2021-02-28,Sha Tau Kok,0,0,0,0,0,0,0,0,Sunday
2021-02-28,Shenzhen Bay,3596,249,2,3847,674,121,1,796,Sunday
2021-02-28,China Ferry Terminal,0,0,0,0,0,0,0,0,Sunday
2021-02-28,Harbour Control,0,0,0,0,0,0,0,0,Sunday
2021-02-28,Macau Ferry Terminal,0,0,0,0,0,0,0,0,Sunday
2021-02-28,Tuen Mun Ferry Terminal,0,0,0,0,0,0,0,0,Sunday
2021-02-28,Total,4813,280,21,5114,1864,167,46,2077,Sunday
2021-03-01,Airport,317,3,14,334,790,17,18,825,Monday
2021-03-01,Express Rail Link West Kowloon,0,0,0,0,0,0,0,0,Monday
2021-03-01,Hung Hom,0,0,0,0,0,0,0,0,Monday
2021-03-01,Lo Wu,0,0,0,0,0,0,0,0,Monday
2021-03-01,Lok Ma Chau Spur Line,0,0,0,0,0,0,0,0,Monday
2021-03-01,Heung Yuen Wai,0,0,0,0,0,0,0,0,Monday
2021-03-01,Hong Kong-Zhuhai-Macao Bridge,174,3,1,178,188,8,0,196,Monday
2021-03-01,Lok Ma Chau,0,0,0,0,0,0,0,0,Monday
2021-03-01,Man Kam To,0,0,0,0,0,0,0,0,Monday
2021-03-01,Sha Tau Kok,0,0,0,0,0,0,0,0,Monday
2021-03-01,Shenzhen Bay,3093,210,3,3306,1096,58,2,1156,Monday
2021-03-01,China Ferry Terminal,0,0,0,0,0,0,0,0,Monday
2021-03-01,Harbour Control,0,0,0,0,0,0,0,0,Monday
2021-03-01,Kai Tak Cruise Terminal,0,0,0,0,0,0,0,0,Monday
2021-03-01,Macau Ferry Terminal,0,0,0,0,0,0,0,0,Monday
2021-03-01,Tuen Mun Ferry Terminal,0,0,0,0,0,0,0,0,Monday
2021-03-01,Total,3584,216,18,3818,2074,83,20,2177,Monday
2021-03-02,Airport,350,4,10,364,760,12,30,802,Tuesday
2021-03-02,Hung Hom,0,0,0,0,0,0,0,0,Tuesday
2021-03-02,Lo Wu,0,0,0,0,0,0,0,0,Tuesday
2021-03-02,Lok Ma Chau Spur Line,0,0,0,0,0,0,0,0,Tuesday
2021-03-02,Heung Yuen Wai,0,0,0,0,0,0,0,0,Tuesday
2021-03-02,Hong Kong-Zhuhai-Macao Bridge,144,3,2,149,211,11,3,225,Tuesday
2021-03-02,Lok Ma Chau,0,0,0,0,0,0,0,0,Tuesday
2021-03-02,Man Kam To,0,0,0,0,0,0,0,0,Tuesday
2021-03-02,Sha Tau Kok,0,0,0,0,0,0,0,0,Tuesday
2021-03-02,Shenzhen Bay,2022,176,1,2199,1165,92,5,1262,Tuesday
2021-03-02,China Ferry Terminal,0,0,0,0,0,0,0,0,Tuesday
2021-03-02,Harbour Control,0,0,0,0,0,0,0,0,Tuesday
2021-03-02,Kai Tak Cruise Terminal,0,0,0,0,0,0,0,0,Tuesday
2021-03-02,Macau Ferry Terminal,0,0,0,0,0,0,0,0,Tuesday
2021-03-02,Tuen Mun Ferry Terminal,0,0,0,0,0,0,0,0,Tuesday
2021-03-02,Total,2516,183,13,2712,2136,115,38,2289,Tuesday
2021-03-03,Airport,558,9,33,600,722,2,37,761,Wednesday
2021-03-03,Express Rail Link West Kowloon,0,0,0,0,0,0,0,0,Wednesday
2021-03-03,Hung Hom,0,0,0,0,0,0,0,0,Wednesday
2021-03-03,Lo Wu,0,0,0,0,0,0,0,0,Wednesday
2021-03-03,Lok Ma Chau Spur Line,0,0,0,0,0,0,0,0,Wednesday
2021-03-03,Heung Yuen Wai,0,0,0,0,0,0,0,0,Wednesday
2021-03-03,Hong Kong-Zhuhai-Macao Bridge,151,11,0,162,183,10,4,197,Wednesday
2021-03-03,Lok Ma Chau,0,0,0,0,0,0,0,0,Wednesday
2021-03-03,Man Kam To,0,0,0,0,0,0,0,0,Wednesday
2021-03-03,Sha Tau Kok,0,0,0,0,0,0,0,0,Wednesday
2021-03-03,Shenzhen Bay,1875,162,3,2040,715,104,0,819,Wednesday
2021-03-03,China Ferry Terminal,0,0,0,0,0,0,0,0,Wednesday
2021-03-03,Harbour Control,0,0,0,0,0,0,0,0,Wednesday
2021-03-03,Macau Ferry Terminal,0,0,0,0,0,0,0,0,Wednesday
2021-03-03,Tuen Mun Ferry Terminal,0,0,0,0,0,0,0,0,Wednesday
2021-03-03,Total,2584,182,36,2802,1620,116,41,1777,Wednesday
2021-03-04,Airport,418,2,42,462,675,9,38,722,Thursday
2021-03-04,Express Rail Link West Kowloon,0,0,0,0,0,0,0,0,Thursday
2021-03-04,Hung Hom,0,0,0,0,0,0,0,0,Thursday
2021-03-04,Lo Wu,0,0,0,0,0,0,0,0,Thursday
2021-03-04,Lok Ma Chau Spur Line,0,0,0,0,0,0,0,0,Thursday
2021-03-04,Heung Yuen Wai,0,0,0,0,0,0,0,0,Thursday
2021-03-04,Hong Kong-Zhuhai-Macao Bridge,106,7,2,115,116,8,0,124,Thursday
2021-03-04,Lok Ma Chau,0,0,0,0,0,0,0,0,Thursday
2021-03-04,Man Kam To,0,0,0,0,0,0,0,0,Thursday
2021-03-04,Sha Tau Kok,0,0,0,0,0,0,0,0,Thursday
2021-03-04,Shenzhen Bay,1387,154,3,1544,587,75,1,663,Thursday
2021-03-04,China Ferry Terminal,0,0,0,0,0,0,0,0,Thursday
2021-03-04,Harbour Control,0,0,0,0,0,0,0,0,Thursday
2021-03-04,Kai Tak Cruise Terminal,0,0,0,0,0,0,0,0,Thursday
2021-03-04,Macau Ferry Terminal,0,0,0,0,0,0,0,0,Thursday
2021-03-04,Tuen Mun Ferry Terminal,0,0,0,0,0,0,0,0,Thursday
2021-03-04,Total,1911,163,47,2121,1378,92,39,1509,Thursday
2021-03-05,Airport,465,2,25,492,714,13,26,753,Friday
2021-03-05,Express Rail Link West Kowloon,0,0,0,0,0,0,0,0,Friday
2021-03-05,Hung Hom,0,0,0,0,0,0,0,0,Friday
2021-03-05,Lo Wu,0,0,0,0,0,0,0,0,Friday
2021-03-05,Lok Ma Chau Spur Line,0,0,0,0,0,0,0,0,Friday
2021-03-05,Heung Yuen Wai,0,0,0,0,0,0,0,0,Friday
2021-03-05,Lok Ma Chau,0,0,0,0,0,0,0,0,Friday
2021-03-05,Man Kam To,0,0,0,0,0,0,0,0,Friday
2021-03-05,Sha Tau Kok,0,0,0,0,0,0,0,0,Friday
2021-03-05,Shenzhen Bay,1507,138,3,1648,650,86,4,740,Friday
2021-03-05,China Ferry Terminal,0,0,0,0,0,0,0,0,Friday
2021-03-05,Harbour Control,0,0,0,0,0,0,0,0,Friday
2021-03-05,Kai Tak Cruise Terminal,0,0,0,0,0,0,0,0,Friday
2021-03-05,Macau Ferry Terminal,0,0,0,0,0,0,0,0,Friday
2021-03-05,Tuen Mun Ferry Terminal,0,0,0,0,0,0,0,0,Friday
2021-03-06,Airport,347,13,7,367,776,43,28,847,Saturday
2021-03-06,Hung Hom,0,0,0,0,0,0,0,0,Saturday
2021-03-06,Lo Wu,0,0,0,0,0,0,0,0,Saturday
2021-03-06,Lok Ma Chau Spur Line,0,0,0,0,0,0,0,0,Saturday
2021-03-06,Heung Yuen Wai,0,0,0,0,0,0,0,0,Saturday
2021-03-06,Hong Kong-Zhuhai-Macao Bridge,159,4,1,164,134,9,1,144,Saturday
2021-03-06,Lok Ma Chau,0,0,0,0,0,0,0,0,Saturday
2021-03-06,Man Kam To,0,0,0,0,0,0,0,0,Saturday
2021-03-06,Sha Tau Kok,0,0,0,0,0,0,0,0,Saturday
2021-03-06,Shenzhen Bay,1913,184,0,2097,667,68,0,735,Saturday
2021-03-06,China Ferry Terminal,0,0,0,0,0,0,0,0,Saturday
2021-03-06,Harbour Control,0,0,0,0,0,0,0,0,Saturday
2021-03-06,Kai Tak Cruise Terminal,0,0,0,0,0,0,0,0,Saturday
2021-03-06,Macau Ferry Terminal,0,0,0,0,0,0,0,0,Saturday
2021-03-06,Tuen Mun Ferry Terminal,0,0,0,0,0,0,0,0,Saturday
2021-03-06,Total,2419,201,8,2628,1577,120,29,1726,Saturday
2021-03-07,Airport,555,5,21,581,725,2,30,757,Sunday
2021-03-07,Express Rail Link West Kowloon,0,0,0,0,0,0,0,0,Sunday
2021-03-07,Hung Hom,0,0,0,0,0,0,0,0,Sunday
2021-03-07,Lo Wu,0,0,0,0,0,0,0,0,Sunday
2021-03-07,Lok Ma Chau Spur Line,0,0,0,0,0,0,0,0,Sunday
2021-03-07,Heung Yuen Wai,0,0,0,0,0,0,0,0,Sunday
2021-03-07,Hong Kong-Zhuhai-Macao Bridge,209,9,0,218,99,8,0,107,Sunday
2021-03-07,Lok Ma Chau,0,0,0,0,0,0,0,0,Sunday
2021-03-07,Man Kam To,0,0,0,0,0,0,0,0,Sunday
2021-03-07,Sha Tau Kok,0,0,0,0,0,0,0,0,Sunday
2021-03-07,Shenzhen Bay,2709,252,0,2961,483,89,2,574,Sunday
2021-03-07,China Ferry Terminal,0,0,0,0,0,0,0,0,Sunday
2021-03-07,Harbour Control,0,0,0,0,0,0,0,0,Sunday
2021-03-07,Macau Ferry Terminal,0,0,0,0,0,0,0,0,Sunday
2021-03-07,Tuen Mun Ferry Terminal,0,0,0,0,0,0,0,0,Sunday
2021-03-07,Total,3473,266,21,3760,1307,99,32,1438,Sunday
2021-03-08,Airport,149,0,11,160,575,7,20,602,Monday
2021-03-08,Express Rail Link West Kowloon,0,0,0,0,0,0,0,0,Monday
2021-03-08,Hung Hom,0,0,0,0,0,0,0,0,Monday
2021-03-08,Lo Wu,0,0,0,0,0,0,0,0,Monday
2021-03-08,Lok Ma Chau Spur Line,0,0,0,0,0,0,0,0,Monday
2021-03-08,Heung Yuen Wai,0,0,0,0,0,0,0,0,Monday
2021-03-08,Hong Kong-Zhuhai-Macao Bridge,106,3,3,112,142,3,2,147,Monday
2021-03-08,Lok Ma Chau,0,0,0,0,0,0,0,0,Monday
2021-03-08,Man Kam To,0,0,0,0,0,0,0,0,Monday
2021-03-08,Sha Tau Kok,0,0,0,0,0,0,0,0,Monday
2021-03-08,Shenzhen Bay,1470,147,5,1622,732,61,1,794,Monday
2021-03-08,China Ferry Terminal,0,0,0,0,0,0,0,0,Monday
2021-03-08,Harbour Control,0,0,0,0,0,0,0,0,Monday
2021-03-08,Kai Tak Cruise Terminal,0,0,0,0,0,0,0,0,Monday
2021-03-08,Macau Ferry Terminal,0,0,0,0,0,0,0,0,Monday
2021-03-08,Tuen Mun Ferry Terminal,0,0,0,0,0,0,0,0,Monday
2021-03-08,Total,1725,150,19,1894,1449,71,23,1543,Monday
2021-03-09,Airport,483,6,15,504,729,10,14,753,Tuesday
2021-03-09,Hung Hom,0,0,0,0,0,0,0,0,Tuesday
2021-03-09,Lo Wu,0,0,0,0,0,0,0,0,Tuesday
2021-03-09,Lok Ma Chau Spur Line,0,0,0,0,0,0,0,0,Tuesday
2021-03-09,Heung Yuen Wai,0,0,0,0,0,0,0,0,Tuesday
2021-03-09,Hong Kong-Zhuhai-Macao Bridge,79,2,1,82,164,14,2,180,Tuesday
2021-03-09,Lok Ma Chau,0,0,0,0,0,0,0,0,Tuesday
2021-03-09,Man Kam To,0,0,0,0,0,0,0,0,Tuesday
2021-03-09,Sha Tau Kok,0,0,0,0,0,0,0,0,Tuesday
2021-03-09,Shenzhen Bay,1229,107,0,1336,749,118,0,867,Tuesday
2021-03-09,China Ferry Terminal,0,0,0,0,0,0,0,0,Tuesday
2021-03-09,Harbour Control,0,0,0,0,0,0,0,0,Tuesday
2021-03-09,Kai Tak Cruise Terminal,0,0,0,0,0,0,0,0,Tuesday
2021-03-09,Macau Ferry Terminal,0,0,0,0,0,0,0,0,Tuesday
2021-03-09,Tuen Mun Ferry Terminal,0,0,0,0,0,0,0,0,Tuesday
2021-03-09,Total,1791,115,16,1922,1642,142,16,1800,Tuesday
2021-03-10,Airport,679,2,22,703,854,3,68,925,Wednesday
2021-03-10,Express Rail Link West Kowloon,0,0,0,0,0,0,0,0,Wednesday
2021-03-10,Hung Hom,0,0,0,0,0,0,0,0,Wednesday
2021-03-10,Lo Wu,0,0,0,0,0,0,0,0,Wednesday
2021-03-10,Lok Ma Chau Spur Line,0,0,0,0,0,0,0,0,Wednesday
2021-03-10,Heung Yuen Wai,0,0,0,0,0,0,0,0,Wednesday
2021-03-10,Hong Kong-Zhuhai-Macao Bridge,133,6,28,167,156,10,4,170,Wednesday
2021-03-10,Lok Ma Chau,0,0,0,0,0,0,0,0,Wednesday
2021-03-10,Man Kam To,0,0,0,0,0,0,0,0,Wednesday
2021-03-10,Sha Tau Kok,0,0,0,0,0,0,0,0,Wednesday
2021-03-10,Shenzhen Bay,1500,145,0,1645,796,106,2,904,Wednesday
2021-03-10,China Ferry Terminal,0,0,0,0,0,0,0,0,Wednesday
2021-03-10,Harbour Control,0,0,0,0,0,0,0,0,Wednesday
2021-03-10,Macau Ferry Terminal,0,0,0,0,0,0,0,0,Wednesday
2021-03-10,Tuen Mun Ferry Terminal,0,0,0,0,0,0,0,0,Wednesday
2021-03-10,Total,2312,153,50,2515,1806,119,74,1999,Wednesday
2021-03-11,Airport,346,2,11,359,578,2,16,596,Thursday
2021-03-11,Express Rail Link West Kowloon,0,0,0,0,0,0,0,0,Thursday
2021-03-11,Hung Hom,0,0,0,0,0,0,0,0,Thursday
2021-03-11,Lo Wu,0,0,0,0,0,0,0,0,Thursday
2021-03-11,Lok Ma Chau Spur Line,0,0,0,0,0,0,0,0,Thursday
2021-03-11,Heung Yuen Wai,0,0,0,0,0,0,0,0,Thursday
2021-03-11,Hong Kong-Zhuhai-Macao Bridge,89,4,1,94,132,9,0,141,Thursday
2021-03-11,Man Kam To,0,0,0,0,0,0,0,0,Thursday
2021-03-11,Sha Tau Kok,0,0,0,0,0,0,0,0,Thursday
2021-03-11,China Ferry Terminal,0,0,0,0,0,0,0,0,Thursday
2021-03-11,Harbour Control,0,0,0,0,0,0,0,0,Thursday
2021-03-11,Kai Tak Cruise Terminal,0,0,0,0,0,0,0,0,Thursday
2021-03-11,Macau Ferry Terminal,0,0,0,0,0,0,0,0,Thursday
2021-03-11,Tuen Mun Ferry Terminal,0,0,0,0,0,0,0,0,Thursday
2021-03-11,Total,1567,122,13,1702,1299,88,17,1404,Thursday
2021-03-12,Airport,512,5,20,537,658,16,32,706,Friday
2021-03-12,Express Rail Link West Kowloon,0,0,0,0,0,0,0,0,Friday
2021-03-12,Hung Hom,0,0,0,0,0,0,0,0,Friday
2021-03-12,Lo Wu,0,0,0,0,0,0,0,0,Friday
2021-03-12,Lok Ma Chau Spur Line,0,0,0,0,0,0,0,0,Friday
2021-03-12,Heung Yuen Wai,0,0,0,0,0,0,0,0,Friday
2021-03-12,Lok Ma Chau,0,0,0,0,0,0,0,0,Friday
2021-03-12,Man Kam To,0,0,0,0,0,0,0,0,Friday
2021-03-12,Sha Tau Kok,0,0,0,0,0,0,0,0,Friday
2021-03-12,Shenzhen Bay,1060,133,2,1195,632,86,1,719,Friday
2021-03-12,China Ferry Terminal,0,0,0,0,0,0,0,0,Friday
2021-03-12,Harbour Control,0,0,0,0,0,0,0,0,Friday
2021-03-12,Kai Tak Cruise Terminal,0,0,0,0,0,0,0,0,Friday
2021-03-12,Macau Ferry Terminal,0,0,0,0,0,0,0,0,Friday
2021-03-12,Tuen Mun Ferry Terminal,0,0,0,0,0,0,0,0,Friday
2021-03-12,Total,1647,142,24,1813,1404,112,36,1552,Friday
2021-03-13,Airport,521,8,9,538,713,42,20,775,Saturday
2021-03-13,Express Rail Link West Kowloon,0,0,0,0,0,0,0,0,Saturday
2021-03-13,Hung Hom,0,0,0,0,0,0,0,0,Saturday
2021-03-13,Lo Wu,0,0,0,0,0,0,0,0,Saturday
2021-03-13,Lok Ma Chau Spur Line,0,0,0,0,0,0,0,0,Saturday
2021-03-13,Heung Yuen Wai,0,0,0,0,0,0,0,0,Saturday
2021-03-13,Hong Kong-Zhuhai-Macao Bridge,112,7,0,119,88,14,1,103,Saturday
2021-03-13,Lok Ma Chau,0,0,0,0,0,0,0,0,Saturday
2021-03-13,Man Kam To,0,0,0,0,0,0,0,0,Saturday
2021-03-13,Sha Tau Kok,0,0,0,0,0,0,0,0,Saturday
2021-03-13,Shenzhen Bay,1203,142,1,1346,663,84,1,748,Saturday
2021-03-13,China Ferry Terminal,0,0,0,0,0,0,0,0,Saturday
2021-03-13,Harbour Control,0,0,0,0,0,0,0,0,Saturday
2021-03-13,Kai Tak Cruise Terminal,0,0,0,0,0,0,0,0,Saturday
2021-03-13,Macau Ferry Terminal,0,0,0,0,0,0,0,0,Saturday
2021-03-13,Tuen Mun Ferry Terminal,0,0,0,0,0,0,0,0,Saturday
2021-03-13,Total,1836,157,10,2003,1464,140,22,1626,Saturday
2021-03-14,Airport,522,0,31,553,745,4,32,781,Sunday
2021-03-14,Hung Hom,0,0,0,0,0,0,0,0,Sunday
2021-03-14,Lo Wu,0,0,0,0,0,0,0,0,Sunday
2021-03-14,Lok Ma Chau Spur Line,0,0,0,0,0,0,0,0,Sunday
2021-03-14,Heung Yuen Wai,0,0,0,0,0,0,0,0,Sunday
2021-03-14,Hong Kong-Zhuhai-Macao Bridge,159,10,0,169,76,6,2,84,Sunday
2021-03-14,Lok Ma Chau,0,0,0,0,0,0,0,0,Sunday
2021-03-14,Man Kam To,0,0,0,0,0,0,0,0,Sunday
2021-03-14,Sha Tau Kok,0,0,0,0,0,0,0,0,Sunday
2021-03-14,Shenzhen Bay,1728,162,1,1891,395,79,1,475,Sunday
2021-03-14,China Ferry Terminal,0,0,0,0,0,0,0,0,Sunday
2021-03-14,Harbour Control,0,0,0,0,0,0,0,0,Sunday
2021-03-14,Kai Tak Cruise Terminal,0,0,0,0,0,0,0,0,Sunday
2021-03-14,Macau Ferry Terminal,0,0,0,0,0,0,0,0,Sunday
2021-03-14,Tuen Mun Ferry Terminal,0,0,0,0,0,0,0,0,Sunday
2021-03-14,Total,2409,172,32,2613,1216,89,35,1340,Sunday
2021-03-15,Airport,243,2,19,264,574,4,18,596,Monday
2021-03-15,Express Rail Link West Kowloon,0,0,0,0,0,0,0,0,Monday
2021-03-15,Hung Hom,0,0,0,0,0,0,0,0,Monday
2021-03-15,Lo Wu,0,0,0,0,0,0,0,0,Monday
2021-03-15,Lok Ma Chau Spur Line,0,0,0,0,0,0,0,0,Monday
2021-03-15,Heung Yuen Wai,0,0,0,0,0,0,0,0,Monday
2021-03-15,Hong Kong-Zhuhai-Macao Bridge,88,1,4,93,95,5,1,101,Monday
2021-03-15,Lok Ma Chau,0,0,0,0,0,0,0,0,Monday
2021-03-15,Man Kam To,0,0,0,0,0,0,0,0,Monday
2021-03-15,Sha Tau Kok,0,0,0,0,0,0,0,0,Monday
2021-03-15,Shenzhen Bay,1199,141,5,1345,609,72,2,683,Monday
2021-03-15,China Ferry Terminal,0,0,0,0,0,0,0,0,Monday
2021-03-15,Harbour Control,0,0,0,0,0,0,0,0,Monday
2021-03-15,Kai Tak Cruise Terminal,0,0,0,0,0,0,0,0,Monday
2021-03-15,Macau Ferry Terminal,0,0,0,0,0,0,0,0,Monday
2021-03-15,Total,1530,144,28,1702,1278,81,21,1380,Monday
2021-03-16,Airport,460,0,3,463,844,19,34,897,Tuesday
2021-03-16,Express Rail Link West Kowloon,0,0,0,0,0,0,0,0,Tuesday
2021-03-16,Hung Hom,0,0,0,0,0,0,0,0,Tuesday
2021-03-16,Lo Wu,0,0,0,0,0,0,0,0,Tuesday
2021-03-16,Lok Ma Chau Spur Line,0,0,0,0,0,0,0,0,Tuesday
2021-03-16,Heung Yuen Wai,0,0,0,0,0,0,0,0,Tuesday
2021-03-16,Hong Kong-Zhuhai-Macao Bridge,89,5,0,94,149,13,0,162,Tuesday
2021-03-16,Lok Ma Chau,0,0,0,0,0,0,0,0,Tuesday
2021-03-16,Man Kam To,0,0,0,0,0,0,0,0,Tuesday
2021-03-16,Sha Tau Kok,0,0,0,0,0,0,0,0,Tuesday
2021-03-16,Shenzhen Bay,1085,142,1,1228,767,91,1,859,Tuesday
2021-03-16,China Ferry Terminal,0,0,0,0,0,0,0,0,Tuesday
2021-03-16,Harbour Control,0,0,0,0,0,0,0,0,Tuesday
2021-03-16,Kai Tak Cruise Terminal,0,0,0,0,0,0,0,0,Tuesday
2021-03-16,Macau Ferry Terminal,0,0,0,0,0,0,0,0,Tuesday
2021-03-16,Tuen Mun Ferry Terminal,0,0,0,0,0,0,0,0,Tuesday
2021-03-17,Airport,494,11,14,519,544,5,30,579,Wednesday
2021-03-17,Hung Hom,0,0,0,0,0,0,0,0,Wednesday
2021-03-17,Lo Wu,0,0,0,0,0,0,0,0,Wednesday
2021-03-17,Lok Ma Chau Spur Line,0,0,0,0,0,0,0,0,Wednesday
2021-03-17,Heung Yuen Wai,0,0,0,0,0,0,0,0,Wednesday
2021-03-17,Hong Kong-Zhuhai-Macao Bridge,94,3,3,100,101,12,0,113,Wednesday
2021-03-17,Lok Ma Chau,0,0,0,0,0,0,0,0,Wednesday
2021-03-17,Man Kam To,0,0,0,0,0,0,0,0,Wednesday
2021-03-17,Sha Tau Kok,0,0,0,0,0,0,0,0,Wednesday
2021-03-17,Shenzhen Bay,1024,110,1,1135,779,116,13,908,Wednesday
2021-03-17,China Ferry Terminal,0,0,0,0,0,0,0,0,Wednesday
2021-03-17,Harbour Control,0,0,0,0,0,0,0,0,Wednesday
2021-03-17,Kai Tak Cruise Terminal,0,0,0,0,0,0,0,0,Wednesday
2021-03-17,Macau Ferry Terminal,0,0,0,0,0,0,0,0,Wednesday
2021-03-17,Tuen Mun Ferry Terminal,0,0,0,0,0,0,0,0,Wednesday
2021-03-17,Total,1612,124,18,1754,1424,133,43,1600,Wednesday
2021-03-18,Airport,253,4,18,275,573,10,51,634,Thursday
2021-03-18,Express Rail Link West Kowloon,0,0,0,0,0,0,0,0,Thursday
2021-03-18,Hung Hom,0,0,0,0,0,0,0,0,Thursday
2021-03-18,Lo Wu,0,0,0,0,0,0,0,0,Thursday
2021-03-18,Lok Ma Chau Spur Line,0,0,0,0,0,0,0,0,Thursday
2021-03-18,Heung Yuen Wai,0,0,0,0,0,0,0,0,Thursday
2021-03-18,Hong Kong-Zhuhai-Macao Bridge,93,2,3,98,119,10,0,129,Thursday
2021-03-18,Lok Ma Chau,0,0,0,0,0,0,0,0,Thursday
2021-03-18,Man Kam To,0,0,0,0,0,0,0,0,Thursday
2021-03-18,Sha Tau Kok,0,0,0,0,0,0,0,0,Thursday
2021-03-18,Shenzhen Bay,1004,133,2,1139,722,82,2,806,Thursday
2021-03-18,China Ferry Terminal,0,0,0,0,0,0,0,0,Thursday
2021-03-18,Harbour Control,0,0,0,0,0,0,0,0,Thursday
2021-03-18,Macau Ferry Terminal,0,0,0,0,0,0,0,0,Thursday
2021-03-18,Tuen Mun Ferry Terminal,0,0,0,0,0,0,0,0,Thursday
2021-03-18,Total,1350,139,23,1512,1414,102,53,1569,Thursday
2021-03-19,Airport,463,5,25,493,546,8,34,588,Friday
2021-03-19,Express Rail Link West Kowloon,0,0,0,0,0,0,0,0,Friday
2021-03-19,Hung Hom,0,0,0,0,0,0,0,0,Friday
2021-03-19,Lo Wu,0,0,0,0,0,0,0,0,Friday
2021-03-19,Lok Ma Chau Spur Line,0,0,0,0,0,0,0,0,Friday
2021-03-19,Heung Yuen Wai,0,0,0,0,0,0,0,0,Friday
2021-03-19,Hong Kong-Zhuhai-Macao Bridge,94,3,0,97,133,5,1,139,Friday
2021-03-19,Lok Ma Chau,0,0,0,0,0,0,0,0,Friday
2021-03-19,Man Kam To,0,0,0,0,0,0,0,0,Friday
2021-03-19,Sha Tau Kok,0,0,0,0,0,0,0,0,Friday
2021-03-19,Shenzhen Bay,760,82,5,847,683,92,5,780,Friday
2021-03-19,China Ferry Terminal,0,0,0,0,0,0,0,0,Friday
2021-03-19,Harbour Control,0,0,0,0,0,0,0,0,Friday
2021-03-19,Kai Tak Cruise Terminal,0,0,0,0,0,0,0,0,Friday
2021-03-19,Macau Ferry Terminal,0,0,0,0,0,0,0,0,Friday
2021-03-19,Tuen Mun Ferry Terminal,0,0,0,0,0,0,0,0,Friday
2021-03-19,Total,1317,90,30,1437,1362,105,40,1507,Friday
2021-03-20,Airport,444,7,9,460,646,41,19,706,Saturday
2021-03-20,Hung Hom,0,0,0,0,0,0,0,0,Saturday
2021-03-20,Lo Wu,0,0,0,0,0,0,0,0,Saturday
2021-03-20,Lok Ma Chau Spur Line,0,0,0,0,0,0,0,0,Saturday
2021-03-20,Heung Yuen Wai,0,0,0,0,0,0,0,0,Saturday
2021-03-20,Hong Kong-Zhuhai-Macao Bridge,90,9,4,103,102,9,4,115,Saturday
2021-03-20,Lok Ma Chau,0,0,0,0,0,0,0,0,Saturday
2021-03-20,Man Kam To,0,0,0,0,0,0,0,0,Saturday
2021-03-20,Sha Tau Kok,0,0,0,0,0,0,0,0,Saturday
2021-03-20,Shenzhen Bay,1098,161,0,1259,651,87,0,738,Saturday
2021-03-20,China Ferry Terminal,0,0,0,0,0,0,0,0,Saturday
2021-03-20,Harbour Control,0,0,0,0,0,0,0,0,Saturday
2021-03-20,Kai Tak Cruise Terminal,0,0,0,0,0,0,0,0,Saturday
2021-03-20,Macau Ferry Terminal,0,0,0,0,0,0,0,0,Saturday
2021-03-20,Tuen Mun Ferry Terminal,0,0,0,0,0,0,0,0,Saturday
2021-03-20,Total,1632,177,13,1822,1399,137,23,1559,Saturday
2021-03-21,Airport,461,3,13,477,774,13,30,817,Sunday
2021-03-21,Express Rail Link West Kowloon,0,0,0,0,0,0,0,0,Sunday
2021-03-21,Hung Hom,0,0,0,0,0,0,0,0,Sunday
2021-03-21,Lo Wu,0,0,0,0,0,0,0,0,Sunday
2021-03-21,Lok Ma Chau Spur Line,0,0,0,0,0,0,0,0,Sunday
2021-03-21,Heung Yuen Wai,0,0,0,0,0,0,0,0,Sunday
2021-03-21,Hong Kong-Zhuhai-Macao Bridge,98,5,2,105,86,18,0,104,Sunday
2021-03-21,Lok Ma Chau,0,0,0,0,0,0,0,0,Sunday
2021-03-21,Man Kam To,0,0,0,0,0,0,0,0,Sunday
2021-03-21,Sha Tau Kok,0,0,0,0,0,0,0,0,Sunday
2021-03-21,Shenzhen Bay,1332,124,1,1457,424,67,0,491,Sunday
2021-03-21,China Ferry Terminal,0,0,0,0,0,0,0,0,Sunday
2021-03-21,Harbour Control,0,0,0,0,0,0,0,0,Sunday
2021-03-21,Kai Tak Cruise Terminal,0,0,0,0,0,0,0,0,Sunday
2021-03-21,Macau Ferry Terminal,0,0,0,0,0,0,0,0,Sunday
2021-03-21,Tuen Mun Ferry Terminal,0,0,0,0,0,0,0,0,Sunday
2021-03-21,Total,1891,132,16,2039,1284,98,30,1412,Sunday
2021-03-22,Airport,264,2,10,276,447,3,30,480,Monday
2021-03-22,Hung Hom,0,0,0,0,0,0,0,0,Monday
2021-03-22,Lo Wu,0,0,0,0,0,0,0,0,Monday
2021-03-22,Lok Ma Chau Spur Line,0,0,0,0,0,0,0,0,Monday
2021-03-22,Heung Yuen Wai,0,0,0,0,0,0,0,0,Monday
2021-03-22,Hong Kong-Zhuhai-Macao Bridge,103,4,6,113,72,4,3,79,Monday
2021-03-22,Man Kam To,0,0,0,0,0,0,0,0,Monday
2021-03-22,Sha Tau Kok,0,0,0,0,0,0,0,0,Monday
2021-03-22,Shenzhen Bay,879,120,2,1001,534,90,4,628,Monday
2021-03-22,Harbour Control,0,0,0,0,0,0,0,0,Monday
2021-03-22,Kai Tak Cruise Terminal,0,0,0,0,0,0,0,0,Monday
2021-03-22,Macau Ferry Terminal,0,0,0,0,0,0,0,0,Monday
2021-03-22,Tuen Mun Ferry Terminal,0,0,0,0,0,0,0,0,Monday
2021-03-22,Total,1246,126,18,1390,1053,97,37,1187,Monday
2021-03-23,Airport,385,3,4,392,554,12,17,583,Tuesday
2021-03-23,Express Rail Link West Kowloon,0,0,0,0,0,0,0,0,Tuesday
2021-03-23,Hung Hom,0,0,0,0,0,0,0,0,Tuesday
2021-03-23,Lo Wu,0,0,0,0,0,0,0,0,Tuesday
2021-03-23,Lok Ma Chau Spur Line,0,0,0,0,0,0,0,0,Tuesday
2021-03-23,Heung Yuen Wai,0,0,0,0,0,0,0,0,Tuesday
2021-03-23,Hong Kong-Zhuhai-Macao Bridge,81,7,6,94,141,11,6,158,Tuesday
2021-03-23,Lok Ma Chau,0,0,0,0,0,0,0,0,Tuesday
2021-03-23,Man Kam To,0,0,0,0,0,0,0,0,Tuesday
2021-03-23,Sha Tau Kok,0,0,0,0,0,0,0,0,Tuesday
2021-03-23,Shenzhen Bay,882,92,3,977,608,109,0,717,Tuesday
2021-03-23,China Ferry Terminal,0,0,0,0,0,0,0,0,Tuesday
2021-03-23,Harbour Control,0,0,0,0,0,0,0,0,Tuesday
2021-03-23,Macau Ferry Terminal,0,0,0,0,0,0,0,0,Tuesday
2021-03-23,Tuen Mun Ferry Terminal,0,0,0,0,0,0,0,0,Tuesday
2021-03-23,Total,1348,102,13,1463,1303,132,23,1458,Tuesday
2021-03-24,Airport,395,2,22,419,415,6,20,441,Wednesday
2021-03-24,Express Rail Link West Kowloon,0,0,0,0,0,0,0,0,Wednesday
2021-03-24,Hung Hom,0,0,0,0,0,0,0,0,Wednesday
2021-03-24,Lo Wu,0,0,0,0,0,0,0,0,Wednesday
2021-03-24,Lok Ma Chau Spur Line,0,0,0,0,0,0,0,0,Wednesday
2021-03-24,Heung Yuen Wai,0,0,0,0,0,0,0,0,Wednesday
2021-03-24,Hong Kong-Zhuhai-Macao Bridge,85,7,4,96,110,14,4,128,Wednesday
2021-03-24,Lok Ma Chau,0,0,0,0,0,0,0,0,Wednesday
2021-03-24,Man Kam To,0,0,0,0,0,0,0,0,Wednesday
2021-03-24,Sha Tau Kok,0,0,0,0,0,0,0,0,Wednesday
2021-03-24,Shenzhen Bay,958,97,2,1057,541,78,2,621,Wednesday
2021-03-24,China Ferry Terminal,0,0,0,0,0,0,0,0,Wednesday
2021-03-24,Harbour Control,0,0,0,0,0,0,0,0,Wednesday
2021-03-24,Kai Tak Cruise Terminal,0,0,0,0,0,0,0,0,Wednesday
2021-03-24,Macau Ferry Terminal,0,0,0,0,0,0,0,0,Wednesday
2021-03-24,Tuen Mun Ferry Terminal,0,0,0,0,0,0,0,0,Wednesday
2021-03-24,Total,1438,106,28,1572,1066,98,26,1190,Wednesday
2021-03-25,Airport,368,1,18,387,607,2,31,640,Thursday
2021-03-25,Hung Hom,0,0,0,0,0,0,0,0,Thursday
2021-03-25,Lo Wu,0,0,0,0,0,0,0,0,Thursday
2021-03-25,Lok Ma Chau Spur Line,0,0,0,0,0,0,0,0,Thursday
2021-03-25,Heung Yuen Wai,0,0,0,0,0,0,0,0,Thursday
2021-03-25,Hong Kong-Zhuhai-Macao Bridge,100,5,0,105,69,11,2,82,Thursday
2021-03-25,Lok Ma Chau,0,0,0,0,0,0,0,0,Thursday
2021-03-25,Man Kam To,0,0,0,0,0,0,0,0,Thursday
2021-03-25,Sha Tau Kok,0,0,0,0,0,0,0,0,Thursday
2021-03-25,Shenzhen Bay,855,93,2,950,557,67,3,627,Thursday
2021-03-25,China Ferry Terminal,0,0,0,0,0,0,0,0,Thursday
2021-03-25,Harbour Control,0,0,0,0,0,0,0,0,Thursday
2021-03-25,Kai Tak Cruise Terminal,0,0,0,0,0,0,0,0,Thursday
2021-03-25,Macau Ferry Terminal,0,0,0,0,0,0,0,0,Thursday
2021-03-25,Tuen Mun Ferry Terminal,0,0,0,0,0,0,0,0,Thursday
2021-03-25,Total,1323,99,20,1442,1233,80,36,1349,Thursday
2021-03-26,Airport,476,3,26,505,757,1,27,785,Friday
2021-03-26,Express Rail Link West Kowloon,0,0,0,0,0,0,0,0,Friday
2021-03-26,Hung Hom,0,0,0,0,0,0,0,0,Friday
2021-03-26,Lo Wu,0,0,0,0,0,0,0,0,Friday
2021-03-26,Lok Ma Chau Spur Line,0,0,0,0,0,0,0,0,Friday
2021-03-26,Heung Yuen Wai,0,0,0,0,0,0,0,0,Friday
2021-03-26,Hong Kong-Zhuhai-Macao Bridge,97,2,2,101,82,3,3,88,Friday
2021-03-26,Lok Ma Chau,0,0,0,0,0,0,0,0,Friday
2021-03-26,Man Kam To,0,0,0,0,0,0,0,0,Friday
2021-03-26,Sha Tau Kok,0,0,0,0,0,0,0,0,Friday
2021-03-26,Shenzhen Bay,752,87,0,839,654,83,0,737,Friday
2021-03-26,China Ferry Terminal,0,0,0,0,0,0,0,0,Friday
2021-03-26,Harbour Control,0,0,0,0,0,0,0,0,Friday
2021-03-26,Kai Tak Cruise Terminal,0,0,0,0,0,0,0,0,Friday
2021-03-26,Macau Ferry Terminal,0,0,0,0,0,0,0,0,Friday
2021-03-26,Tuen Mun Ferry Terminal,0,0,0,0,0,0,0,0,Friday
2021-03-26,Total,1325,92,28,1445,1493,87,30,1610,Friday
2021-03-27,Airport,405,7,15,427,721,38,21,780,Saturday
2021-03-27,Hung Hom,0,0,0,0,0,0,0,0,Saturday
2021-03-27,Lo Wu,0,0,0,0,0,0,0,0,Saturday
2021-03-27,Lok Ma Chau Spur Line,0,0,0,0,0,0,0,0,Saturday
2021-03-27,Heung Yuen Wai,0,0,0,0,0,0,0,0,Saturday
2021-03-27,Hong Kong-Zhuhai-Macao Bridge,76,0,3,79,86,10,0,96,Saturday
2021-03-27,Lok Ma Chau,0,0,0,0,0,0,0,0,Saturday
2021-03-27,Man Kam To,0,0,0,0,0,0,0,0,Saturday
2021-03-27,Sha Tau Kok,0,0,0,0,0,0,0,0,Saturday
2021-03-27,Shenzhen Bay,831,104,1,936,674,77,2,753,Saturday
2021-03-27,China Ferry Terminal,0,0,0,0,0,0,0,0,Saturday
2021-03-27,Harbour Control,0,0,0,0,0,0,0,0,Saturday
2021-03-27,Kai Tak Cruise Terminal,0,0,0,0,0,0,0,0,Saturday
2021-03-27,Macau Ferry Terminal,0,0,0,0,0,0,0,0,Saturday
2021-03-27,Total,1312,111,19,1442,1481,125,23,1629,Saturday
2021-03-28,Airport,501,2,19,522,803,13,38,854,Sunday
2021-03-28,Express Rail Link West Kowloon,0,0,0,0,0,0,0,0,Sunday
2021-03-28,Hung Hom,0,0,0,0,0,0,0,0,Sunday
2021-03-28,Lo Wu,0,0,0,0,0,0,0,0,Sunday
2021-03-28,Lok Ma Chau Spur Line,0,0,0,0,0,0,0,0,Sunday
2021-03-28,Heung Yuen Wai,0,0,0,0,0,0,0,0,Sunday
2021-03-28,Hong Kong-Zhuhai-Macao Bridge,105,5,3,113,71,3,3,77,Sunday
2021-03-28,Lok Ma Chau,0,0,0,0,0,0,0,0,Sunday
2021-03-28,Man Kam To,0,0,0,0,0,0,0,0,Sunday
2021-03-28,Sha Tau Kok,0,0,0,0,0,0,0,0,Sunday
2021-03-28,Shenzhen Bay,1175,139,1,1315,490,78,1,569,Sunday
2021-03-28,China Ferry Terminal,0,0,0,0,0,0,0,0,Sunday
2021-03-28,Harbour Control,0,0,0,0,0,0,0,0,Sunday
2021-03-28,Macau Ferry Terminal,0,0,0,0,0,0,0,0,Sunday
2021-03-28,Tuen Mun Ferry Terminal,0,0,0,0,0,0,0,0,Sunday
2021-03-28,Total,1781,146,23,1950,1364,94,42,1500,Sunday
2021-03-29,Airport,152,1,7,160,421,4,9,434,Monday
2021-03-29,Express Rail Link West Kowloon,0,0,0,0,0,0,0,0,Monday
2021-03-29,Hung Hom,0,0,0,0,0,0,0,0,Monday
2021-03-29,Lo Wu,0,0,0,0,0,0,0,0,Monday
2021-03-29,Lok Ma Chau Spur Line,0,0,0,0,0,0,0,0,Monday
2021-03-29,Heung Yuen Wai,0,0,0,0,0,0,0,0,Monday
2021-03-29,Hong Kong-Zhuhai-Macao Bridge,79,5,4,88,44,2,0,46,Monday
2021-03-29,Lok Ma Chau,0,0,0,0,0,0,0,0,Monday
2021-03-29,Man Kam To,0,0,0,0,0,0,0,0,Monday
2021-03-29,Sha Tau Kok,0,0,0,0,0,0,0,0,Monday
2021-03-29,Shenzhen Bay,790,90,1,881,508,56,1,565,Monday
2021-03-29,China Ferry Terminal,0,0,0,0,0,0,0,0,Monday
2021-03-29,Harbour Control,0,0,0,0,0,0,0,0,Monday
2021-03-29,Kai Tak Cruise Terminal,0,0,0,0,0,0,0,0,Monday
2021-03-29,Macau Ferry Terminal,0,0,0,0,0,0,0,0,Monday
2021-03-29,Tuen Mun Ferry Terminal,0,0,0,0,0,0,0,0,Monday
2021-03-29,Total,1021,96,12,1129,973,62,10,1045,Monday
2021-03-30,Airport,332,7,5,344,808,8,21,837,Tuesday
2021-03-30,Hung Hom,0,0,0,0,0,0,0,0,Tuesday
2021-03-30,Lo Wu,0,0,0,0,0,0,0,0,Tuesday
2021-03-30,Lok Ma Chau Spur Line,0,0,0,0,0,0,0,0,Tuesday
2021-03-30,Heung Yuen Wai,0,0,0,0,0,0,0,0,Tuesday
2021-03-30,Hong Kong-Zhuhai-Macao Bridge,87,6,0,93,109,0,4,113,Tuesday
2021-03-30,Lok Ma Chau,0,0,0,0,0,0,0,0,Tuesday
2021-03-30,Man Kam To,0,0,0,0,0,0,0,0,Tuesday
2021-03-30,Sha Tau Kok,0,0,0,0,0,0,0,0,Tuesday
2021-03-30,Shenzhen Bay,885,97,1,983,676,83,2,761,Tuesday
2021-03-30,China Ferry Terminal,0,0,0,0,0,0,0,0,Tuesday
2021-03-30,Harbour Control,0,0,0,0,0,0,0,0,Tuesday
2021-03-30,Kai Tak Cruise Terminal,0,0,0,0,0,0,0,0,Tuesday
2021-03-30,Macau Ferry Terminal,0,0,0,0,0,0,0,0,Tuesday
2021-03-30,Tuen Mun Ferry Terminal,0,0,0,0,0,0,0,0,Tuesday
2021-03-30,Total,1304,110,6,1420,1593,91,27,1711,Tuesday
2021-03-31,Airport,620,5,20,645,571,9,24,604,Wednesday
2021-03-31,Express Rail Link West Kowloon,0,0,0,0,0,0,0,0,Wednesday
2021-03-31,Hung Hom,0,0,0,0,0,0,0,0,Wednesday
2021-03-31,Lo Wu,0,0,0,0,0,0,0,0,Wednesday
2021-03-31,Lok Ma Chau Spur Line,0,0,0,0,0,0,0,0,Wednesday
2021-03-31,Heung Yuen Wai,0,0,0,0,0,0,0,0,Wednesday
2021-03-31,Hong Kong-Zhuhai-Macao Bridge,110,9,5,124,109,12,2,123,Wednesday
2021-03-31,Lok Ma Chau,0,0,0,0,0,0,0,0,Wednesday
2021-03-31,Man Kam To,0,0,0,0,0,0,0,0,Wednesday
2021-03-31,Sha Tau Kok,0,0,0,0,0,0,0,0,Wednesday
2021-03-31,Shenzhen Bay,1037,115,2,1154,714,94,0,808,Wednesday
2021-03-31,China Ferry Terminal,0,0,0,0,0,0,0,0,Wednesday
2021-03-31,Harbour Control,0,0,0,0,0,0,0,0,Wednesday
2021-03-31,Macau Ferry Terminal,0,0,0,0,0,0,0,0,Wednesday
2021-03-31,Tuen Mun Ferry Terminal,0,0,0,0,0,0,0,0,Wednesday
2021-03-31,Total,1767,129,27,1923,1394,115,26,1535,Wednesday
2021-04-01,Airport,304,3,19,326,820,0,25,845,Thursday
2021-04-01,Express Rail Link West Kowloon,0,0,0,0,0,0,0,0,Thursday
2021-04-01,Hung Hom,0,0,0,0,0,0,0,0,Thursday
2021-04-01,Lo Wu,0,0,0,0,0,0,0,0,Thursday
2021-04-01,Lok Ma Chau Spur Line,0,0,0,0,0,0,0,0,Thursday
2021-04-01,Heung Yuen Wai,0,0,0,0,0,0,0,0,Thursday
2021-04-01,Hong Kong-Zhuhai-Macao Bridge,100,1,0,101,180,17,2,199,Thursday
2021-04-01,Lok Ma Chau,0,0,0,0,0,0,0,0,Thursday
2021-04-01,Man Kam To,0,0,0,0,0,0,0,0,Thursday
2021-04-01,Sha Tau Kok,0,0,0,0,0,0,0,0,Thursday
2021-04-01,Shenzhen Bay,852,82,3,937,1217,179,3,1399,Thursday
2021-04-01,China Ferry Terminal,0,0,0,0,0,0,0,0,Thursday
2021-04-01,Harbour Control,0,0,0,0,0,0,0,0,Thursday
2021-04-01,Kai Tak Cruise Terminal,0,0,0,0,0,0,0,0,Thursday
2021-04-01,Macau Ferry Terminal,0,0,0,0,0,0,0,0,Thursday
2021-04-01,Tuen Mun Ferry Terminal,0,0,0,0,0,0,0,0,Thursday
2021-04-01,Total,1256,86,22,1364,2217,196,30,2443,Thursday
2021-04-02,Airport,576,6,36,618,1050,14,41,1105,Friday
2021-04-02,Express Rail Link West Kowloon,0,0,0,0,0,0,0,0,Friday
2021-04-02,Hung Hom,0,0,0,0,0,0,0,0,Friday
2021-04-02,Lo Wu,0,0,0,0,0,0,0,0,Friday
2021-04-02,Lok Ma Chau Spur Line,0,0,0,0,0,0,0,0,Friday
2021-04-02,Heung Yuen Wai,0,0,0,0,0,0,0,0,Friday
2021-04-02,Lok Ma Chau,0,0,0,0,0,0,0,0,Friday
2021-04-02,Man Kam To,0,0,0,0,0,0,0,0,Friday
2021-04-02,Sha Tau Kok,0,0,0,0,0,0,0,0,Friday
2021-04-02,Shenzhen Bay,881,169,4,1054,1057,139,1,1197,Friday
2021-04-02,China Ferry Terminal,0,0,0,0,0,0,0,0,Friday
2021-04-02,Harbour Control,0,0,0,0,0,0,0,0,Friday
2021-04-02,Kai Tak Cruise Terminal,0,0,0,0,0,0,0,0,Friday
2021-04-02,Macau Ferry Terminal,0,0,0,0,0,0,0,0,Friday
2021-04-02,Tuen Mun Ferry Terminal,0,0,0,0,0,0,0,0,Friday
2021-04-02,Total,1547,178,44,1769,2244,169,43,2456,Friday
2021-04-03,Airport,289,4,9,302,494,25,7,526,Saturday
2021-04-03,Hung Hom,0,0,0,0,0,0,0,0,Saturday
2021-04-03,Lo Wu,0,0,0,0,0,0,0,0,Saturday
2021-04-03,Lok Ma Chau Spur Line,0,0,0,0,0,0,0,0,Saturday
2021-04-03,Heung Yuen Wai,0,0,0,0,0,0,0,0,Saturday
2021-04-03,Hong Kong-Zhuhai-Macao Bridge,56,2,4,62,98,7,0,105,Saturday
2021-04-03,Lok Ma Chau,0,0,0,0,0,0,0,0,Saturday
2021-04-03,Man Kam To,0,0,0,0,0,0,0,0,Saturday
2021-04-03,Sha Tau Kok,0,0,0,0,0,0,0,0,Saturday
2021-04-03,Shenzhen Bay,744,95,3,842,632,76,1,709,Saturday
2021-04-03,China Ferry Terminal,0,0,0,0,0,0,0,0,Saturday
2021-04-03,Harbour Control,0,0,0,0,0,0,0,0,Saturday
2021-04-03,Kai Tak Cruise Terminal,0,0,0,0,0,0,0,0,Saturday
2021-04-03,Macau Ferry Terminal,0,0,0,0,0,0,0,0,Saturday
2021-04-03,Tuen Mun Ferry Terminal,0,0,0,0,0,0,0,0,Saturday
2021-04-03,Total,1089,101,16,1206,1224,108,8,1340,Saturday
2021-04-04,Airport,525,3,22,550,616,6,18,640,Sunday
2021-04-04,Express Rail Link West Kowloon,0,0,0,0,0,0,0,0,Sunday
2021-04-04,Hung Hom,0,0,0,0,0,0,0,0,Sunday
2021-04-04,Lo Wu,0,0,0,0,0,0,0,0,Sunday
2021-04-04,Lok Ma Chau Spur Line,0,0,0,0,0,0,0,0,Sunday
2021-04-04,Heung Yuen Wai,0,0,0,0,0,0,0,0,Sunday
2021-04-04,Hong Kong-Zhuhai-Macao Bridge,79,3,1,83,55,6,2,63,Sunday
2021-04-04,Lok Ma Chau,0,0,0,0,0,0,0,0,Sunday
2021-04-04,Man Kam To,0,0,0,0,0,0,0,0,Sunday
2021-04-04,Sha Tau Kok,0,0,0,0,0,0,0,0,Sunday
2021-04-04,Shenzhen Bay,581,65,4,650,373,54,2,429,Sunday
2021-04-04,China Ferry Terminal,0,0,0,0,0,0,0,0,Sunday
2021-04-04,Harbour Control,0,0,0,0,0,0,0,0,Sunday
2021-04-04,Kai Tak Cruise Terminal,0,0,0,0,0,0,0,0,Sunday
2021-04-04,Macau Ferry Terminal,0,0,0,0,0,0,0,0,Sunday
2021-04-04,Tuen Mun Ferry Terminal,0,0,0,0,0,0,0,0,Sunday
2021-04-04,Total,1185,71,27,1283,1044,66,22,1132,Sunday
2021-04-05,Airport,208,4,5,217,722,13,22,757,Monday
2021-04-05,Hung Hom,0,0,0,0,0,0,0,0,Monday
2021-04-05,Lo Wu,0,0,0,0,0,0,0,0,Monday
2021-04-05,Lok Ma Chau Spur Line,0,0,0,0,0,0,0,0,Monday
2021-04-05,Heung Yuen Wai,0,0,0,0,0,0,0,0,Monday
2021-04-05,Hong Kong-Zhuhai-Macao Bridge,69,4,0,73,67,3,1,71,Monday
2021-04-05,Lok Ma Chau,0,0,0,0,0,0,0,0,Monday
2021-04-05,Man Kam To,0,0,0,0,0,0,0,0,Monday
2021-04-05,Sha Tau Kok,0,0,0,0,0,0,0,0,Monday
2021-04-05,Shenzhen Bay,831,113,1,945,528,55,2,585,Monday
2021-04-05,China Ferry Terminal,0,0,0,0,0,0,0,0,Monday
2021-04-05,Harbour Control,0,0,0,0,0,0,0,0,Monday
2021-04-05,Kai Tak Cruise Terminal,0,0,0,0,0,0,0,0,Monday
2021-04-05,Macau Ferry Terminal,0,0,0,0,0,0,0,0,Monday
2021-04-05,Tuen Mun Ferry Terminal,0,0,0,0,0,0,0,0,Monday
2021-04-05,Total,1108,121,6,1235,1317,71,25,1413,Monday
2021-04-06,Airport,357,1,12,370,550,14,21,585,Tuesday
2021-04-06,Express Rail Link West Kowloon,0,0,0,0,0,0,0,0,Tuesday
2021-04-06,Hung Hom,0,0,0,0,0,0,0,0,Tuesday
2021-04-06,Lo Wu,0,0,0,0,0,0,0,0,Tuesday
2021-04-06,Lok Ma Chau Spur Line,0,0,0,0,0,0,0,0,Tuesday
2021-04-06,Heung Yuen Wai,0,0,0,0,0,0,0,0,Tuesday
2021-04-06,Hong Kong-Zhuhai-Macao Bridge,137,3,4,144,78,6,2,86,Tuesday
2021-04-06,Lok Ma Chau,0,0,0,0,0,0,0,0,Tuesday
2021-04-06,Man Kam To,0,0,0,0,0,0,0,0,Tuesday
2021-04-06,Sha Tau Kok,0,0,0,0,0,0,0,0,Tuesday
2021-04-06,Shenzhen Bay,1474,151,2,1627,612,59,0,671,Tuesday
2021-04-06,China Ferry Terminal,0,0,0,0,0,0,0,0,Tuesday
2021-04-06,Harbour Control,0,0,0,0,0,0,0,0,Tuesday
2021-04-06,Macau Ferry Terminal,0,0,0,0,0,0,0,0,Tuesday
2021-04-06,Tuen Mun Ferry Terminal,0,0,0,0,0,0,0,0,Tuesday
2021-04-06,Total,1968,155,18,2141,1240,79,23,1342,Tuesday
2021-04-07,Airport,466,1,12,479,388,2,13,403,Wednesday
2021-04-07,Express Rail Link West Kowloon,0,0,0,0,0,0,0,0,Wednesday
2021-04-07,Hung Hom,0,0,0,0,0,0,0,0,Wednesday
2021-04-07,Lo Wu,0,0,0,0,0,0,0,0,Wednesday
2021-04-07,Lok Ma Chau Spur Line,0,0,0,0,0,0,0,0,Wednesday
2021-04-07,Heung Yuen Wai,0,0,0,0,0,0,0,0,Wednesday
2021-04-07,Hong Kong-Zhuhai-Macao Bridge,130,6,1,137,112,5,1,118,Wednesday
2021-04-07,Lok Ma Chau,0,0,0,0,0,0,0,0,Wednesday
2021-04-07,Man Kam To,0,0,0,0,0,0,0,0,Wednesday
2021-04-07,Sha Tau Kok,0,0,0,0,0,0,0,0,Wednesday
2021-04-07,Shenzhen Bay,1582,145,3,1730,604,56,1,661,Wednesday
2021-04-07,China Ferry Terminal,0,0,0,0,0,0,0,0,Wednesday
2021-04-07,Harbour Control,0,0,0,0,0,0,0,0,Wednesday
2021-04-07,Kai Tak Cruise Terminal,0,0,0,0,0,0,0,0,Wednesday
2021-04-07,Tuen Mun Ferry Terminal,0,0,0,0,0,0,0,0,Wednesday
2021-04-07,Total,2178,152,16,2346,1104,63,15,1182,Wednesday
2021-04-08,Airport,284,6,45,335,804,1,93,898,Thursday
2021-04-08,Hung Hom,0,0,0,0,0,0,0,0,Thursday
2021-04-08,Lo Wu,0,0,0,0,0,0,0,0,Thursday
2021-04-08,Lok Ma Chau Spur Line,0,0,0,0,0,0,0,0,Thursday
2021-04-08,Heung Yuen Wai,0,0,0,0,0,0,0,0,Thursday
2021-04-08,Hong Kong-Zhuhai-Macao Bridge,142,8,48,198,141,13,4,158,Thursday
2021-04-08,Lok Ma Chau,0,0,0,0,0,0,0,0,Thursday
2021-04-08,Man Kam To,0,0,0,0,0,0,0,0,Thursday
2021-04-08,Sha Tau Kok,0,0,0,0,0,0,0,0,Thursday
2021-04-08,Shenzhen Bay,1371,134,4,1509,783,88,2,873,Thursday
2021-04-08,China Ferry Terminal,0,0,0,0,0,0,0,0,Thursday
2021-04-08,Harbour Control,0,0,0,0,0,0,0,0,Thursday
2021-04-08,Kai Tak Cruise Terminal,0,0,0,0,0,0,0,0,Thursday
2021-04-08,Macau Ferry Terminal,0,0,0,0,0,0,0,0,Thursday
2021-04-08,Tuen Mun Ferry Terminal,0,0,0,0,0,0,0,0,Thursday
2021-04-08,Total,1797,148,97,2042,1728,102,99,1929,Thursday
2021-04-09,Airport,647,10,29,686,1190,8,43,1241,Friday
2021-04-09,Express Rail Link West Kowloon,0,0,0,0,0,0,0,0,Friday
2021-04-09,Hung Hom,0,0,0,0,0,0,0,0,Friday
2021-04-09,Lo Wu,0,0,0,0,0,0,0,0,Friday
2021-04-09,Lok Ma Chau Spur Line,0,0,0,0,0,0,0,0,Friday
2021-04-09,Heung Yuen Wai,0,0,0,0,0,0,0,0,Friday
2021-04-09,Hong Kong-Zhuhai-Macao Bridge,152,7,1,160,118,8,3,129,Friday
2021-04-09,Lok Ma Chau,0,0,0,0,0,0,0,0,Friday
2021-04-09,Man Kam To,0,0,0,0,0,0,0,0,Friday
2021-04-09,Sha Tau Kok,0,0,0,0,0,0,0,0,Friday
2021-04-09,Shenzhen Bay,1353,147,3,1503,750,91,0,841,Friday
2021-04-09,China Ferry Terminal,0,0,0,0,0,0,0,0,Friday
2021-04-09,Harbour Control,0,0,0,0,0,0,0,0,Friday
2021-04-09,Kai Tak Cruise Terminal,0,0,0,0,0,0,0,0,Friday
2021-04-09,Macau Ferry Terminal,0,0,0,0,0,0,0,0,Friday
2021-04-09,Total,2152,164,33,2349,2058,107,46,2211,Friday
2021-04-10,Airport,445,10,15,470,754,11,30,795,Saturday
2021-04-10,Express Rail Link West Kowloon,0,0,0,0,0,0,0,0,Saturday
2021-04-10,Hung Hom,0,0,0,0,0,0,0,0,Saturday
2021-04-10,Lo Wu,0,0,0,0,0,0,0,0,Saturday
2021-04-10,Lok Ma Chau Spur Line,0,0,0,0,0,0,0,0,Saturday
2021-04-10,Heung Yuen Wai,0,0,0,0,0,0,0,0,Saturday
2021-04-10,Hong Kong-Zhuhai-Macao Bridge,164,7,4,175,118,9,0,127,Saturday
2021-04-10,Lok Ma Chau,0,0,0,0,0,0,0,0,Saturday
2021-04-10,Man Kam To,0,0,0,0,0,0,0,0,Saturday
2021-04-10,Sha Tau Kok,0,0,0,0,0,0,0,0,Saturday
2021-04-10,Shenzhen Bay,2019,212,1,2232,912,99,0,1011,Saturday
2021-04-10,China Ferry Terminal,0,0,0,0,0,0,0,0,Saturday
2021-04-10,Harbour Control,0,0,0,0,0,0,0,0,Saturday
2021-04-10,Kai Tak Cruise Terminal,0,0,0,0,0,0,0,0,Saturday
2021-04-10,Macau Ferry Terminal,0,0,0,0,0,0,0,0,Saturday
2021-04-10,Tuen Mun Ferry Terminal,0,0,0,0,0,0,0,0,Saturday
2021-04-10,Total,2628,229,20,2877,1784,119,30,1933,Saturday
2021-04-11,Airport,467,4,20,491,1135,8,39,1182,Sunday
2021-04-11,Hung Hom,0,0,0,0,0,0,0,0,Sunday
2021-04-11,Lo Wu,0,0,0,0,0,0,0,0,Sunday
2021-04-11,Lok Ma Chau Spur Line,0,0,0,0,0,0,0,0,Sunday
2021-04-11,Heung Yuen Wai,0,0,0,0,0,0,0,0,Sunday
2021-04-11,Hong Kong-Zhuhai-Macao Bridge,183,5,2,190,98,14,0,112,Sunday
2021-04-11,Lok Ma Chau,0,0,0,0,0,0,0,0,Sunday
2021-04-11,Man Kam To,0,0,0,0,0,0,0,0,Sunday
2021-04-11,Sha Tau Kok,0,0,0,0,0,0,0,0,Sunday
2021-04-11,Shenzhen Bay,2019,196,1,2216,576,105,3,684,Sunday
2021-04-11,China Ferry Terminal,0,0,0,0,0,0,0,0,Sunday
2021-04-11,Harbour Control,0,0,0,0,0,0,0,0,Sunday
2021-04-11,Kai Tak Cruise Terminal,0,0,0,0,0,0,0,0,Sunday
2021-04-11,Macau Ferry Terminal,0,0,0,0,0,0,0,0,Sunday
2021-04-11,Tuen Mun Ferry Terminal,0,0,0,0,0,0,0,0,Sunday
2021-04-11,Total,2669,205,23,2897,1809,127,42,1978,Sunday
2021-04-12,Airport,216,5,7,228,694,4,9,707,Monday
2021-04-12,Express Rail Link West Kowloon,0,0,0,0,0,0,0,0,Monday
2021-04-12,Hung Hom,0,0,0,0,0,0,0,0,Monday
2021-04-12,Lo Wu,0,0,0,0,0,0,0,0,Monday
2021-04-12,Lok Ma Chau Spur Line,0,0,0,0,0,0,0,0,Monday
2021-04-12,Heung Yuen Wai,0,0,0,0,0,0,0,0,Monday
2021-04-12,Hong Kong-Zhuhai-Macao Bridge,85,8,3,96,115,4,1,120,Monday
2021-04-12,Lok Ma Chau,0,0,0,0,0,0,0,0,Monday
2021-04-12,Man Kam To,0,0,0,0,0,0,0,0,Monday
2021-04-12,Sha Tau Kok,0,0,0,0,0,0,0,0,Monday
2021-04-12,Shenzhen Bay,1096,96,9,1201,716,69,2,787,Monday
2021-04-12,China Ferry Terminal,0,0,0,0,0,0,0,0,Monday
2021-04-12,Harbour Control,0,0,0,0,0,0,0,0,Monday
2021-04-12,Kai Tak Cruise Terminal,0,0,0,0,0,0,0,0,Monday
2021-04-12,Macau Ferry Terminal,0,0,0,0,0,0,0,0,Monday
2021-04-12,Tuen Mun Ferry Terminal,0,0,0,0,0,0,0,0,Monday
2021-04-12,Total,1397,109,19,1525,1525,77,12,1614,Monday
2021-04-13,Airport,354,1,10,365,789,7,40,836,Tuesday
2021-04-13,Hung Hom,0,0,0,0,0,0,0,0,Tuesday
2021-04-13,Lo Wu,0,0,0,0,0,0,0,0,Tuesday
2021-04-13,Lok Ma Chau Spur Line,0,0,0,0,0,0,0,0,Tuesday
2021-04-13,Heung Yuen Wai,0,0,0,0,0,0,0,0,Tuesday
2021-04-13,Lok Ma Chau,0,0,0,0,0,0,0,0,Tuesday
2021-04-13,Man Kam To,0,0,0,0,0,0,0,0,Tuesday
2021-04-13,Sha Tau Kok,0,0,0,0,0,0,0,0,Tuesday
2021-04-13,Shenzhen Bay,1185,104,2,1291,895,103,3,1001,Tuesday
2021-04-13,China Ferry Terminal,0,0,0,0,0,0,0,0,Tuesday
2021-04-13,Harbour Control,0,0,0,0,0,0,0,0,Tuesday
2021-04-13,Macau Ferry Terminal,0,0,0,0,0,0,0,0,Tuesday
2021-04-13,Tuen Mun Ferry Terminal,0,0,0,0,0,0,0,0,Tuesday
2021-04-13,Total,1633,106,14,1753,1824,116,43,1983,Tuesday
2021-04-14,Airport,417,0,12,429,476,3,24,503,Wednesday
2021-04-14,Express Rail Link West Kowloon,0,0,0,0,0,0,0,0,Wednesday
2021-04-14,Hung Hom,0,0,0,0,0,0,0,0,Wednesday
2021-04-14,Lo Wu,0,0,0,0,0,0,0,0,Wednesday
2021-04-14,Lok Ma Chau Spur Line,0,0,0,0,0,0,0,0,Wednesday
2021-04-14,Heung Yuen Wai,0,0,0,0,0,0,0,0,Wednesday
2021-04-14,Hong Kong-Zhuhai-Macao Bridge,128,7,3,138,163,9,2,174,Wednesday
2021-04-14,Lok Ma Chau,0,0,0,0,0,0,0,0,Wednesday
2021-04-14,Man Kam To,0,0,0,0,0,0,0,0,Wednesday
2021-04-14,Sha Tau Kok,0,0,0,0,0,0,0,0,Wednesday
2021-04-14,Shenzhen Bay,1091,149,0,1240,766,140,6,912,Wednesday
2021-04-14,China Ferry Terminal,0,0,0,0,0,0,0,0,Wednesday
2021-04-14,Harbour Control,0,0,0,0,0,0,0,0,Wednesday
2021-04-14,Kai Tak Cruise Terminal,0,0,0,0,0,0,0,0,Wednesday
2021-04-14,Macau Ferry Terminal,0,0,0,0,0,0,0,0,Wednesday
2021-04-14,Tuen Mun Ferry Terminal,0,0,0,0,0,0,0,0,Wednesday
2021-04-14,Total,1636,156,15,1807,1405,152,32,1589,Wednesday
2021-04-15,Airport,264,4,10,278,695,3,82,780,Thursday
2021-04-15,Hung Hom,0,0,0,0,0,0,0,0,Thursday
2021-04-15,Lo Wu,0,0,0,0,0,0,0,0,Thursday
2021-04-15,Lok Ma Chau Spur Line,0,0,0,0,0,0,0,0,Thursday
2021-04-15,Heung Yuen Wai,0,0,0,0,0,0,0,0,Thursday
2021-04-15,Hong Kong-Zhuhai-Macao Bridge,112,5,54,171,160,13,2,175,Thursday
2021-04-15,Lok Ma Chau,0,0,0,0,0,0,0,0,Thursday
2021-04-15,Man Kam To,0,0,0,0,0,0,0,0,Thursday
2021-04-15,Sha Tau Kok,0,0,0,0,0,0,0,0,Thursday
2021-04-15,Shenzhen Bay,1175,99,1,1275,965,80,3,1048,Thursday
2021-04-15,China Ferry Terminal,0,0,0,0,0,0,0,0,Thursday
2021-04-15,Harbour Control,0,0,0,0,0,0,0,0,Thursday
2021-04-15,Kai Tak Cruise Terminal,0,0,0,0,0,0,0,0,Thursday
2021-04-15,Macau Ferry Terminal,0,0,0,0,0,0,0,0,Thursday
2021-04-15,Tuen Mun Ferry Terminal,0,0,0,0,0,0,0,0,Thursday
2021-04-15,Total,1551,108,65,1724,1820,96,87,2003,Thursday
2021-04-16,Airport,533,5,25,563,805,21,39,865,Friday
2021-04-16,Express Rail Link West Kowloon,0,0,0,0,0,0,0,0,Friday
2021-04-16,Hung Hom,0,0,0,0,0,0,0,0,Friday
2021-04-16,Lo Wu,0,0,0,0,0,0,0,0,Friday
2021-04-16,Lok Ma Chau Spur Line,0,0,0,0,0,0,0,0,Friday
2021-04-16,Heung Yuen Wai,0,0,0,0,0,0,0,0,Friday
2021-04-16,Hong Kong-Zhuhai-Macao Bridge,100,3,5,108,135,8,1,144,Friday
2021-04-16,Lok Ma Chau,0,0,0,0,0,0,0,0,Friday
2021-04-16,Man Kam To,0,0,0,0,0,0,0,0,Friday
2021-04-16,Sha Tau Kok,0,0,0,0,0,0,0,0,Friday
2021-04-16,Shenzhen Bay,1059,86,1,1146,939,108,1,1048,Friday
2021-04-16,China Ferry Terminal,0,0,0,0,0,0,0,0,Friday
2021-04-16,Harbour Control,0,0,0,0,0,0,0,0,Friday
2021-04-16,Kai Tak Cruise Terminal,0,0,0,0,0,0,0,0,Friday
2021-04-16,Macau Ferry Terminal,0,0,0,0,0,0,0,0,Friday
2021-04-16,Total,1692,94,31,1817,1879,137,41,2057,Friday
2021-04-17,Airport,290,7,11,308,531,12,18,561,Saturday
2021-04-17,Express Rail Link West Kowloon,0,0,0,0,0,0,0,0,Saturday
2021-04-17,Hung Hom,0,0,0,0,0,0,0,0,Saturday
2021-04-17,Lo Wu,0,0,0,0,0,0,0,0,Saturday
2021-04-17,Lok Ma Chau Spur Line,0,0,0,0,0,0,0,0,Saturday
2021-04-17,Heung Yuen Wai,0,0,0,0,0,0,0,0,Saturday
2021-04-17,Hong Kong-Zhuhai-Macao Bridge,106,4,0,110,89,2,1,92,Saturday
2021-04-17,Lok Ma Chau,0,0,0,0,0,0,0,0,Saturday
2021-04-17,Man Kam To,0,0,0,0,0,0,0,0,Saturday
2021-04-17,Sha Tau Kok,0,0,0,0,0,0,0,0,Saturday
2021-04-17,Shenzhen Bay,1107,112,1,1220,888,85,2,975,Saturday
2021-04-17,China Ferry Terminal,0,0,0,0,0,0,0,0,Saturday
2021-04-17,Harbour Control,0,0,0,0,0,0,0,0,Saturday
2021-04-17,Kai Tak Cruise Terminal,0,0,0,0,0,0,0,0,Saturday
2021-04-17,Macau Ferry Terminal,0,0,0,0,0,0,0,0,Saturday
2021-04-17,Tuen Mun Ferry Terminal,0,0,0,0,0,0,0,0,Saturday
2021-04-17,Total,1503,123,12,1638,1508,99,21,1628,Saturday
2021-04-18,Airport,582,2,14,598,928,8,37,973,Sunday
2021-04-18,Express Rail Link West Kowloon,0,0,0,0,0,0,0,0,Sunday
2021-04-18,Hung Hom,0,0,0,0,0,0,0,0,Sunday
2021-04-18,Lo Wu,0,0,0,0,0,0,0,0,Sunday
2021-04-18,Lok Ma Chau Spur Line,0,0,0,0,0,0,0,0,Sunday
2021-04-18,Heung Yuen Wai,0,0,0,0,0,0,0,0,Sunday
2021-04-18,Lok Ma Chau,0,0,0,0,0,0,0,0,Sunday
2021-04-18,Man Kam To,0,0,0,0,0,0,0,0,Sunday
2021-04-18,Sha Tau Kok,0,0,0,0,0,0,0,0,Sunday
2021-04-18,Shenzhen Bay,1446,132,1,1579,713,88,3,804,Sunday
2021-04-18,China Ferry Terminal,0,0,0,0,0,0,0,0,Sunday
2021-04-18,Harbour Control,0,0,0,0,0,0,0,0,Sunday
2021-04-18,Kai Tak Cruise Terminal,0,0,0,0,0,0,0,0,Sunday
2021-04-18,Tuen Mun Ferry Terminal,0,0,0,0,0,0,0,0,Sunday
2021-04-18,Total,2139,143,18,2300,1726,102,45,1873,Sunday
2021-04-19,Airport,133,1,11,145,624,11,16,651,Monday
2021-04-19,Hung Hom,0,0,0,0,0,0,0,0,Monday
2021-04-19,Lo Wu,0,0,0,0,0,0,0,0,Monday
2021-04-19,Lok Ma Chau Spur Line,0,0,0,0,0,0,0,0,Monday
2021-04-19,Heung Yuen Wai,0,0,0,0,0,0,0,0,Monday
2021-04-19,Hong Kong-Zhuhai-Macao Bridge,69,1,4,74,121,3,2,126,Monday
2021-04-19,Lok Ma Chau,0,0,0,0,0,0,0,0,Monday
2021-04-19,Man Kam To,0,0,0,0,0,0,0,0,Monday
2021-04-19,Sha Tau Kok,0,0,0,0,0,0,0,0,Monday
2021-04-19,Shenzhen Bay,822,90,0,912,680,60,0,740,Monday
2021-04-19,China Ferry Terminal,0,0,0,0,0,0,0,0,Monday
2021-04-19,Harbour Control,0,0,0,0,0,0,0,0,Monday
2021-04-19,Kai Tak Cruise Terminal,0,0,0,0,0,0,0,0,Monday
2021-04-19,Macau Ferry Terminal,0,0,0,0,0,0,0,0,Monday
2021-04-19,Tuen Mun Ferry Terminal,0,0,0,0,0,0,0,0,Monday
2021-04-19,Total,1024,92,15,1131,1425,74,18,1517,Monday
2021-04-20,Airport,285,3,12,300,819,8,40,867,Tuesday
2021-04-20,Express Rail Link West Kowloon,0,0,0,0,0,0,0,0,Tuesday
2021-04-20,Hung Hom,0,0,0,0,0,0,0,0,Tuesday
2021-04-20,Lo Wu,0,0,0,0,0,0,0,0,Tuesday
2021-04-20,Lok Ma Chau Spur Line,0,0,0,0,0,0,0,0,Tuesday
2021-04-20,Heung Yuen Wai,0,0,0,0,0,0,0,0,Tuesday
2021-04-20,Hong Kong-Zhuhai-Macao Bridge,103,1,3,107,148,9,3,160,Tuesday
2021-04-20,Lok Ma Chau,0,0,0,0,0,0,0,0,Tuesday
2021-04-20,Man Kam To,0,0,0,0,0,0,0,0,Tuesday
2021-04-20,Sha Tau Kok,0,0,0,0,0,0,0,0,Tuesday
2021-04-20,Shenzhen Bay,1015,127,3,1145,893,134,1,1028,Tuesday
2021-04-20,China Ferry Terminal,0,0,0,0,0,0,0,0,Tuesday
2021-04-20,Harbour Control,0,0,0,0,0,0,0,0,Tuesday
2021-04-20,Kai Tak Cruise Terminal,0,0,0,0,0,0,0,0,Tuesday
2021-04-20,Macau Ferry Terminal,0,0,0,0,0,0,0,0,Tuesday
2021-04-20,Tuen Mun Ferry Terminal,0,0,0,0,0,0,0,0,Tuesday
2021-04-20,Total,1403,131,18,1552,1860,151,44,2055,Tuesday
2021-04-21,Airport,429,3,21,453,425,9,14,448,Wednesday
2021-04-21,Hung Hom,0,0,0,0,0,0,0,0,Wednesday
2021-04-21,Lo Wu,0,0,0,0,0,0,0,0,Wednesday
2021-04-21,Lok Ma Chau Spur Line,0,0,0,0,0,0,0,0,Wednesday
2021-04-21,Heung Yuen Wai,0,0,0,0,0,0,0,0,Wednesday
2021-04-21,Hong Kong-Zhuhai-Macao Bridge,86,6,2,94,154,5,1,160,Wednesday
2021-04-21,Lok Ma Chau,0,0,0,0,0,0,0,0,Wednesday
2021-04-21,Man Kam To,0,0,0,0,0,0,0,0,Wednesday
2021-04-21,Sha Tau Kok,0,0,0,0,0,0,0,0,Wednesday
2021-04-21,Shenzhen Bay,1234,90,0,1324,807,101,1,909,Wednesday
2021-04-21,China Ferry Terminal,0,0,0,0,0,0,0,0,Wednesday
2021-04-21,Harbour Control,0,0,0,0,0,0,0,0,Wednesday
2021-04-21,Kai Tak Cruise Terminal,0,0,0,0,0,0,0,0,Wednesday
2021-04-21,Macau Ferry Terminal,0,0,0,0,0,0,0,0,Wednesday
2021-04-21,Tuen Mun Ferry Terminal,0,0,0,0,0,0,0,0,Wednesday
2021-04-21,Total,1749,99,23,1871,1386,115,16,1517,Wednesday
2021-04-22,Airport,418,3,15,436,486,3,30,519,Thursday
2021-04-22,Express Rail Link West Kowloon,0,0,0,0,0,0,0,0,Thursday
2021-04-22,Hung Hom,0,0,0,0,0,0,0,0,Thursday
2021-04-22,Lo Wu,0,0,0,0,0,0,0,0,Thursday
2021-04-22,Lok Ma Chau Spur Line,0,0,0,0,0,0,0,0,Thursday
2021-04-22,Heung Yuen Wai,0,0,0,0,0,0,0,0,Thursday
2021-04-22,Hong Kong-Zhuhai-Macao Bridge,89,2,0,91,123,7,0,130,Thursday
2021-04-22,Lok Ma Chau,0,0,0,0,0,0,0,0,Thursday
2021-04-22,Man Kam To,0,0,0,0,0,0,0,0,Thursday
2021-04-22,Sha Tau Kok,0,0,0,0,0,0,0,0,Thursday
2021-04-22,Shenzhen Bay,849,90,0,939,812,72,5,889,Thursday
2021-04-22,China Ferry Terminal,0,0,0,0,0,0,0,0,Thursday
2021-04-22,Harbour Control,0,0,0,0,0,0,0,0,Thursday
2021-04-22,Macau Ferry Terminal,0,0,0,0,0,0,0,0,Thursday
2021-04-22,Tuen Mun Ferry Terminal,0,0,0,0,0,0,0,0,Thursday
2021-04-22,Total,1356,95,15,1466,1421,82,35,1538,Thursday
2021-04-23,Airport,518,5,32,555,882,14,82,978,Friday
2021-04-23,Express Rail Link West Kowloon,0,0,0,0,0,0,0,0,Friday
2021-04-23,Hung Hom,0,0,0,0,0,0,0,0,Friday
2021-04-23,Lo Wu,0,0,0,0,0,0,0,0,Friday
2021-04-23,Lok Ma Chau Spur Line,0,0,0,0,0,0,0,0,Friday
2021-04-23,Heung Yuen Wai,0,0,0,0,0,0,0,0,Friday
2021-04-23,Hong Kong-Zhuhai-Macao Bridge,85,1,2,88,118,8,2,128,Friday
2021-04-23,Lok Ma Chau,0,0,0,0,0,0,0,0,Friday
2021-04-23,Man Kam To,0,0,0,0,0,0,0,0,Friday
2021-04-23,Sha Tau Kok,0,0,0,0,0,0,0,0,Friday
2021-04-23,Shenzhen Bay,1009,65,1,1075,826,87,2,915,Friday
2021-04-23,China Ferry Terminal,0,0,0,0,0,0,0,0,Friday
2021-04-23,Harbour Control,0,0,0,0,0,0,0,0,Friday
2021-04-23,Kai Tak Cruise Terminal,0,0,0,0,0,0,0,0,Friday
2021-04-23,Macau Ferry Terminal,0,0,0,0,0,0,0,0,Friday
2021-04-23,Tuen Mun Ferry Terminal,0,0,0,0,0,0,0,0,Friday
2021-04-23,Total,1612,71,35,1718,1826,109,86,2021,Friday
2021-04-24,Airport,184,4,14,202,495,18,14,527,Saturday
2021-04-24,Hung Hom,0,0,0,0,0,0,0,0,Saturday
2021-04-24,Lo Wu,0,0,0,0,0,0,0,0,Saturday
2021-04-24,Lok Ma Chau Spur Line,0,0,0,0,0,0,0,0,Saturday
2021-04-24,Lok Ma Chau,0,0,0,0,0,0,0,0,Saturday
2021-04-24,Man Kam To,0,0,0,0,0,0,0,0,Saturday
2021-04-24,Sha Tau Kok,0,0,0,0,0,0,0,0,Saturday
2021-04-24,Shenzhen Bay,970,108,1,1079,774,75,1,850,Saturday
2021-04-24,China Ferry Terminal,0,0,0,0,0,0,0,0,Saturday
2021-04-24,Harbour Control,0,0,0,0,0,0,0,0,Saturday
2021-04-24,Kai Tak Cruise Terminal,0,0,0,0,0,0,0,0,Saturday
2021-04-24,Macau Ferry Terminal,0,0,0,0,0,0,0,0,Saturday
2021-04-24,Tuen Mun Ferry Terminal,0,0,0,0,0,0,0,0,Saturday
2021-04-24,Total,1245,118,19,1382,1365,105,18,1488,Saturday
2021-04-25,Airport,565,2,24,591,858,9,25,892,Sunday
2021-04-25,Express Rail Link West Kowloon,0,0,0,0,0,0,0,0,Sunday
2021-04-25,Hung Hom,0,0,0,0,0,0,0,0,Sunday
2021-04-25,Lo Wu,0,0,0,0,0,0,0,0,Sunday
2021-04-25,Lok Ma Chau Spur Line,0,0,0,0,0,0,0,0,Sunday
2021-04-25,Heung Yuen Wai,0,0,0,0,0,0,0,0,Sunday
2021-04-25,Hong Kong-Zhuhai-Macao Bridge,87,4,7,98,95,8,2,105,Sunday
2021-04-25,Lok Ma Chau,0,0,0,0,0,0,0,0,Sunday
2021-04-25,Man Kam To,0,0,0,0,0,0,0,0,Sunday
2021-04-25,Sha Tau Kok,0,0,0,0,0,0,0,0,Sunday
2021-04-25,Shenzhen Bay,1202,135,5,1342,596,82,0,678,Sunday
2021-04-25,China Ferry Terminal,0,0,0,0,0,0,0,0,Sunday
2021-04-25,Harbour Control,0,0,0,0,0,0,0,0,Sunday
2021-04-25,Kai Tak Cruise Terminal,0,0,0,0,0,0,0,0,Sunday
2021-04-25,Macau Ferry Terminal,0,0,0,0,0,0,0,0,Sunday
2021-04-25,Tuen Mun Ferry Terminal,0,0,0,0,0,0,0,0,Sunday
2021-04-25,Total,1854,141,36,2031,1549,99,27,1675,Sunday
2021-04-26,Airport,79,3,13,95,556,6,27,589,Monday
2021-04-26,Hung Hom,0,0,0,0,0,0,0,0,Monday
2021-04-26,Lo Wu,0,0,0,0,0,0,0,0,Monday
2021-04-26,Lok Ma Chau Spur Line,0,0,0,0,0,0,0,0,Monday
2021-04-26,Heung Yuen Wai,0,0,0,0,0,0,0,0,Monday
2021-04-26,Hong Kong-Zhuhai-Macao Bridge,72,1,2,75,127,5,1,133,Monday
2021-04-26,Lok Ma Chau,0,0,0,0,0,0,0,0,Monday
2021-04-26,Man Kam To,0,0,0,0,0,0,0,0,Monday
2021-04-26,Sha Tau Kok,0,0,0,0,0,0,0,0,Monday
2021-04-26,Shenzhen Bay,773,73,1,847,770,72,3,845,Monday
2021-04-26,China Ferry Terminal,0,0,0,0,0,0,0,0,Monday
2021-04-26,Harbour Control,0,0,0,0,0,0,0,0,Monday
2021-04-26,Kai Tak Cruise Terminal,0,0,0,0,0,0,0,0,Monday
2021-04-26,Macau Ferry Terminal,0,0,0,0,0,0,0,0,Monday
2021-04-26,Tuen Mun Ferry Terminal,0,0,0,0,0,0,0,0,Monday
2021-04-26,Total,924,77,16,1017,1453,83,31,1567,Monday
2021-04-27,Airport,351,3,11,365,688,7,32,727,Tuesday
2021-04-27,Express Rail Link West Kowloon,0,0,0,0,0,0,0,0,Tuesday
2021-04-27,Hung Hom,0,0,0,0,0,0,0,0,Tuesday
2021-04-27,Lo Wu,0,0,0,0,0,0,0,0,Tuesday
2021-04-27,Lok Ma Chau Spur Line,0,0,0,0,0,0,0,0,Tuesday
2021-04-27,Heung Yuen Wai,0,0,0,0,0,0,0,0,Tuesday
2021-04-27,Hong Kong-Zhuhai-Macao Bridge,95,3,2,100,127,3,5,135,Tuesday
2021-04-27,Lok Ma Chau,0,0,0,0,0,0,0,0,Tuesday
2021-04-27,Man Kam To,0,0,0,0,0,0,0,0,Tuesday
2021-04-27,Sha Tau Kok,0,0,0,0,0,0,0,0,Tuesday
2021-04-27,Shenzhen Bay,763,76,1,840,778,97,2,877,Tuesday
2021-04-27,China Ferry Terminal,0,0,0,0,0,0,0,0,Tuesday
2021-04-27,Harbour Control,0,0,0,0,0,0,0,0,Tuesday
2021-04-27,Kai Tak Cruise Terminal,0,0,0,0,0,0,0,0,Tuesday
2021-04-27,Macau Ferry Terminal,0,0,0,0,0,0,0,0,Tuesday
2021-04-27,Tuen Mun Ferry Terminal,0,0,0,0,0,0,0,0,Tuesday
2021-04-27,Total,1209,82,14,1305,1593,107,39,1739,Tuesday
2021-04-28,Airport,462,5,12,479,509,6,22,537,Wednesday
2021-04-28,Hung Hom,0,0,0,0,0,0,0,0,Wednesday
2021-04-28,Lo Wu,0,0,0,0,0,0,0,0,Wednesday
2021-04-28,Lok Ma Chau Spur Line,0,0,0,0,0,0,0,0,Wednesday
2021-04-28,Heung Yuen Wai,0,0,0,0,0,0,0,0,Wednesday
2021-04-28,Hong Kong-Zhuhai-Macao Bridge,92,1,2,95,135,5,2,142,Wednesday
2021-04-28,Lok Ma Chau,0,0,0,0,0,0,0,0,Wednesday
2021-04-28,Man Kam To,0,0,0,0,0,0,0,0,Wednesday
2021-04-28,Sha Tau Kok,0,0,0,0,0,0,0,0,Wednesday
2021-04-28,Shenzhen Bay,978,86,0,1064,801,69,0,870,Wednesday
2021-04-28,China Ferry Terminal,0,0,0,0,0,0,0,0,Wednesday
2021-04-28,Harbour Control,0,0,0,0,0,0,0,0,Wednesday
2021-04-28,Kai Tak Cruise Terminal,0,0,0,0,0,0,0,0,Wednesday
2021-04-28,Macau Ferry Terminal,0,0,0,0,0,0,0,0,Wednesday
2021-04-28,Tuen Mun Ferry Terminal,0,0,0,0,0,0,0,0,Wednesday
2021-04-28,Total,1532,92,14,1638,1445,80,24,1549,Wednesday
2021-04-29,Airport,496,1,18,515,596,3,31,630,Thursday
2021-04-29,Express Rail Link West Kowloon,0,0,0,0,0,0,0,0,Thursday
2021-04-29,Hung Hom,0,0,0,0,0,0,0,0,Thursday
2021-04-29,Lo Wu,0,0,0,0,0,0,0,0,Thursday
2021-04-29,Lok Ma Chau Spur Line,0,0,0,0,0,0,0,0,Thursday
2021-04-29,Heung Yuen Wai,0,0,0,0,0,0,0,0,Thursday
2021-04-29,Hong Kong-Zhuhai-Macao Bridge,118,4,2,124,95,6,4,105,Thursday
2021-04-29,Lok Ma Chau,0,0,0,0,0,0,0,0,Thursday
2021-04-29,Man Kam To,0,0,0,0,0,0,0,0,Thursday
2021-04-29,Sha Tau Kok,0,0,0,0,0,0,0,0,Thursday
2021-04-29,Shenzhen Bay,1205,141,0,1346,778,121,5,904,Thursday
2021-04-29,Harbour Control,0,0,0,0,0,0,0,0,Thursday
2021-04-29,Tuen Mun Ferry Terminal,0,0,0,0,0,0,0,0,Thursday
2021-04-29,Total,1819,146,20,1985,1469,130,40,1639,Thursday
2021-04-30,Airport,617,1,21,639,1034,5,30,1069,Friday
2021-04-30,Express Rail Link West Kowloon,0,0,0,0,0,0,0,0,Friday
2021-04-30,Hung Hom,0,0,0,0,0,0,0,0,Friday
2021-04-30,Lo Wu,0,0,0,0,0,0,0,0,Friday
2021-04-30,Lok Ma Chau Spur Line,0,0,0,0,0,0,0,0,Friday
2021-04-30,Heung Yuen Wai,0,0,0,0,0,0,0,0,Friday
2021-04-30,Hong Kong-Zhuhai-Macao Bridge,161,5,4,170,183,2,2,187,Friday
2021-04-30,Lok Ma Chau,0,0,0,0,0,0,0,0,Friday
2021-04-30,Man Kam To,0,0,0,0,0,0,0,0,Friday
2021-04-30,Sha Tau Kok,0,0,0,0,0,0,0,0,Friday
2021-04-30,Shenzhen Bay,1550,91,2,1643,989,89,2,1080,Friday
2021-04-30,China Ferry Terminal,0,0,0,0,0,0,0,0,Friday
2021-04-30,Harbour Control,0,0,0,0,0,0,0,0,Friday
2021-04-30,Kai Tak Cruise Terminal,0,0,0,0,0,0,0,0,Friday
2021-04-30,Macau Ferry Terminal,0,0,0,0,0,0,0,0,Friday
2021-04-30,Tuen Mun Ferry Terminal,0,0,0,0,0,0,0,0,Friday
2021-04-30,Total,2328,97,27,2452,2206,96,34,2336,Friday
2021-05-01,Airport,380,1,5,386,782,3,13,798,Saturday
2021-05-01,Hung Hom,0,0,0,0,0,0,0,0,Saturday
2021-05-01,Lo Wu,0,0,0,0,0,0,0,0,Saturday
2021-05-01,Lok Ma Chau Spur Line,0,0,0,0,0,0,0,0,Saturday
2021-05-01,Heung Yuen Wai,0,0,0,0,0,0,0,0,Saturday
2021-05-01,Hong Kong-Zhuhai-Macao Bridge,97,3,5,105,154,13,2,169,Saturday
2021-05-01,Lok Ma Chau,0,0,0,0,0,0,0,0,Saturday
2021-05-01,Man Kam To,0,0,0,0,0,0,0,0,Saturday
2021-05-01,Sha Tau Kok,0,0,0,0,0,0,0,0,Saturday
2021-05-01,Shenzhen Bay,918,96,2,1016,1055,90,1,1146,Saturday
2021-05-01,China Ferry Terminal,0,0,0,0,0,0,0,0,Saturday
2021-05-01,Harbour Control,0,0,0,0,0,0,0,0,Saturday
2021-05-01,Kai Tak Cruise Terminal,0,0,0,0,0,0,0,0,Saturday
2021-05-01,Macau Ferry Terminal,0,0,0,0,0,0,0,0,Saturday
2021-05-01,Tuen Mun Ferry Terminal,0,0,0,0,0,0,0,0,Saturday
2021-05-01,Total,1395,100,12,1507,1991,106,16,2113,Saturday
2021-05-02,Airport,740,5,24,769,1039,8,37,1084,Sunday
2021-05-02,Express Rail Link West Kowloon,0,0,0,0,0,0,0,0,Sunday
2021-05-02,Hung Hom,0,0,0,0,0,0,0,0,Sunday
2021-05-02,Lo Wu,0,0,0,0,0,0,0,0,Sunday
2021-05-02,Lok Ma Chau Spur Line,0,0,0,0,0,0,0,0,Sunday
2021-05-02,Heung Yuen Wai,0,0,0,0,0,0,0,0,Sunday
2021-05-02,Hong Kong-Zhuhai-Macao Bridge,93,6,3,102,112,6,1,119,Sunday
2021-05-02,Lok Ma Chau,0,0,0,0,0,0,0,0,Sunday
2021-05-02,Man Kam To,0,0,0,0,0,0,0,0,Sunday
2021-05-02,Sha Tau Kok,0,0,0,0,0,0,0,0,Sunday
2021-05-02,Shenzhen Bay,1097,116,1,1214,651,76,0,727,Sunday
2021-05-02,China Ferry Terminal,0,0,0,0,0,0,0,0,Sunday
2021-05-02,Harbour Control,0,0,0,0,0,0,0,0,Sunday
2021-05-02,Kai Tak Cruise Terminal,0,0,0,0,0,0,0,0,Sunday
2021-05-02,Macau Ferry Terminal,0,0,0,0,0,0,0,0,Sunday
2021-05-02,Tuen Mun Ferry Terminal,0,0,0,0,0,0,0,0,Sunday
2021-05-02,Total,1930,127,28,2085,1802,90,38,1930,Sunday
2021-05-03,Airport,124,2,11,137,457,3,21,481,Monday
2021-05-03,Hung Hom,0,0,0,0,0,0,0,0,Monday
2021-05-03,Lo Wu,0,0,0,0,0,0,0,0,Monday
2021-05-03,Lok Ma Chau Spur Line,0,0,0,0,0,0,0,0,Monday
2021-05-03,Heung Yuen Wai,0,0,0,0,0,0,0,0,Monday
2021-05-03,Hong Kong-Zhuhai-Macao Bridge,89,0,2,91,136,4,3,143,Monday
2021-05-03,Lok Ma Chau,0,0,0,0,0,0,0,0,Monday
2021-05-03,Man Kam To,0,0,0,0,0,0,0,0,Monday
2021-05-03,Sha Tau Kok,0,0,0,0,0,0,0,0,Monday
2021-05-03,Shenzhen Bay,752,69,1,822,661,66,1,728,Monday
2021-05-03,China Ferry Terminal,0,0,0,0,0,0,0,0,Monday
2021-05-03,Harbour Control,0,0,0,0,0,0,0,0,Monday
2021-05-03,Kai Tak Cruise Terminal,0,0,0,0,0,0,0,0,Monday
2021-05-03,Macau Ferry Terminal,0,0,0,0,0,0,0,0,Monday
2021-05-03,Tuen Mun Ferry Terminal,0,0,0,0,0,0,0,0,Monday
2021-05-03,Total,965,71,14,1050,1254,73,25,1352,Monday
2021-05-04,Airport,269,2,16,287,829,9,15,853,Tuesday
2021-05-04,Express Rail Link West Kowloon,0,0,0,0,0,0,0,0,Tuesday
2021-05-04,Hung Hom,0,0,0,0,0,0,0,0,Tuesday
2021-05-04,Lo Wu,0,0,0,0,0,0,0,0,Tuesday
2021-05-04,Lok Ma Chau Spur Line,0,0,0,0,0,0,0,0,Tuesday
2021-05-04,Heung Yuen Wai,0,0,0,0,0,0,0,0,Tuesday
2021-05-04,Hong Kong-Zhuhai-Macao Bridge,71,3,3,77,137,3,2,142,Tuesday
2021-05-04,Lok Ma Chau,0,0,0,0,0,0,0,0,Tuesday
2021-05-04,Man Kam To,0,0,0,0,0,0,0,0,Tuesday
2021-05-04,Sha Tau Kok,0,0,0,0,0,0,0,0,Tuesday
2021-05-04,Shenzhen Bay,632,69,3,704,798,76,4,878,Tuesday
2021-05-04,China Ferry Terminal,0,0,0,0,0,0,0,0,Tuesday
2021-05-04,Harbour Control,0,0,0,0,0,0,0,0,Tuesday
2021-05-04,Macau Ferry Terminal,0,0,0,0,0,0,0,0,Tuesday
2021-05-04,Tuen Mun Ferry Terminal,0,0,0,0,0,0,0,0,Tuesday
2021-05-04,Total,972,74,22,1068,1764,88,21,1873,Tuesday
2021-05-05,Airport,534,4,10,548,474,4,18,496,Wednesday
2021-05-05,Express Rail Link West Kowloon,0,0,0,0,0,0,0,0,Wednesday
2021-05-05,Hung Hom,0,0,0,0,0,0,0,0,Wednesday
2021-05-05,Lo Wu,0,0,0,0,0,0,0,0,Wednesday
2021-05-05,Lok Ma Chau Spur Line,0,0,0,0,0,0,0,0,Wednesday
2021-05-05,Hong Kong-Zhuhai-Macao Bridge,74,2,2,78,168,12,3,183,Wednesday
2021-05-05,Lok Ma Chau,0,0,0,0,0,0,0,0,Wednesday
2021-05-05,Man Kam To,0,0,0,0,0,0,0,0,Wednesday
2021-05-05,Sha Tau Kok,0,0,0,0,0,0,0,0,Wednesday
2021-05-05,Shenzhen Bay,704,58,0,762,825,85,4,914,Wednesday
2021-05-05,China Ferry Terminal,0,0,0,0,0,0,0,0,Wednesday
2021-05-05,Harbour Control,0,0,0,0,0,0,0,0,Wednesday
2021-05-05,Kai Tak Cruise Terminal,0,0,0,0,0,0,0,0,Wednesday
2021-05-05,Macau Ferry Terminal,0,0,0,0,0,0,0,0,Wednesday
2021-05-05,Total,1312,64,12,1388,1467,101,25,1593,Wednesday
2021-05-06,Airport,170,1,9,180,686,2,20,708,Thursday
2021-05-06,Express Rail Link West Kowloon,0,0,0,0,0,0,0,0,Thursday
2021-05-06,Hung Hom,0,0,0,0,0,0,0,0,Thursday
2021-05-06,Lo Wu,0,0,0,0,0,0,0,0,Thursday
2021-05-06,Lok Ma Chau Spur Line,0,0,0,0,0,0,0,0,Thursday
2021-05-06,Heung Yuen Wai,0,0,0,0,0,0,0,0,Thursday
2021-05-06,Hong Kong-Zhuhai-Macao Bridge,72,3,3,78,166,13,2,181,Thursday
2021-05-06,Lok Ma Chau,0,0,0,0,0,0,0,0,Thursday
2021-05-06,Man Kam To,0,0,0,0,0,0,0,0,Thursday
2021-05-06,Sha Tau Kok,0,0,0,0,0,0,0,0,Thursday
2021-05-06,Shenzhen Bay,764,90,0,854,1047,98,2,1147,Thursday
2021-05-06,China Ferry Terminal,0,0,0,0,0,0,0,0,Thursday
2021-05-06,Harbour Control,0,0,0,0,0,0,0,0,Thursday
2021-05-06,Kai Tak Cruise Terminal,0,0,0,0,0,0,0,0,Thursday
2021-05-06,Macau Ferry Terminal,0,0,0,0,0,0,0,0,Thursday
2021-05-06,Tuen Mun Ferry Terminal,0,0,0,0,0,0,0,0,Thursday
2021-05-06,Total,1006,94,12,1112,1899,113,24,2036,Thursday
2021-05-07,Airport,617,4,29,650,883,15,63,961,Friday
2021-05-07,Express Rail Link West Kowloon,0,0,0,0,0,0,0,0,Friday
2021-05-07,Hung Hom,0,0,0,0,0,0,0,0,Friday
2021-05-07,Lo Wu,0,0,0,0,0,0,0,0,Friday
2021-05-07,Lok Ma Chau Spur Line,0,0,0,0,0,0,0,0,Friday
2021-05-07,Heung Yuen Wai,0,0,0,0,0,0,0,0,Friday
2021-05-07,Lok Ma Chau,0,0,0,0,0,0,0,0,Friday
2021-05-07,Man Kam To,0,0,0,0,0,0,0,0,Friday
2021-05-07,Sha Tau Kok,0,0,0,0,0,0,0,0,Friday
2021-05-07,Shenzhen Bay,992,96,1,1089,869,147,1,1017,Friday
2021-05-07,China Ferry Terminal,0,0,0,0,0,0,0,0,Friday
2021-05-07,Harbour Control,0,0,0,0,0,0,0,0,Friday
2021-05-07,Kai Tak Cruise Terminal,0,0,0,0,0,0,0,0,Friday
2021-05-07,Macau Ferry Terminal,0,0,0,0,0,0,0,0,Friday
2021-05-07,Tuen Mun Ferry Terminal,0,0,0,0,0,0,0,0,Friday
2021-05-07,Total,1708,103,40,1851,1939,170,68,2177,Friday
2021-05-08,Airport,336,3,5,344,945,8,12,965,Saturday
2021-05-08,Express Rail Link West Kowloon,0,0,0,0,0,0,0,0,Saturday
2021-05-08,Hung Hom,0,0,0,0,0,0,0,0,Saturday
2021-05-08,Lo Wu,0,0,0,0,0,0,0,0,Saturday
2021-05-08,Lok Ma Chau Spur Line,0,0,0,0,0,0,0,0,Saturday
2021-05-08,Heung Yuen Wai,0,0,0,0,0,0,0,0,Saturday
2021-05-08,Hong Kong-Zhuhai-Macao Bridge,106,2,1,109,164,11,2,177,Saturday
2021-05-08,Lok Ma Chau,0,0,0,0,0,0,0,0,Saturday
2021-05-08,Man Kam To,0,0,0,0,0,0,0,0,Saturday
2021-05-08,Sha Tau Kok,0,0,0,0,0,0,0,0,Saturday
2021-05-08,Shenzhen Bay,1156,101,5,1262,876,82,3,961,Saturday
2021-05-08,China Ferry Terminal,0,0,0,0,0,0,0,0,Saturday
2021-05-08,Harbour Control,0,0,0,0,0,0,0,0,Saturday
2021-05-08,Kai Tak Cruise Terminal,0,0,0,0,0,0,0,0,Saturday
2021-05-08,Macau Ferry Terminal,0,0,0,0,0,0,0,0,Saturday
2021-05-08,Tuen Mun Ferry Terminal,0,0,0,0,0,0,0,0,Saturday
2021-05-08,Total,1598,106,11,1715,1985,101,17,2103,Saturday
2021-05-09,Airport,669,6,73,748,923,9,44,976,Sunday
2021-05-09,Hung Hom,0,0,0,0,0,0,0,0,Sunday
2021-05-09,Lo Wu,0,0,0,0,0,0,0,0,Sunday
2021-05-09,Lok Ma Chau Spur Line,0,0,0,0,0,0,0,0,Sunday
2021-05-09,Heung Yuen Wai,0,0,0,0,0,0,0,0,Sunday
2021-05-09,Hong Kong-Zhuhai-Macao Bridge,111,6,0,117,137,9,1,147,Sunday
2021-05-09,Lok Ma Chau,0,0,0,0,0,0,0,0,Sunday
2021-05-09,Man Kam To,0,0,0,0,0,0,0,0,Sunday
2021-05-09,Sha Tau Kok,0,0,0,0,0,0,0,0,Sunday
2021-05-09,Shenzhen Bay,1099,84,2,1185,624,89,3,716,Sunday
2021-05-09,China Ferry Terminal,0,0,0,0,0,0,0,0,Sunday
2021-05-09,Harbour Control,0,0,0,0,0,0,0,0,Sunday
2021-05-09,Kai Tak Cruise Terminal,0,0,0,0,0,0,0,0,Sunday
2021-05-09,Macau Ferry Terminal,0,0,0,0,0,0,0,0,Sunday
2021-05-09,Tuen Mun Ferry Terminal,0,0,0,0,0,0,0,0,Sunday
2021-05-09,Total,1879,96,75,2050,1684,107,48,1839,Sunday
2021-05-10,Airport,151,0,42,193,679,2,28,709,Monday
2021-05-10,Express Rail Link West Kowloon,0,0,0,0,0,0,0,0,Monday
2021-05-10,Hung Hom,0,0,0,0,0,0,0,0,Monday
2021-05-10,Lo Wu,0,0,0,0,0,0,0,0,Monday
2021-05-10,Lok Ma Chau Spur Line,0,0,0,0,0,0,0,0,Monday
2021-05-10,Heung Yuen Wai,0,0,0,0,0,0,0,0,Monday
2021-05-10,Hong Kong-Zhuhai-Macao Bridge,81,2,2,85,204,11,3,218,Monday
2021-05-10,Lok Ma Chau,0,0,0,0,0,0,0,0,Monday
2021-05-10,Man Kam To,0,0,0,0,0,0,0,0,Monday
2021-05-10,Sha Tau Kok,0,0,0,0,0,0,0,0,Monday
2021-05-10,Shenzhen Bay,1084,63,2,1149,929,83,0,1012,Monday
2021-05-10,China Ferry Terminal,0,0,0,0,0,0,0,0,Monday
2021-05-10,Harbour Control,0,0,0,0,0,0,0,0,Monday
2021-05-10,Macau Ferry Terminal,0,0,0,0,0,0,0,0,Monday
2021-05-10,Tuen Mun Ferry Terminal,0,0,0,0,0,0,0,0,Monday
2021-05-10,Total,1316,65,46,1427,1812,96,31,1939,Monday
2021-05-11,Airport,280,3,18,301,736,7,31,774,Tuesday
2021-05-11,Hung Hom,0,0,0,0,0,0,0,0,Tuesday
2021-05-11,Lo Wu,0,0,0,0,0,0,0,0,Tuesday
2021-05-11,Lok Ma Chau Spur Line,0,0,0,0,0,0,0,0,Tuesday
2021-05-11,Heung Yuen Wai,0,0,0,0,0,0,0,0,Tuesday
2021-05-11,Hong Kong-Zhuhai-Macao Bridge,94,2,1,97,170,20,2,192,Tuesday
2021-05-11,Lok Ma Chau,0,0,0,0,0,0,0,0,Tuesday
2021-05-11,Man Kam To,0,0,0,0,0,0,0,0,Tuesday
2021-05-11,Sha Tau Kok,0,0,0,0,0,0,0,0,Tuesday
2021-05-11,Shenzhen Bay,841,53,3,897,983,130,1,1114,Tuesday
2021-05-11,China Ferry Terminal,0,0,0,0,0,0,0,0,Tuesday
2021-05-11,Harbour Control,0,0,0,0,0,0,0,0,Tuesday
2021-05-11,Kai Tak Cruise Terminal,0,0,0,0,0,0,0,0,Tuesday
2021-05-11,Macau Ferry Terminal,0,0,0,0,0,0,0,0,Tuesday
2021-05-11,Tuen Mun Ferry Terminal,0,0,0,0,0,0,0,0,Tuesday
2021-05-11,Total,1215,58,22,1295,1889,157,34,2080,Tuesday
2021-05-12,Airport,497,11,22,530,657,6,8,671,Wednesday
2021-05-12,Express Rail Link West Kowloon,0,0,0,0,0,0,0,0,Wednesday
2021-05-12,Hung Hom,0,0,0,0,0,0,0,0,Wednesday
2021-05-12,Lo Wu,0,0,0,0,0,0,0,0,Wednesday
2021-05-12,Lok Ma Chau Spur Line,0,0,0,0,0,0,0,0,Wednesday
2021-05-12,Heung Yuen Wai,0,0,0,0,0,0,0,0,Wednesday
2021-05-12,Hong Kong-Zhuhai-Macao Bridge,127,3,1,131,211,11,1,223,Wednesday
2021-05-12,Lok Ma Chau,0,0,0,0,0,0,0,0,Wednesday
2021-05-12,Man Kam To,0,0,0,0,0,0,0,0,Wednesday
2021-05-12,Sha Tau Kok,0,0,0,0,0,0,0,0,Wednesday
2021-05-12,Shenzhen Bay,958,118,1,1077,880,158,3,1041,Wednesday
2021-05-12,China Ferry Terminal,0,0,0,0,0,0,0,0,Wednesday
2021-05-12,Harbour Control,0,0,0,0,0,0,0,0,Wednesday
2021-05-12,Macau Ferry Terminal,0,0,0,0,0,0,0,0,Wednesday
2021-05-12,Tuen Mun Ferry Terminal,0,0,0,0,0,0,0,0,Wednesday
2021-05-12,Total,1582,132,24,1738,1748,175,12,1935,Wednesday
2021-05-13,Airport,314,2,15,331,734,5,26,765,Thursday
2021-05-13,Express Rail Link West Kowloon,0,0,0,0,0,0,0,0,Thursday
2021-05-13,Hung Hom,0,0,0,0,0,0,0,0,Thursday
2021-05-13,Lo Wu,0,0,0,0,0,0,0,0,Thursday
2021-05-13,Lok Ma Chau Spur Line,0,0,0,0,0,0,0,0,Thursday
2021-05-13,Heung Yuen Wai,0,0,0,0,0,0,0,0,Thursday
2021-05-13,Hong Kong-Zhuhai-Macao Bridge,89,7,1,97,212,9,2,223,Thursday
2021-05-13,Lok Ma Chau,0,0,0,0,0,0,0,0,Thursday
2021-05-13,Man Kam To,0,0,0,0,0,0,0,0,Thursday
2021-05-13,Sha Tau Kok,0,0,0,0,0,0,0,0,Thursday
2021-05-13,Shenzhen Bay,812,59,2,873,843,89,2,934,Thursday
2021-05-13,China Ferry Terminal,0,0,0,0,0,0,0,0,Thursday
2021-05-13,Harbour Control,0,0,0,0,0,0,0,0,Thursday
2021-05-13,Kai Tak Cruise Terminal,0,0,0,0,0,0,0,0,Thursday
2021-05-13,Macau Ferry Terminal,0,0,0,0,0,0,0,0,Thursday
2021-05-13,Tuen Mun Ferry Terminal,0,0,0,0,0,0,0,0,Thursday
2021-05-13,Total,1215,68,18,1301,1789,103,30,1922,Thursday
2021-05-14,Airport,684,3,36,723,1043,16,45,1104,Friday
2021-05-14,Hung Hom,0,0,0,0,0,0,0,0,Friday
2021-05-14,Lo Wu,0,0,0,0,0,0,0,0,Friday
2021-05-14,Lok Ma Chau Spur Line,0,0,0,0,0,0,0,0,Friday
2021-05-14,Heung Yuen Wai,0,0,0,0,0,0,0,0,Friday
2021-05-14,Hong Kong-Zhuhai-Macao Bridge,104,2,0,106,160,10,2,172,Friday
2021-05-14,Lok Ma Chau,0,0,0,0,0,0,0,0,Friday
2021-05-14,Man Kam To,0,0,0,0,0,0,0,0,Friday
2021-05-14,Sha Tau Kok,0,0,0,0,0,0,0,0,Friday
2021-05-14,Shenzhen Bay,852,100,4,956,856,83,2,941,Friday
2021-05-14,China Ferry Terminal,0,0,0,0,0,0,0,0,Friday
2021-05-14,Harbour Control,0,0,0,0,0,0,0,0,Friday
2021-05-14,Kai Tak Cruise Terminal,0,0,0,0,0,0,0,0,Friday
2021-05-14,Macau Ferry Terminal,0,0,0,0,0,0,0,0,Friday
2021-05-14,Tuen Mun Ferry Terminal,0,0,0,0,0,0,0,0,Friday
2021-05-14,Total,1640,105,40,1785,2059,109,49,2217,Friday
2021-05-15,Airport,718,7,26,751,1049,10,27,1086,Saturday
2021-05-15,Express Rail Link West Kowloon,0,0,0,0,0,0,0,0,Saturday
2021-05-15,Hung Hom,0,0,0,0,0,0,0,0,Saturday
2021-05-15,Lo Wu,0,0,0,0,0,0,0,0,Saturday
2021-05-15,Lok Ma Chau Spur Line,0,0,0,0,0,0,0,0,Saturday
2021-05-15,Heung Yuen Wai,0,0,0,0,0,0,0,0,Saturday
2021-05-15,Hong Kong-Zhuhai-Macao Bridge,110,6,0,116,181,10,4,195,Saturday
2021-05-15,Lok Ma Chau,0,0,0,0,0,0,0,0,Saturday
2021-05-15,Man Kam To,0,0,0,0,0,0,0,0,Saturday
2021-05-15,Sha Tau Kok,0,0,0,0,0,0,0,0,Saturday
2021-05-15,Shenzhen Bay,1102,150,1,1253,1064,138,3,1205,Saturday
2021-05-15,China Ferry Terminal,0,0,0,0,0,0,0,0,Saturday
2021-05-15,Harbour Control,0,0,0,0,0,0,0,0,Saturday
2021-05-15,Kai Tak Cruise Terminal,0,0,0,0,0,0,0,0,Saturday
2021-05-15,Macau Ferry Terminal,0,0,0,0,0,0,0,0,Saturday
2021-05-15,Tuen Mun Ferry Terminal,0,0,0,0,0,0,0,0,Saturday
2021-05-15,Total,1930,163,27,2120,2294,158,34,2486,Saturday
2021-05-16,Airport,511,7,22,540,1090,10,66,1166,Sunday
2021-05-16,Hung Hom,0,0,0,0,0,0,0,0,Sunday
2021-05-16,Lo Wu,0,0,0,0,0,0,0,0,Sunday
2021-05-16,Heung Yuen Wai,0,0,0,0,0,0,0,0,Sunday
2021-05-16,Hong Kong-Zhuhai-Macao Bridge,127,7,1,135,175,13,2,190,Sunday
2021-05-16,Lok Ma Chau,0,0,0,0,0,0,0,0,Sunday
2021-05-16,Man Kam To,0,0,0,0,0,0,0,0,Sunday
2021-05-16,Sha Tau Kok,0,0,0,0,0,0,0,0,Sunday
2021-05-16,Shenzhen Bay,1271,154,1,1426,768,106,4,878,Sunday
2021-05-16,China Ferry Terminal,0,0,0,0,0,0,0,0,Sunday
2021-05-16,Harbour Control,0,0,0,0,0,0,0,0,Sunday
2021-05-16,Macau Ferry Terminal,0,0,0,0,0,0,0,0,Sunday
2021-05-16,Tuen Mun Ferry Terminal,0,0,0,0,0,0,0,0,Sunday
2021-05-16,Total,1909,168,24,2101,2033,129,72,2234,Sunday
2021-05-17,Airport,245,5,6,256,536,0,68,604,Monday
2021-05-17,Express Rail Link West Kowloon,0,0,0,0,0,0,0,0,Monday
2021-05-17,Hung Hom,0,0,0,0,0,0,0,0,Monday
2021-05-17,Lo Wu,0,0,0,0,0,0,0,0,Monday
2021-05-17,Lok Ma Chau Spur Line,0,0,0,0,0,0,0,0,Monday
2021-05-17,Heung Yuen Wai,0,0,0,0,0,0,0,0,Monday
2021-05-17,Hong Kong-Zhuhai-Macao Bridge,80,9,8,97,168,11,5,184,Monday
2021-05-17,Lok Ma Chau,0,0,0,0,0,0,0,0,Monday
2021-05-17,Man Kam To,0,0,0,0,0,0,0,0,Monday
2021-05-17,Sha Tau Kok,0,0,0,0,0,0,0,0,Monday
2021-05-17,Shenzhen Bay,779,188,0,967,955,102,0,1057,Monday
2021-05-17,China Ferry Terminal,0,0,0,0,0,0,0,0,Monday
2021-05-17,Harbour Control,0,0,0,0,0,0,0,0,Monday
2021-05-17,Kai Tak Cruise Terminal,0,0,0,0,0,0,0,0,Monday
2021-05-17,Macau Ferry Terminal,0,0,0,0,0,0,0,0,Monday
2021-05-17,Tuen Mun Ferry Terminal,0,0,0,0,0,0,0,0,Monday
2021-05-17,Total,1104,202,14,1320,1659,113,73,1845,Monday
2021-05-18,Airport,268,4,18,290,956,15,81,1052,Tuesday
2021-05-18,Hung Hom,0,0,0,0,0,0,0,0,Tuesday
2021-05-18,Lo Wu,0,0,0,0,0,0,0,0,Tuesday
2021-05-18,Lok Ma Chau Spur Line,0,0,0,0,0,0,0,0,Tuesday
2021-05-18,Heung Yuen Wai,0,0,0,0,0,0,0,0,Tuesday
2021-05-18,Hong Kong-Zhuhai-Macao Bridge,89,6,4,99,227,14,3,244,Tuesday
2021-05-18,Lok Ma Chau,0,0,0,0,0,0,0,0,Tuesday
2021-05-18,Man Kam To,0,0,0,0,0,0,0,0,Tuesday
2021-05-18,Sha Tau Kok,0,0,0,0,0,0,0,0,Tuesday
2021-05-18,Shenzhen Bay,899,160,2,1061,1061,173,1,1235,Tuesday
2021-05-18,China Ferry Terminal,0,0,0,0,0,0,0,0,Tuesday
2021-05-18,Harbour Control,0,0,0,0,0,0,0,0,Tuesday
2021-05-18,Kai Tak Cruise Terminal,0,0,0,0,0,0,0,0,Tuesday
2021-05-18,Macau Ferry Terminal,0,0,0,0,0,0,0,0,Tuesday
2021-05-18,Tuen Mun Ferry Terminal,0,0,0,0,0,0,0,0,Tuesday
2021-05-18,Total,1256,170,24,1450,2244,202,85,2531,Tuesday
2021-05-19,Airport,738,4,19,761,527,9,30,566,Wednesday
2021-05-19,Express Rail Link West Kowloon,0,0,0,0,0,0,0,0,Wednesday
2021-05-19,Hung Hom,0,0,0,0,0,0,0,0,Wednesday
2021-05-19,Lo Wu,0,0,0,0,0,0,0,0,Wednesday
2021-05-19,Lok Ma Chau Spur Line,0,0,0,0,0,0,0,0,Wednesday
2021-05-19,Heung Yuen Wai,0,0,0,0,0,0,0,0,Wednesday
2021-05-19,Hong Kong-Zhuhai-Macao Bridge,90,2,5,97,148,14,1,163,Wednesday
2021-05-19,Lok Ma Chau,0,0,0,0,0,0,0,0,Wednesday
2021-05-19,Man Kam To,0,0,0,0,0,0,0,0,Wednesday
2021-05-19,Sha Tau Kok,0,0,0,0,0,0,0,0,Wednesday
2021-05-19,Shenzhen Bay,1023,113,3,1139,972,122,1,1095,Wednesday
2021-05-19,China Ferry Terminal,0,0,0,0,0,0,0,0,Wednesday
2021-05-19,Harbour Control,0,0,0,0,0,0,0,0,Wednesday
2021-05-19,Macau Ferry Terminal,0,0,0,0,0,0,0,0,Wednesday
2021-05-19,Tuen Mun Ferry Terminal,0,0,0,0,0,0,0,0,Wednesday
2021-05-19,Total,1851,119,27,1997,1647,145,32,1824,Wednesday
2021-05-20,Airport,289,3,26,318,797,3,56,856,Thursday
2021-05-20,Express Rail Link West Kowloon,0,0,0,0,0,0,0,0,Thursday
2021-05-20,Hung Hom,0,0,0,0,0,0,0,0,Thursday
2021-05-20,Lo Wu,0,0,0,0,0,0,0,0,Thursday
2021-05-20,Lok Ma Chau Spur Line,0,0,0,0,0,0,0,0,Thursday
2021-05-20,Heung Yuen Wai,0,0,0,0,0,0,0,0,Thursday
2021-05-20,Hong Kong-Zhuhai-Macao Bridge,114,3,37,154,198,11,3,212,Thursday
2021-05-20,Lok Ma Chau,0,0,0,0,0,0,0,0,Thursday
2021-05-20,Man Kam To,0,0,0,0,0,0,0,0,Thursday
2021-05-20,Sha Tau Kok,0,0,0,0,0,0,0,0,Thursday
2021-05-20,Shenzhen Bay,1067,98,1,1166,819,91,3,913,Thursday
2021-05-20,China Ferry Terminal,0,0,0,0,0,0,0,0,Thursday
2021-05-20,Harbour Control,0,0,0,0,0,0,0,0,Thursday
2021-05-20,Kai Tak Cruise Terminal,0,0,0,0,0,0,0,0,Thursday
2021-05-20,Macau Ferry Terminal,0,0,0,0,0,0,0,0,Thursday
2021-05-20,Tuen Mun Ferry Terminal,0,0,0,0,0,0,0,0,Thursday
2021-05-20,Total,1470,104,64,1638,1814,105,62,1981,Thursday
2021-05-21,Airport,758,12,9,779,884,29,26,939,Friday
2021-05-21,Express Rail Link West Kowloon,0,0,0,0,0,0,0,0,Friday
2021-05-21,Hung Hom,0,0,0,0,0,0,0,0,Friday
2021-05-21,Lo Wu,0,0,0,0,0,0,0,0,Friday
2021-05-21,Lok Ma Chau Spur Line,0,0,0,0,0,0,0,0,Friday
2021-05-21,Heung Yuen Wai,0,0,0,0,0,0,0,0,Friday
2021-05-21,Lok Ma Chau,0,0,0,0,0,0,0,0,Friday
2021-05-21,Man Kam To,0,0,0,0,0,0,0,0,Friday
2021-05-21,Sha Tau Kok,0,0,0,0,0,0,0,0,Friday
2021-05-21,Shenzhen Bay,987,98,1,1086,808,84,1,893,Friday
2021-05-21,China Ferry Terminal,0,0,0,0,0,0,0,0,Friday
2021-05-21,Kai Tak Cruise Terminal,0,0,0,0,0,0,0,0,Friday
2021-05-21,Macau Ferry Terminal,0,0,0,0,0,0,0,0,Friday
2021-05-21,Total,1846,114,13,1973,1898,126,27,2051,Friday
2021-05-22,Airport,695,4,5,704,864,11,17,892,Saturday
2021-05-22,Express Rail Link West Kowloon,0,0,0,0,0,0,0,0,Saturday
2021-05-22,Hung Hom,0,0,0,0,0,0,0,0,Saturday
2021-05-22,Lo Wu,0,0,0,0,0,0,0,0,Saturday
2021-05-22,Lok Ma Chau Spur Line,0,0,0,0,0,0,0,0,Saturday
2021-05-22,Heung Yuen Wai,0,0,0,0,0,0,0,0,Saturday
2021-05-22,Hong Kong-Zhuhai-Macao Bridge,112,4,4,120,135,6,4,145,Saturday
2021-05-22,Lok Ma Chau,0,0,0,0,0,0,0,0,Saturday
2021-05-22,Man Kam To,0,0,0,0,0,0,0,0,Saturday
2021-05-22,Sha Tau Kok,0,0,0,0,0,0,0,0,Saturday
2021-05-22,Shenzhen Bay,1229,144,1,1374,903,96,3,1002,Saturday
2021-05-22,China Ferry Terminal,0,0,0,0,0,0,0,0,Saturday
2021-05-22,Harbour Control,0,0,0,0,0,0,0,0,Saturday
2021-05-22,Kai Tak Cruise Terminal,0,0,0,0,0,0,0,0,Saturday
2021-05-22,Macau Ferry Terminal,0,0,0,0,0,0,0,0,Saturday
2021-05-22,Tuen Mun Ferry Terminal,0,0,0,0,0,0,0,0,Saturday
2021-05-22,Total,2036,152,10,2198,1902,113,24,2039,Saturday
2021-05-23,Airport,658,6,15,679,890,1,28,919,Sunday
2021-05-23,Hung Hom,0,0,0,0,0,0,0,0,Sunday
2021-05-23,Lo Wu,0,0,0,0,0,0,0,0,Sunday
2021-05-23,Lok Ma Chau Spur Line,0,0,0,0,0,0,0,0,Sunday
2021-05-23,Heung Yuen Wai,0,0,0,0,0,0,0,0,Sunday
2021-05-23,Hong Kong-Zhuhai-Macao Bridge,88,4,3,95,117,9,5,131,Sunday
2021-05-23,Lok Ma Chau,0,0,0,0,0,0,0,0,Sunday
2021-05-23,Man Kam To,0,0,0,0,0,0,0,0,Sunday
2021-05-23,Sha Tau Kok,0,0,0,0,0,0,0,0,Sunday
2021-05-23,Shenzhen Bay,902,134,3,1039,579,80,2,661,Sunday
2021-05-23,China Ferry Terminal,0,0,0,0,0,0,0,0,Sunday
2021-05-23,Harbour Control,0,0,0,0,0,0,0,0,Sunday
2021-05-23,Kai Tak Cruise Terminal,0,0,0,0,0,0,0,0,Sunday
2021-05-23,Macau Ferry Terminal,0,0,0,0,0,0,0,0,Sunday
2021-05-23,Tuen Mun Ferry Terminal,0,0,0,0,0,0,0,0,Sunday
2021-05-23,Total,1648,144,21,1813,1586,90,35,1711,Sunday
2021-05-24,Airport,365,2,5,372,530,2,21,553,Monday
2021-05-24,Express Rail Link West Kowloon,0,0,0,0,0,0,0,0,Monday
2021-05-24,Hung Hom,0,0,0,0,0,0,0,0,Monday
2021-05-24,Lo Wu,0,0,0,0,0,0,0,0,Monday
2021-05-24,Lok Ma Chau Spur Line,0,0,0,0,0,0,0,0,Monday
2021-05-24,Heung Yuen Wai,0,0,0,0,0,0,0,0,Monday
2021-05-24,Hong Kong-Zhuhai-Macao Bridge,91,4,2,97,142,9,1,152,Monday
2021-05-24,Lok Ma Chau,0,0,0,0,0,0,0,0,Monday
2021-05-24,Man Kam To,0,0,0,0,0,0,0,0,Monday
2021-05-24,Sha Tau Kok,0,0,0,0,0,0,0,0,Monday
2021-05-24,Shenzhen Bay,923,82,2,1007,717,68,1,786,Monday
2021-05-24,China Ferry Terminal,0,0,0,0,0,0,0,0,Monday
2021-05-24,Harbour Control,0,0,0,0,0,0,0,0,Monday
2021-05-24,Kai Tak Cruise Terminal,0,0,0,0,0,0,0,0,Monday
2021-05-24,Macau Ferry Terminal,0,0,0,0,0,0,0,0,Monday
2021-05-24,Tuen Mun Ferry Terminal,0,0,0,0,0,0,0,0,Monday
2021-05-24,Total,1379,88,9,1476,1389,79,23,1491,Monday
2021-05-25,Airport,320,7,2,329,843,7,39,889,Tuesday
2021-05-25,Hung Hom,0,0,0,0,0,0,0,0,Tuesday
2021-05-25,Lo Wu,0,0,0,0,0,0,0,0,Tuesday
2021-05-25,Lok Ma Chau Spur Line,0,0,0,0,0,0,0,0,Tuesday
2021-05-25,Heung Yuen Wai,0,0,0,0,0,0,0,0,Tuesday
2021-05-25,Hong Kong-Zhuhai-Macao Bridge,141,1,1,143,190,9,5,204,Tuesday
2021-05-25,Lok Ma Chau,0,0,0,0,0,0,0,0,Tuesday
2021-05-25,Man Kam To,0,0,0,0,0,0,0,0,Tuesday
2021-05-25,Sha Tau Kok,0,0,0,0,0,0,0,0,Tuesday
2021-05-25,Shenzhen Bay,1113,111,1,1225,914,114,6,1034,Tuesday
2021-05-25,China Ferry Terminal,0,0,0,0,0,0,0,0,Tuesday
2021-05-25,Harbour Control,0,0,0,0,0,0,0,0,Tuesday
2021-05-25,Kai Tak Cruise Terminal,0,0,0,0,0,0,0,0,Tuesday
2021-05-25,Macau Ferry Terminal,0,0,0,0,0,0,0,0,Tuesday
2021-05-25,Tuen Mun Ferry Terminal,0,0,0,0,0,0,0,0,Tuesday
2021-05-25,Total,1574,119,4,1697,1947,130,50,2127,Tuesday
2021-05-26,Airport,649,4,27,680,610,4,43,657,Wednesday
2021-05-26,Express Rail Link West Kowloon,0,0,0,0,0,0,0,0,Wednesday
2021-05-26,Hung Hom,0,0,0,0,0,0,0,0,Wednesday
2021-05-26,Lo Wu,0,0,0,0,0,0,0,0,Wednesday
2021-05-26,Lok Ma Chau Spur Line,0,0,0,0,0,0,0,0,Wednesday
2021-05-26,Heung Yuen Wai,0,0,0,0,0,0,0,0,Wednesday
2021-05-26,Hong Kong-Zhuhai-Macao Bridge,171,3,3,177,178,12,4,194,Wednesday
2021-05-26,Lok Ma Chau,0,0,0,0,0,0,0,0,Wednesday
2021-05-26,Man Kam To,0,0,0,0,0,0,0,0,Wednesday
2021-05-26,Sha Tau Kok,0,0,0,0,0,0,0,0,Wednesday
2021-05-26,Shenzhen Bay,1170,122,0,1292,727,93,2,822,Wednesday
2021-05-26,China Ferry Terminal,0,0,0,0,0,0,0,0,Wednesday
2021-05-26,Harbour Control,0,0,0,0,0,0,0,0,Wednesday
2021-05-26,Macau Ferry Terminal,0,0,0,0,0,0,0,0,Wednesday
2021-05-26,Tuen Mun Ferry Terminal,0,0,0,0,0,0,0,0,Wednesday
2021-05-26,Total,1990,129,30,2149,1515,109,49,1673,Wednesday
2021-05-27,Airport,143,10,10,163,840,5,80,925,Thursday
2021-05-27,Express Rail Link West Kowloon,0,0,0,0,0,0,0,0,Thursday
2021-05-27,Hung Hom,0,0,0,0,0,0,0,0,Thursday
2021-05-27,Heung Yuen Wai,0,0,0,0,0,0,0,0,Thursday
2021-05-27,Hong Kong-Zhuhai-Macao Bridge,138,4,36,178,173,9,3,185,Thursday
2021-05-27,Lok Ma Chau,0,0,0,0,0,0,0,0,Thursday
2021-05-27,Man Kam To,0,0,0,0,0,0,0,0,Thursday
2021-05-27,Sha Tau Kok,0,0,0,0,0,0,0,0,Thursday
2021-05-27,Shenzhen Bay,979,133,3,1115,670,83,3,756,Thursday
2021-05-27,China Ferry Terminal,0,0,0,0,0,0,0,0,Thursday
2021-05-27,Harbour Control,0,0,0,0,0,0,0,0,Thursday
2021-05-27,Kai Tak Cruise Terminal,0,0,0,0,0,0,0,0,Thursday
2021-05-27,Macau Ferry Terminal,0,0,0,0,0,0,0,0,Thursday
2021-05-27,Tuen Mun Ferry Terminal,0,0,0,0,0,0,0,0,Thursday
2021-05-27,Total,1260,147,49,1456,1683,97,86,1866,Thursday
2021-05-28,Airport,863,12,19,894,996,24,35,1055,Friday
2021-05-28,Express Rail Link West Kowloon,0,0,0,0,0,0,0,0,Friday
2021-05-28,Hung Hom,0,0,0,0,0,0,0,0,Friday
2021-05-28,Lo Wu,0,0,0,0,0,0,0,0,Friday
2021-05-28,Lok Ma Chau Spur Line,0,0,0,0,0,0,0,0,Friday
2021-05-28,Heung Yuen Wai,0,0,0,0,0,0,0,0,Friday
2021-05-28,Lok Ma Chau,0,0,0,0,0,0,0,0,Friday
2021-05-28,Man Kam To,0,0,0,0,0,0,0,0,Friday
2021-05-28,Sha Tau Kok,0,0,0,0,0,0,0,0,Friday
2021-05-28,Shenzhen Bay,1256,124,4,1384,743,80,4,827,Friday
2021-05-28,China Ferry Terminal,0,0,0,0,0,0,0,0,Friday
2021-05-28,Harbour Control,0,0,0,0,0,0,0,0,Friday
2021-05-28,Kai Tak Cruise Terminal,0,0,0,0,0,0,0,0,Friday
2021-05-28,Macau Ferry Terminal,0,0,0,0,0,0,0,0,Friday
2021-05-28,Tuen Mun Ferry Terminal,0,0,0,0,0,0,0,0,Friday
2021-05-28,Total,2276,147,27,2450,1951,115,39,2105,Friday
2021-05-29,Airport,809,9,13,831,946,27,16,989,Saturday
2021-05-29,Express Rail Link West Kowloon,0,0,0,0,0,0,0,0,Saturday
2021-05-29,Hung Hom,0,0,0,0,0,0,0,0,Saturday
2021-05-29,Lo Wu,0,0,0,0,0,0,0,0,Saturday
2021-05-29,Lok Ma Chau Spur Line,0,0,0,0,0,0,0,0,Saturday
2021-05-29,Heung Yuen Wai,0,0,0,0,0,0,0,0,Saturday
2021-05-29,Hong Kong-Zhuhai-Macao Bridge,121,5,5,131,161,18,1,180,Saturday
2021-05-29,Lok Ma Chau,0,0,0,0,0,0,0,0,Saturday
2021-05-29,Man Kam To,0,0,0,0,0,0,0,0,Saturday
2021-05-29,Sha Tau Kok,0,0,0,0,0,0,0,0,Saturday
2021-05-29,Shenzhen Bay,1048,125,0,1173,677,83,3,763,Saturday
2021-05-29,China Ferry Terminal,0,0,0,0,0,0,0,0,Saturday
2021-05-29,Harbour Control,0,0,0,0,0,0,0,0,Saturday
2021-05-29,Kai Tak Cruise Terminal,0,0,0,0,0,0,0,0,Saturday
2021-05-29,Macau Ferry Terminal,0,0,0,0,0,0,0,0,Saturday
2021-05-29,Tuen Mun Ferry Terminal,0,0,0,0,0,0,0,0,Saturday
2021-05-29,Total,1978,139,18,2135,1784,128,20,1932,Saturday
2021-05-30,Airport,759,8,22,789,1115,9,56,1180,Sunday
2021-05-30,Hung Hom,0,0,0,0,0,0,0,0,Sunday
2021-05-30,Lo Wu,0,0,0,0,0,0,0,0,Sunday
2021-05-30,Lok Ma Chau Spur Line,0,0,0,0,0,0,0,0,Sunday
2021-05-30,Heung Yuen Wai,0,0,0,0,0,0,0,0,Sunday
2021-05-30,Hong Kong-Zhuhai-Macao Bridge,120,10,4,134,179,14,2,195,Sunday
2021-05-30,Lok Ma Chau,0,0,0,0,0,0,0,0,Sunday
2021-05-30,Man Kam To,0,0,0,0,0,0,0,0,Sunday
2021-05-30,Sha Tau Kok,0,0,0,0,0,0,0,0,Sunday
2021-05-30,Shenzhen Bay,1136,119,3,1258,604,93,0,697,Sunday
2021-05-30,China Ferry Terminal,0,0,0,0,0,0,0,0,Sunday
2021-05-30,Harbour Control,0,0,0,0,0,0,0,0,Sunday
2021-05-30,Kai Tak Cruise Terminal,0,0,0,0,0,0,0,0,Sunday
2021-05-30,Macau Ferry Terminal,0,0,0,0,0,0,0,0,Sunday
2021-05-30,Tuen Mun Ferry Terminal,0,0,0,0,0,0,0,0,Sunday
2021-05-30,Total,2015,137,29,2181,1898,116,58,2072,Sunday
2021-06-24,Airport,542,33,10,585,1520,43,28,1591,Thursday
2021-06-24,Express Rail Link West Kowloon,0,0,0,0,0,0,0,0,Thursday
2021-06-24,Hung Hom,0,0,0,0,0,0,0,0,Thursday
2021-06-24,Lo Wu,0,0,0,0,0,0,0,0,Thursday
2021-06-24,Lok Ma Chau Spur Line,0,0,0,0,0,0,0,0,Thursday
2021-06-24,Heung Yuen Wai,0,0,0,0,0,0,0,0,Thursday
2021-06-24,Hong Kong-Zhuhai-Macao Bridge,143,6,10,159,188,12,1,201,Thursday
2021-06-24,Lok Ma Chau,0,0,0,0,0,0,0,0,Thursday
2021-06-24,Man Kam To,0,0,0,0,0,0,0,0,Thursday
2021-06-24,Sha Tau Kok,0,0,0,0,0,0,0,0,Thursday
2021-06-24,Shenzhen Bay,652,71,1,724,475,68,2,545,Thursday
2021-06-24,China Ferry Terminal,0,0,0,0,0,0,0,0,Thursday
2021-06-24,Harbour Control,0,0,0,0,0,0,0,0,Thursday
2021-06-24,Kai Tak Cruise Terminal,0,0,0,0,0,0,0,0,Thursday
2021-06-24,Macau Ferry Terminal,0,0,0,0,0,0,0,0,Thursday
2021-06-24,Tuen Mun Ferry Terminal,0,0,0,0,0,0,0,0,Thursday
2021-06-24,Total,1337,110,21,1468,2183,123,31,2337,Thursday
2021-06-23,Airport,706,7,14,727,875,9,38,922,Wednesday
2021-06-23,Express Rail Link West Kowloon,0,0,0,0,0,0,0,0,Wednesday
2021-06-23,Hung Hom,0,0,0,0,0,0,0,0,Wednesday
2021-06-23,Lo Wu,0,0,0,0,0,0,0,0,Wednesday
2021-06-23,Lok Ma Chau Spur Line,0,0,0,0,0,0,0,0,Wednesday
2021-06-23,Heung Yuen Wai,0,0,0,0,0,0,0,0,Wednesday
2021-06-23,Hong Kong-Zhuhai-Macao Bridge,145,11,18,174,204,10,2,216,Wednesday
2021-06-23,Lok Ma Chau,0,0,0,0,0,0,0,0,Wednesday
2021-06-23,Man Kam To,0,0,0,0,0,0,0,0,Wednesday
2021-06-23,Sha Tau Kok,0,0,0,0,0,0,0,0,Wednesday
2021-06-23,Shenzhen Bay,802,127,2,931,436,103,2,541,Wednesday
2021-06-23,China Ferry Terminal,0,0,0,0,0,0,0,0,Wednesday
2021-06-23,Harbour Control,0,0,0,0,0,0,0,0,Wednesday
2021-06-23,Kai Tak Cruise Terminal,0,0,0,0,0,0,0,0,Wednesday
2021-06-23,Macau Ferry Terminal,0,0,0,0,0,0,0,0,Wednesday
2021-06-23,Tuen Mun Ferry Terminal,0,0,0,0,0,0,0,0,Wednesday
2021-06-23,Total,1653,145,34,1832,1515,122,42,1679,Wednesday
2021-06-22,Airport,645,17,11,673,1159,35,34,1228,Tuesday
2021-06-22,Express Rail Link West Kowloon,0,0,0,0,0,0,0,0,Tuesday
2021-06-22,Hung Hom,0,0,0,0,0,0,0,0,Tuesday
2021-06-22,Lo Wu,0,0,0,0,0,0,0,0,Tuesday
2021-06-22,Lok Ma Chau Spur Line,0,0,0,0,0,0,0,0,Tuesday
2021-06-22,Heung Yuen Wai,0,0,0,0,0,0,0,0,Tuesday
2021-06-22,Hong Kong-Zhuhai-Macao Bridge,157,3,5,165,202,23,2,227,Tuesday
2021-06-22,Lok Ma Chau,0,0,0,0,0,0,0,0,Tuesday
2021-06-22,Man Kam To,0,0,0,0,0,0,0,0,Tuesday
2021-06-22,Sha Tau Kok,0,0,0,0,0,0,0,0,Tuesday
2021-06-22,Shenzhen Bay,761,133,4,898,502,93,1,596,Tuesday
2021-06-22,China Ferry Terminal,0,0,0,0,0,0,0,0,Tuesday
2021-06-22,Harbour Control,0,0,0,0,0,0,0,0,Tuesday
2021-06-22,Kai Tak Cruise Terminal,0,0,0,0,0,0,0,0,Tuesday
2021-06-22,Macau Ferry Terminal,0,0,0,0,0,0,0,0,Tuesday
2021-06-22,Tuen Mun Ferry Terminal,0,0,0,0,0,0,0,0,Tuesday
2021-06-22,Total,1563,153,20,1736,1863,151,37,2051,Tuesday
2021-06-21,Airport,627,3,13,643,806,63,13,882,Monday
2021-06-21,Express Rail Link West Kowloon,0,0,0,0,0,0,0,0,Monday
2021-06-21,Hung Hom,0,0,0,0,0,0,0,0,Monday
2021-06-21,Lo Wu,0,0,0,0,0,0,0,0,Monday
2021-06-21,Lok Ma Chau Spur Line,0,0,0,0,0,0,0,0,Monday
2021-06-21,Heung Yuen Wai,0,0,0,0,0,0,0,0,Monday
2021-06-21,Hong Kong-Zhuhai-Macao Bridge,117,11,3,131,223,12,0,235,Monday
2021-06-21,Lok Ma Chau,0,0,0,0,0,0,0,0,Monday
2021-06-21,Man Kam To,0,0,0,0,0,0,0,0,Monday
2021-06-21,Sha Tau Kok,0,0,0,0,0,0,0,0,Monday
2021-06-21,Shenzhen Bay,716,71,2,789,544,87,2,633,Monday
2021-06-21,China Ferry Terminal,0,0,0,0,0,0,0,0,Monday
2021-06-21,Harbour Control,0,0,0,0,0,0,0,0,Monday
2021-06-21,Kai Tak Cruise Terminal,0,0,0,0,0,0,0,0,Monday
2021-06-21,Macau Ferry Terminal,0,0,0,0,0,0,0,0,Monday
2021-06-21,Tuen Mun Ferry Terminal,0,0,0,0,0,0,0,0,Monday
2021-06-21,Total,1460,85,18,1563,1573,162,15,1750,Monday
2021-06-20,Airport,1522,26,31,1579,1408,29,21,1458,Sunday
2021-06-20,Express Rail Link West Kowloon,0,0,0,0,0,0,0,0,Sunday
2021-06-20,Hung Hom,0,0,0,0,0,0,0,0,Sunday
2021-06-20,Lo Wu,0,0,0,0,0,0,0,0,Sunday
2021-06-20,Lok Ma Chau Spur Line,0,0,0,0,0,0,0,0,Sunday
2021-06-20,Heung Yuen Wai,0,0,0,0,0,0,0,0,Sunday
2021-06-20,Hong Kong-Zhuhai-Macao Bridge,135,5,1,141,149,50,7,206,Sunday
2021-06-20,Lok Ma Chau,0,0,0,0,0,0,0,0,Sunday
2021-06-20,Man Kam To,0,0,0,0,0,0,0,0,Sunday
2021-06-20,Sha Tau Kok,0,0,0,0,0,0,0,0,Sunday
2021-06-20,Shenzhen Bay,865,125,2,992,449,274,0,723,Sunday
2021-06-20,China Ferry Terminal,0,0,0,0,0,0,0,0,Sunday
2021-06-20,Harbour Control,0,0,0,0,0,0,0,0,Sunday
2021-06-20,Kai Tak Cruise Terminal,0,0,0,0,0,0,0,0,Sunday
2021-06-20,Macau Ferry Terminal,0,0,0,0,0,0,0,0,Sunday
2021-06-20,Tuen Mun Ferry Terminal,0,0,0,0,0,0,0,0,Sunday
2021-06-20,Total,2522,156,34,2712,2006,353,28,2387,Sunday
2021-06-19,Airport,957,10,8,975,1455,22,23,1500,Saturday
2021-06-19,Express Rail Link West Kowloon,0,0,0,0,0,0,0,0,Saturday
2021-06-19,Hung Hom,0,0,0,0,0,0,0,0,Saturday
2021-06-19,Lo Wu,0,0,0,0,0,0,0,0,Saturday
2020-07-06,Airport,843,4,46,893,312,2,110,424,Monday
2020-07-06,Hung Hom,0,0,0,0,0,0,0,0,Monday
2020-07-06,Lo Wu,0,0,0,0,0,0,0,0,Monday
2020-07-06,Lok Ma Chau Spur Line,1133,0,0,1133,1133,0,0,1133,Monday
2020-07-06,Hong Kong-Zhuhai-Macao Bridge,106,2,3,111,113,6,4,123,Monday
2020-07-06,Lok Ma Chau,0,0,0,0,0,0,0,0,Monday
2020-07-06,Man Kam To,0,0,0,0,0,0,0,0,Monday
2020-07-06,Sha Tau Kok,0,0,0,0,0,0,0,0,Monday
2020-07-06,Shenzhen Bay,1318,137,16,1471,1040,117,16,1173,Monday
2020-07-06,China Ferry Terminal,0,0,0,0,0,0,0,0,Monday
2020-07-06,Harbour Control,0,0,0,0,0,0,0,0,Monday
2020-07-06,Kai Tak Cruise Terminal,0,0,0,0,0,0,0,0,Monday
2020-07-06,Macau Ferry Terminal,0,0,0,0,0,0,0,0,Monday
2020-07-06,Tuen Mun Ferry Terminal,0,0,0,0,0,0,0,0,Monday
2020-07-06,Total,3400,143,65,3608,2598,125,130,2853,Monday
2020-07-06,Express Rail Link West Kowloon,0,0,0,0,0,0,0,0,Monday
2020-05-01,Lok Ma Chau Spur Line,0,0,0,0,0,0,0,0,Friday
2020-05-01,Kai Tak Cruise Terminal,0,0,0,0,0,0,0,0,Friday
2020-01-24,Express Rail Link West Kowloon,1717,2380,337,4434,20096,2800,316,23212,Friday
2020-01-27,Express Rail Link West Kowloon,10913,1887,421,13221,1167,2790,246,4203,Monday
2020-02-03,Tuen Mun Ferry Terminal,0,0,0,0,0,0,0,0,Monday
2020-02-04,Hung Hom,0,0,0,0,0,0,0,0,Tuesday
2020-02-04,Lok Ma Chau Spur Line,0,0,0,0,0,0,0,0,Tuesday
2020-02-05,Kai Tak Cruise Terminal,175,12,31,218,2,2,0,4,Wednesday
2020-02-07,Hong Kong-Zhuhai-Macao Bridge,6699,628,1340,8667,2576,1102,798,4476,Friday
2020-02-09,Express Rail Link West Kowloon,0,0,0,0,0,0,0,0,Sunday
2020-02-09,Tuen Mun Ferry Terminal,0,0,0,0,0,0,0,0,Sunday
2020-02-10,Express Rail Link West Kowloon,0,0,0,0,0,0,0,0,Monday
2020-02-12,Express Rail Link West Kowloon,0,0,0,0,0,0,0,0,Wednesday
2020-02-13,Tuen Mun Ferry Terminal,0,0,0,0,0,0,0,0,Thursday
2020-02-15,Hong Kong-Zhuhai-Macao Bridge,1183,5,524,1712,1060,119,486,1665,Saturday
2020-02-15,Harbour Control,0,0,0,0,0,0,0,0,Saturday
2020-02-15,Kai Tak Cruise Terminal,0,0,0,0,0,0,0,0,Saturday
2020-02-17,Express Rail Link West Kowloon,0,0,0,0,0,0,0,0,Monday
2020-02-19,Express Rail Link West Kowloon,0,0,0,0,0,0,0,0,Wednesday
2020-02-20,Kai Tak Cruise Terminal,0,0,0,0,0,0,0,0,Thursday
2020-02-21,Sha Tau Kok,0,0,0,0,0,0,0,0,Friday
2020-02-21,Kai Tak Cruise Terminal,0,0,0,0,0,0,0,0,Friday
2020-02-23,Express Rail Link West Kowloon,0,0,0,0,0,0,0,0,Sunday
2020-02-25,Express Rail Link West Kowloon,0,0,0,0,0,0,0,0,Tuesday
2020-02-26,Kai Tak Cruise Terminal,0,0,0,0,0,0,0,0,Wednesday
2020-02-27,Hong Kong-Zhuhai-Macao Bridge,3420,20,616,4056,3672,99,670,4441,Thursday
2020-02-28,Hong Kong-Zhuhai-Macao Bridge,4763,8,865,5636,4669,90,663,5422,Friday
2020-03-01,Express Rail Link West Kowloon,0,0,0,0,0,0,0,0,Sunday
2020-03-03,Express Rail Link West Kowloon,0,0,0,0,0,0,0,0,Tuesday
2020-03-04,Hung Hom,0,0,0,0,0,0,0,0,Wednesday
2020-03-04,Lok Ma Chau Spur Line,0,0,0,0,0,0,0,0,Wednesday
2020-03-05,Macau Ferry Terminal,0,0,0,0,0,0,0,0,Thursday
2020-03-07,Hong Kong-Zhuhai-Macao Bridge,5935,26,973,6934,6440,132,903,7475,Saturday
2020-03-09,Express Rail Link West Kowloon,0,0,0,0,0,0,0,0,Monday
2020-03-10,Airport,7051,663,1531,9245,3802,142,914,4858,Tuesday
2020-03-10,Express Rail Link West Kowloon,0,0,0,0,0,0,0,0,Tuesday
2020-03-11,Kai Tak Cruise Terminal,0,0,0,0,0,0,0,0,Wednesday
2020-03-13,Hong Kong-Zhuhai-Macao Bridge,6872,19,945,7836,6694,142,939,7775,Friday
2020-03-15,Express Rail Link West Kowloon,0,0,0,0,0,0,0,0,Sunday
2020-03-15,Kai Tak Cruise Terminal,0,0,0,0,0,0,0,0,Sunday
2020-03-16,Express Rail Link West Kowloon,0,0,0,0,0,0,0,0,Monday
2020-03-17,Macau Ferry Terminal,0,0,0,0,0,0,0,0,Tuesday
2020-03-19,Hong Kong-Zhuhai-Macao Bridge,4687,22,352,5061,4824,46,423,5293,Thursday
2020-03-21,Express Rail Link West Kowloon,0,0,0,0,0,0,0,0,Saturday
2020-03-21,Shenzhen Bay,904,239,5,1148,1384,457,113,1954,Saturday
2020-03-21,Kai Tak Cruise Terminal,0,0,0,0,0,0,0,0,Saturday
2020-03-23,Express Rail Link West Kowloon,0,0,0,0,0,0,0,0,Monday
2020-03-25,Express Rail Link West Kowloon,0,0,0,0,0,0,0,0,Wednesday
2020-03-26,Tuen Mun Ferry Terminal,0,0,0,0,0,0,0,0,Thursday
2020-03-27,Hong Kong-Zhuhai-Macao Bridge,124,9,17,150,697,120,170,987,Friday
2020-03-27,Kai Tak Cruise Terminal,0,0,0,0,0,0,0,0,Friday
2020-03-29,Express Rail Link West Kowloon,0,0,0,0,0,0,0,0,Sunday
2020-03-31,Express Rail Link West Kowloon,0,0,0,0,0,0,0,0,Tuesday
2020-04-01,Kai Tak Cruise Terminal,0,0,0,0,0,0,0,0,Wednesday
2020-04-02,Hung Hom,0,0,0,0,0,0,0,0,Thursday
2020-04-02,Lok Ma Chau Spur Line,0,0,0,0,0,0,0,0,Thursday
2020-04-03,Hong Kong-Zhuhai-Macao Bridge,59,6,4,69,59,7,6,72,Friday
2020-04-05,Express Rail Link West Kowloon,0,0,0,0,0,0,0,0,Sunday
2020-04-07,Express Rail Link West Kowloon,0,0,0,0,0,0,0,0,Tuesday
2020-04-08,Airport,835,6,24,865,361,14,59,434,Wednesday
2020-04-08,Express Rail Link West Kowloon,0,0,0,0,0,0,0,0,Wednesday
2020-04-10,Express Rail Link West Kowloon,0,0,0,0,0,0,0,0,Friday
2020-04-11,Kai Tak Cruise Terminal,0,0,0,0,0,0,0,0,Saturday
2020-04-13,Express Rail Link West Kowloon,0,0,0,0,0,0,0,0,Monday
2020-04-13,Macau Ferry Terminal,0,0,0,0,0,0,0,0,Monday
2020-04-14,Express Rail Link West Kowloon,0,0,0,0,0,0,0,0,Tuesday
2020-04-15,Kai Tak Cruise Terminal,0,0,0,0,0,0,0,0,Wednesday
2020-04-17,Hong Kong-Zhuhai-Macao Bridge,24,4,2,30,27,2,2,31,Friday
2020-04-19,Express Rail Link West Kowloon,0,0,0,0,0,0,0,0,Sunday
2020-04-19,China Ferry Terminal,0,0,0,0,0,0,0,0,Sunday
2020-04-20,Hong Kong-Zhuhai-Macao Bridge,40,0,1,41,12,1,0,13,Monday
2020-04-22,Hong Kong-Zhuhai-Macao Bridge,47,3,1,51,11,4,1,16,Wednesday
2020-04-24,Express Rail Link West Kowloon,0,0,0,0,0,0,0,0,Friday
2020-04-25,Lok Ma Chau,0,0,0,0,0,0,0,0,Saturday
2020-04-25,China Ferry Terminal,0,0,0,0,0,0,0,0,Saturday
2020-04-27,Express Rail Link West Kowloon,0,0,0,0,0,0,0,0,Monday
2020-04-28,Tuen Mun Ferry Terminal,0,0,0,0,0,0,0,0,Tuesday
2020-04-30,Hong Kong-Zhuhai-Macao Bridge,37,6,2,45,31,2,3,36,Thursday
2020-05-03,Express Rail Link West Kowloon,0,0,0,0,0,0,0,0,Sunday
2020-05-05,Express Rail Link West Kowloon,0,0,0,0,0,0,0,0,Tuesday
2020-05-06,Kai Tak Cruise Terminal,0,0,0,0,0,0,0,0,Wednesday
2020-05-07,Express Rail Link West Kowloon,0,0,0,0,0,0,0,0,Thursday
2020-05-08,Express Rail Link West Kowloon,0,0,0,0,0,0,0,0,Friday
2020-05-10,Express Rail Link West Kowloon,0,0,0,0,0,0,0,0,Sunday
2020-05-11,Tuen Mun Ferry Terminal,0,0,0,0,0,0,0,0,Monday
2020-05-12,Tuen Mun Ferry Terminal,0,0,0,0,0,0,0,0,Tuesday
2020-05-13,China Ferry Terminal,0,0,0,0,0,0,0,0,Wednesday
2020-05-15,Express Rail Link West Kowloon,0,0,0,0,0,0,0,0,Friday
2020-05-17,Express Rail Link West Kowloon,0,0,0,0,0,0,0,0,Sunday
2020-05-18,Harbour Control,0,0,0,0,0,0,0,0,Monday
2020-05-19,Hong Kong-Zhuhai-Macao Bridge,68,5,10,83,20,1,1,22,Tuesday
2020-05-21,Express Rail Link West Kowloon,0,0,0,0,0,0,0,0,Thursday
2020-05-23,Express Rail Link West Kowloon,0,0,0,0,0,0,0,0,Saturday
2020-05-24,Man Kam To,0,0,0,0,0,0,0,0,Sunday
2020-05-25,Express Rail Link West Kowloon,0,0,0,0,0,0,0,0,Monday
2020-05-26,Kai Tak Cruise Terminal,0,0,0,0,0,0,0,0,Tuesday
2020-05-28,Express Rail Link West Kowloon,0,0,0,0,0,0,0,0,Thursday
2020-05-30,Express Rail Link West Kowloon,0,0,0,0,0,0,0,0,Saturday
2020-05-30,Lok Ma Chau Spur Line,0,0,0,0,0,0,0,0,Saturday
2020-05-31,Express Rail Link West Kowloon,0,0,0,0,0,0,0,0,Sunday
2020-06-02,Express Rail Link West Kowloon,0,0,0,0,0,0,0,0,Tuesday
2020-06-03,Tuen Mun Ferry Terminal,0,0,0,0,0,0,0,0,Wednesday
2020-06-05,Express Rail Link West Kowloon,0,0,0,0,0,0,0,0,Friday
2020-06-05,Hong Kong-Zhuhai-Macao Bridge,124,7,9,140,65,9,3,77,Friday
2020-06-07,Hong Kong-Zhuhai-Macao Bridge,122,7,11,140,56,3,4,63,Sunday
2020-06-09,Express Rail Link West Kowloon,0,0,0,0,0,0,0,0,Tuesday
2020-06-10,Tuen Mun Ferry Terminal,0,0,0,0,0,0,0,0,Wednesday
2020-06-11,Express Rail Link West Kowloon,0,0,0,0,0,0,0,0,Thursday
2020-06-13,Express Rail Link West Kowloon,0,0,0,0,0,0,0,0,Saturday
2020-06-14,Tuen Mun Ferry Terminal,0,0,0,0,0,0,0,0,Sunday
2020-06-16,Hong Kong-Zhuhai-Macao Bridge,55,1,9,65,82,4,11,97,Tuesday
2020-06-16,Kai Tak Cruise Terminal,0,0,0,0,0,0,0,0,Tuesday
2020-06-17,Express Rail Link West Kowloon,0,0,0,0,0,0,0,0,Wednesday
2020-06-18,Macau Ferry Terminal,0,0,0,0,0,0,0,0,Thursday
2020-06-20,Hong Kong-Zhuhai-Macao Bridge,46,5,8,59,54,4,6,64,Saturday
2020-06-22,Express Rail Link West Kowloon,0,0,0,0,0,0,0,0,Monday
2020-06-22,Shenzhen Bay,1048,168,18,1234,998,74,31,1103,Monday
2020-06-22,China Ferry Terminal,0,0,0,0,0,0,0,0,Monday
2020-06-23,Tuen Mun Ferry Terminal,0,0,0,0,0,0,0,0,Tuesday
2020-06-25,Hong Kong-Zhuhai-Macao Bridge,49,2,1,52,57,3,3,63,Thursday
2020-06-27,Express Rail Link West Kowloon,0,0,0,0,0,0,0,0,Saturday
2020-06-28,Hong Kong-Zhuhai-Macao Bridge,31,2,2,35,39,0,3,42,Sunday
2020-06-30,Hong Kong-Zhuhai-Macao Bridge,42,3,3,48,88,4,6,98,Tuesday
2020-07-01,Airport,682,3,58,743,1022,20,82,1124,Wednesday
2020-07-01,Express Rail Link West Kowloon,0,0,0,0,0,0,0,0,Wednesday
2020-07-08,Kai Tak Cruise Terminal,0,0,0,0,0,0,0,0,Wednesday
2020-07-10,Hong Kong-Zhuhai-Macao Bridge,102,11,5,118,239,23,16,278,Friday
2020-07-10,China Ferry Terminal,0,0,0,0,0,0,0,0,Friday
2020-07-11,Hong Kong-Zhuhai-Macao Bridge,75,2,7,84,263,41,9,313,Saturday
2020-07-13,Hong Kong-Zhuhai-Macao Bridge,99,2,3,104,393,43,4,440,Monday
2020-07-15,Express Rail Link West Kowloon,0,0,0,0,0,0,0,0,Wednesday
2020-07-16,Lok Ma Chau,0,0,0,0,0,0,0,0,Thursday
2020-07-16,China Ferry Terminal,0,0,0,0,0,0,0,0,Thursday
2020-07-18,Express Rail Link West Kowloon,0,0,0,0,0,0,0,0,Saturday
2020-07-19,Tuen Mun Ferry Terminal,0,0,0,0,0,0,0,0,Sunday
2020-07-21,Hong Kong-Zhuhai-Macao Bridge,35,2,0,37,200,12,3,215,Tuesday
2020-07-22,Lok Ma Chau Spur Line,0,0,0,0,0,0,0,0,Wednesday
2020-07-22,Kai Tak Cruise Terminal,0,0,0,0,0,0,0,0,Wednesday
2020-07-24,Hong Kong-Zhuhai-Macao Bridge,36,0,2,38,250,18,13,281,Friday
2020-07-26,Hong Kong-Zhuhai-Macao Bridge,14,1,6,21,244,20,4,268,Sunday
2020-07-28,Express Rail Link West Kowloon,0,0,0,0,0,0,0,0,Tuesday
2020-07-29,Hong Kong-Zhuhai-Macao Bridge,36,0,7,43,291,16,6,313,Wednesday
2020-07-31,Express Rail Link West Kowloon,0,0,0,0,0,0,0,0,Friday
2020-08-02,Express Rail Link West Kowloon,0,0,0,0,0,0,0,0,Sunday
2020-08-02,Macau Ferry Terminal,0,0,0,0,0,0,0,0,Sunday
2020-08-03,Express Rail Link West Kowloon,0,0,0,0,0,0,0,0,Monday
2020-08-05,Express Rail Link West Kowloon,0,0,0,0,0,0,0,0,Wednesday
2020-08-06,Macau Ferry Terminal,0,0,0,0,0,0,0,0,Thursday
2020-08-08,Hong Kong-Zhuhai-Macao Bridge,38,3,5,46,181,15,4,200,Saturday
2020-08-08,China Ferry Terminal,0,0,0,0,0,0,0,0,Saturday
2020-08-09,Hong Kong-Zhuhai-Macao Bridge,42,4,6,52,113,6,3,122,Sunday
2020-08-11,Hong Kong-Zhuhai-Macao Bridge,23,1,2,26,167,4,3,174,Tuesday
2020-11-10,Macau Ferry Terminal,0,0,0,0,0,0,0,0,Tuesday
2020-08-13,Express Rail Link West Kowloon,0,0,0,0,0,0,0,0,Thursday
2020-08-14,Lok Ma Chau,0,0,0,0,0,0,0,0,Friday
2020-08-14,Kai Tak Cruise Terminal,0,0,0,0,0,0,0,0,Friday
2020-08-16,Express Rail Link West Kowloon,0,0,0,0,0,0,0,0,Sunday
2020-08-18,Express Rail Link West Kowloon,0,0,0,0,0,0,0,0,Tuesday
2020-08-19,Tuen Mun Ferry Terminal,0,0,0,0,0,0,0,0,Wednesday
2020-08-20,Lok Ma Chau Spur Line,0,0,0,0,0,0,0,0,Thursday
2020-08-20,Hong Kong-Zhuhai-Macao Bridge,43,2,12,57,142,3,6,151,Thursday
2020-08-22,Express Rail Link West Kowloon,0,0,0,0,0,0,0,0,Saturday
2020-08-24,Express Rail Link West Kowloon,0,0,0,0,0,0,0,0,Monday
2020-08-25,Kai Tak Cruise Terminal,0,0,0,0,0,0,0,0,Tuesday
2020-08-26,Express Rail Link West Kowloon,0,0,0,0,0,0,0,0,Wednesday
2020-08-26,Kai Tak Cruise Terminal,0,0,0,0,0,0,0,0,Wednesday
2020-08-28,Hong Kong-Zhuhai-Macao Bridge,64,1,1,66,118,4,11,133,Friday
2020-08-30,Express Rail Link West Kowloon,0,0,0,0,0,0,0,0,Sunday
2020-08-31,Sha Tau Kok,0,0,0,0,0,0,0,0,Monday
2020-08-31,China Ferry Terminal,0,0,0,0,0,0,0,0,Monday
2020-09-01,China Ferry Terminal,0,0,0,0,0,0,0,0,Tuesday
2020-09-03,Express Rail Link West Kowloon,0,0,0,0,0,0,0,0,Thursday
2020-09-04,Tuen Mun Ferry Terminal,0,0,0,0,0,0,0,0,Friday
2020-09-06,Express Rail Link West Kowloon,0,0,0,0,0,0,0,0,Sunday
2020-09-06,Kai Tak Cruise Terminal,0,0,0,0,0,0,0,0,Sunday
2020-09-08,Express Rail Link West Kowloon,0,0,0,0,0,0,0,0,Tuesday
2020-09-09,Kai Tak Cruise Terminal,0,0,0,0,0,0,0,0,Wednesday
2020-09-11,Hong Kong-Zhuhai-Macao Bridge,110,7,7,124,133,8,2,143,Friday
2020-09-11,Sha Tau Kok,0,0,0,0,0,0,0,0,Friday
2020-09-11,Kai Tak Cruise Terminal,0,0,0,0,0,0,0,0,Friday
2020-09-13,Express Rail Link West Kowloon,0,0,0,0,0,0,0,0,Sunday
2020-09-15,Express Rail Link West Kowloon,0,0,0,0,0,0,0,0,Tuesday
2020-09-16,China Ferry Terminal,0,0,0,0,0,0,0,0,Wednesday
2020-09-17,Airport,650,5,21,676,1276,6,42,1324,Thursday
2020-09-17,Express Rail Link West Kowloon,0,0,0,0,0,0,0,0,Thursday
2020-09-18,Kai Tak Cruise Terminal,0,0,0,0,0,0,0,0,Friday
2020-09-20,Express Rail Link West Kowloon,0,0,0,0,0,0,0,0,Sunday
2020-09-21,Tuen Mun Ferry Terminal,0,0,0,0,0,0,0,0,Monday
2020-09-22,Sha Tau Kok,0,0,0,0,0,0,0,0,Tuesday
2020-09-22,China Ferry Terminal,0,0,0,0,0,0,0,0,Tuesday
2020-09-23,Kai Tak Cruise Terminal,0,0,0,0,0,0,0,0,Wednesday
2020-09-25,Hong Kong-Zhuhai-Macao Bridge,122,3,1,126,161,5,0,166,Friday
2020-09-27,Express Rail Link West Kowloon,0,0,0,0,0,0,0,0,Sunday
2020-09-28,Airport,965,4,35,1004,1019,12,40,1071,Monday
2020-09-28,Express Rail Link West Kowloon,0,0,0,0,0,0,0,0,Monday
2020-09-29,Hong Kong-Zhuhai-Macao Bridge,81,6,5,92,78,3,8,89,Tuesday
2020-10-01,Express Rail Link West Kowloon,0,0,0,0,0,0,0,0,Thursday
2020-10-03,Express Rail Link West Kowloon,0,0,0,0,0,0,0,0,Saturday
2020-10-03,Man Kam To,0,0,0,0,0,0,0,0,Saturday
2020-10-03,Shenzhen Bay,937,170,6,1113,182,31,3,216,Saturday
2020-10-04,Hong Kong-Zhuhai-Macao Bridge,77,10,4,91,60,5,3,68,Sunday
2020-10-06,Express Rail Link West Kowloon,0,0,0,0,0,0,0,0,Tuesday
2020-10-07,Kai Tak Cruise Terminal,0,0,0,0,0,0,0,0,Wednesday
2020-10-08,Total,1575,76,39,1690,2028,132,60,2220,Thursday
2020-10-09,Express Rail Link West Kowloon,0,0,0,0,0,0,0,0,Friday
2020-10-10,Hong Kong-Zhuhai-Macao Bridge,84,7,4,95,110,12,2,124,Saturday
2020-10-12,Express Rail Link West Kowloon,0,0,0,0,0,0,0,0,Monday
2020-10-13,Tuen Mun Ferry Terminal,0,0,0,0,0,0,0,0,Tuesday
2020-10-14,Man Kam To,0,0,0,0,0,0,0,0,Wednesday
2020-10-14,Tuen Mun Ferry Terminal,0,0,0,0,0,0,0,0,Wednesday
2020-10-16,Hong Kong-Zhuhai-Macao Bridge,67,7,3,77,177,7,8,192,Friday
2020-10-18,Express Rail Link West Kowloon,0,0,0,0,0,0,0,0,Sunday
2020-10-19,Total,1594,126,39,1759,1219,62,33,1314,Monday
2020-10-20,Express Rail Link West Kowloon,0,0,0,0,0,0,0,0,Tuesday
2020-10-21,Express Rail Link West Kowloon,0,0,0,0,0,0,0,0,Wednesday
2020-10-23,Express Rail Link West Kowloon,0,0,0,0,0,0,0,0,Friday
2020-10-24,Kai Tak Cruise Terminal,0,0,0,0,0,0,0,0,Saturday
2020-10-25,Lok Ma Chau,0,0,0,0,0,0,0,0,Sunday
2020-10-25,Tuen Mun Ferry Terminal,0,0,0,0,0,0,0,0,Sunday
2020-10-27,Hong Kong-Zhuhai-Macao Bridge,62,2,3,67,55,1,1,57,Tuesday
2020-10-29,Express Rail Link West Kowloon,0,0,0,0,0,0,0,0,Thursday
2020-10-30,Kai Tak Cruise Terminal,0,0,0,0,0,0,0,0,Friday
2020-10-30,Tuen Mun Ferry Terminal,0,0,0,0,0,0,0,0,Friday
2020-10-31,Hong Kong-Zhuhai-Macao Bridge,48,3,4,55,123,8,0,131,Saturday
2020-11-02,Express Rail Link West Kowloon,0,0,0,0,0,0,0,0,Monday
2020-11-04,Express Rail Link West Kowloon,0,0,0,0,0,0,0,0,Wednesday
2020-11-05,Hong Kong-Zhuhai-Macao Bridge,69,5,61,135,109,10,5,124,Thursday
2020-11-06,Express Rail Link West Kowloon,0,0,0,0,0,0,0,0,Friday
2020-11-07,Kai Tak Cruise Terminal,0,0,0,0,0,0,0,0,Saturday
2020-11-09,Express Rail Link West Kowloon,0,0,0,0,0,0,0,0,Monday
2021-06-08,Lo Wu,0,0,0,0,0,0,0,0,Tuesday
2020-11-11,Hong Kong-Zhuhai-Macao Bridge,44,4,4,52,94,7,1,102,Wednesday
2020-11-13,Express Rail Link West Kowloon,0,0,0,0,0,0,0,0,Friday
2020-11-14,Macau Ferry Terminal,0,0,0,0,0,0,0,0,Saturday
2020-11-16,Express Rail Link West Kowloon,0,0,0,0,0,0,0,0,Monday
2020-11-16,Heung Yuen Wai,0,0,0,0,0,0,0,0,Monday
2020-11-16,Hong Kong-Zhuhai-Macao Bridge,38,5,2,45,196,13,4,213,Monday
2020-11-18,Express Rail Link West Kowloon,0,0,0,0,0,0,0,0,Wednesday
2020-11-19,Macau Ferry Terminal,0,0,0,0,0,0,0,0,Thursday
2020-11-21,Express Rail Link West Kowloon,0,0,0,0,0,0,0,0,Saturday
2020-11-21,Kai Tak Cruise Terminal,0,0,0,0,0,0,0,0,Saturday
2020-11-22,Hong Kong-Zhuhai-Macao Bridge,23,4,5,32,120,14,2,136,Sunday
2020-11-24,Express Rail Link West Kowloon,0,0,0,0,0,0,0,0,Tuesday
2020-11-25,Kai Tak Cruise Terminal,0,0,0,0,0,0,0,0,Wednesday
2020-11-27,Lok Ma Chau Spur Line,0,0,0,0,0,0,0,0,Friday
2020-11-27,Hong Kong-Zhuhai-Macao Bridge,114,3,9,126,209,8,2,219,Friday
2020-11-29,Express Rail Link West Kowloon,0,0,0,0,0,0,0,0,Sunday
2020-11-30,Kai Tak Cruise Terminal,0,0,0,0,0,0,0,0,Monday
2020-12-02,Express Rail Link West Kowloon,0,0,0,0,0,0,0,0,Wednesday
2020-12-02,Kai Tak Cruise Terminal,0,0,0,0,0,0,0,0,Wednesday
2020-12-03,Express Rail Link West Kowloon,0,0,0,0,0,0,0,0,Thursday
2020-12-05,Express Rail Link West Kowloon,0,0,0,0,0,0,0,0,Saturday
2020-12-06,Kai Tak Cruise Terminal,0,0,0,0,0,0,0,0,Sunday
2020-12-08,Express Rail Link West Kowloon,0,0,0,0,0,0,0,0,Tuesday
2020-12-08,Lok Ma Chau Spur Line,0,0,0,0,0,0,0,0,Tuesday
2020-12-08,Hong Kong-Zhuhai-Macao Bridge,73,2,6,81,299,8,1,308,Tuesday
2020-12-10,Express Rail Link West Kowloon,0,0,0,0,0,0,0,0,Thursday
2020-12-11,Kai Tak Cruise Terminal,0,0,0,0,0,0,0,0,Friday
2020-12-13,Express Rail Link West Kowloon,0,0,0,0,0,0,0,0,Sunday
2020-12-13,Harbour Control,0,0,0,0,0,0,0,0,Sunday
2020-12-13,Tuen Mun Ferry Terminal,0,0,0,0,0,0,0,0,Sunday
2020-12-15,Express Rail Link West Kowloon,0,0,0,0,0,0,0,0,Tuesday
2020-12-16,Tuen Mun Ferry Terminal,0,0,0,0,0,0,0,0,Wednesday
2020-12-18,Hong Kong-Zhuhai-Macao Bridge,191,3,9,203,259,5,1,265,Friday
2020-12-19,Lok Ma Chau Spur Line,0,0,0,0,0,0,0,0,Saturday
2020-12-19,Hong Kong-Zhuhai-Macao Bridge,119,0,4,123,221,18,4,243,Saturday
2020-12-21,Express Rail Link West Kowloon,0,0,0,0,0,0,0,0,Monday
2020-12-22,Tuen Mun Ferry Terminal,0,0,0,0,0,0,0,0,Tuesday
2020-12-24,Hong Kong-Zhuhai-Macao Bridge,68,2,0,70,248,10,7,265,Thursday
2020-12-24,Harbour Control,0,0,0,0,0,0,0,0,Thursday
2020-12-24,Kai Tak Cruise Terminal,0,0,0,0,0,0,0,0,Thursday
2020-12-26,Express Rail Link West Kowloon,0,0,0,0,0,0,0,0,Saturday
2020-12-28,Express Rail Link West Kowloon,0,0,0,0,0,0,0,0,Monday
2020-12-29,China Ferry Terminal,0,0,0,0,0,0,0,0,Tuesday
2020-12-30,Lok Ma Chau Spur Line,0,0,0,0,0,0,0,0,Wednesday
2020-12-30,Tuen Mun Ferry Terminal,0,0,0,0,0,0,0,0,Wednesday
2021-01-01,Hong Kong-Zhuhai-Macao Bridge,45,2,0,47,210,7,0,217,Friday
2021-01-03,Express Rail Link West Kowloon,0,0,0,0,0,0,0,0,Sunday
2021-01-04,Harbour Control,0,0,0,0,0,0,0,0,Monday
2021-01-05,Hong Kong-Zhuhai-Macao Bridge,86,3,4,93,205,16,5,226,Tuesday
2021-01-07,Express Rail Link West Kowloon,0,0,0,0,0,0,0,0,Thursday
2021-01-08,Tuen Mun Ferry Terminal,0,0,0,0,0,0,0,0,Friday
2021-01-10,Lo Wu,0,0,0,0,0,0,0,0,Sunday
2021-01-10,Hong Kong-Zhuhai-Macao Bridge,99,3,5,107,205,8,3,216,Sunday
2021-01-12,Express Rail Link West Kowloon,0,0,0,0,0,0,0,0,Tuesday
2021-01-13,Tuen Mun Ferry Terminal,0,0,0,0,0,0,0,0,Wednesday
2021-01-15,Hong Kong-Zhuhai-Macao Bridge,103,3,5,111,251,3,4,258,Friday
2021-01-15,China Ferry Terminal,0,0,0,0,0,0,0,0,Friday
2021-01-15,Kai Tak Cruise Terminal,0,0,0,0,0,0,0,0,Friday
2021-01-17,Express Rail Link West Kowloon,0,0,0,0,0,0,0,0,Sunday
2021-01-18,Tuen Mun Ferry Terminal,0,0,0,0,0,0,0,0,Monday
2021-01-20,Express Rail Link West Kowloon,0,0,0,0,0,0,0,0,Wednesday
2021-01-21,Hung Hom,0,0,0,0,0,0,0,0,Thursday
2021-01-21,Hong Kong-Zhuhai-Macao Bridge,100,3,5,108,201,12,0,213,Thursday
2021-01-23,Express Rail Link West Kowloon,0,0,0,0,0,0,0,0,Saturday
2021-01-25,Express Rail Link West Kowloon,0,0,0,0,0,0,0,0,Monday
2021-01-26,China Ferry Terminal,0,0,0,0,0,0,0,0,Tuesday
2021-01-27,Express Rail Link West Kowloon,0,0,0,0,0,0,0,0,Wednesday
2021-01-28,Macau Ferry Terminal,0,0,0,0,0,0,0,0,Thursday
2021-01-30,Express Rail Link West Kowloon,0,0,0,0,0,0,0,0,Saturday
2021-02-01,Express Rail Link West Kowloon,0,0,0,0,0,0,0,0,Monday
2021-02-01,Hong Kong-Zhuhai-Macao Bridge,82,0,2,84,35,1,1,37,Monday
2021-02-03,Express Rail Link West Kowloon,0,0,0,0,0,0,0,0,Wednesday
2021-02-05,Express Rail Link West Kowloon,0,0,0,0,0,0,0,0,Friday
2021-02-06,Shenzhen Bay,1860,79,1,1940,264,28,2,294,Saturday
2021-02-06,Kai Tak Cruise Terminal,0,0,0,0,0,0,0,0,Saturday
2021-06-25,Tuen Mun Ferry Terminal,0,0,0,0,0,0,0,0,Friday
2021-02-08,Express Rail Link West Kowloon,0,0,0,0,0,0,0,0,Monday
2021-02-09,Tuen Mun Ferry Terminal,0,0,0,0,0,0,0,0,Tuesday
2021-02-11,Hong Kong-Zhuhai-Macao Bridge,85,3,0,88,40,0,0,40,Thursday
2021-02-12,Express Rail Link West Kowloon,0,0,0,0,0,0,0,0,Friday
2021-02-12,Hong Kong-Zhuhai-Macao Bridge,34,2,0,36,26,1,0,27,Friday
2021-02-14,Express Rail Link West Kowloon,0,0,0,0,0,0,0,0,Sunday
2021-02-15,Tuen Mun Ferry Terminal,0,0,0,0,0,0,0,0,Monday
2021-02-17,Hong Kong-Zhuhai-Macao Bridge,121,10,1,132,197,9,1,207,Wednesday
2021-02-17,Sha Tau Kok,0,0,0,0,0,0,0,0,Wednesday
2021-02-18,Express Rail Link West Kowloon,0,0,0,0,0,0,0,0,Thursday
2021-02-20,Express Rail Link West Kowloon,0,0,0,0,0,0,0,0,Saturday
2021-02-21,Kai Tak Cruise Terminal,0,0,0,0,0,0,0,0,Sunday
2021-02-23,Express Rail Link West Kowloon,0,0,0,0,0,0,0,0,Tuesday
2021-02-24,Express Rail Link West Kowloon,0,0,0,0,0,0,0,0,Wednesday
2021-02-26,Express Rail Link West Kowloon,0,0,0,0,0,0,0,0,Friday
2021-02-27,Kai Tak Cruise Terminal,0,0,0,0,0,0,0,0,Saturday
2021-02-28,Man Kam To,0,0,0,0,0,0,0,0,Sunday
2021-02-28,Kai Tak Cruise Terminal,0,0,0,0,0,0,0,0,Sunday
2021-03-02,Express Rail Link West Kowloon,0,0,0,0,0,0,0,0,Tuesday
2021-03-03,Kai Tak Cruise Terminal,0,0,0,0,0,0,0,0,Wednesday
2021-03-05,Hong Kong-Zhuhai-Macao Bridge,106,5,5,116,160,13,0,173,Friday
2021-03-05,Total,2078,145,33,2256,1524,112,30,1666,Friday
2021-03-06,Express Rail Link West Kowloon,0,0,0,0,0,0,0,0,Saturday
2021-03-07,Kai Tak Cruise Terminal,0,0,0,0,0,0,0,0,Sunday
2021-03-09,Express Rail Link West Kowloon,0,0,0,0,0,0,0,0,Tuesday
2021-03-10,Kai Tak Cruise Terminal,0,0,0,0,0,0,0,0,Wednesday
2021-03-11,Lok Ma Chau,0,0,0,0,0,0,0,0,Thursday
2021-03-11,Shenzhen Bay,1132,116,1,1249,589,77,1,667,Thursday
2021-03-12,Hong Kong-Zhuhai-Macao Bridge,75,4,2,81,114,10,3,127,Friday
2021-03-14,Express Rail Link West Kowloon,0,0,0,0,0,0,0,0,Sunday
2021-03-15,Tuen Mun Ferry Terminal,0,0,0,0,0,0,0,0,Monday
2021-03-16,Total,1634,147,4,1785,1760,123,35,1918,Tuesday
2021-03-17,Express Rail Link West Kowloon,0,0,0,0,0,0,0,0,Wednesday
2021-03-18,Kai Tak Cruise Terminal,0,0,0,0,0,0,0,0,Thursday
2021-03-20,Express Rail Link West Kowloon,0,0,0,0,0,0,0,0,Saturday
2021-03-22,Express Rail Link West Kowloon,0,0,0,0,0,0,0,0,Monday
2021-03-22,Lok Ma Chau,0,0,0,0,0,0,0,0,Monday
2021-03-22,China Ferry Terminal,0,0,0,0,0,0,0,0,Monday
2021-03-23,Kai Tak Cruise Terminal,0,0,0,0,0,0,0,0,Tuesday
2021-03-25,Express Rail Link West Kowloon,0,0,0,0,0,0,0,0,Thursday
2021-03-27,Express Rail Link West Kowloon,0,0,0,0,0,0,0,0,Saturday
2021-03-27,Tuen Mun Ferry Terminal,0,0,0,0,0,0,0,0,Saturday
2021-03-28,Kai Tak Cruise Terminal,0,0,0,0,0,0,0,0,Sunday
2021-03-30,Express Rail Link West Kowloon,0,0,0,0,0,0,0,0,Tuesday
2021-03-31,Kai Tak Cruise Terminal,0,0,0,0,0,0,0,0,Wednesday
2021-04-02,Hong Kong-Zhuhai-Macao Bridge,90,3,4,97,137,16,1,154,Friday
2021-04-03,Express Rail Link West Kowloon,0,0,0,0,0,0,0,0,Saturday
2021-04-05,Express Rail Link West Kowloon,0,0,0,0,0,0,0,0,Monday
2021-04-06,Kai Tak Cruise Terminal,0,0,0,0,0,0,0,0,Tuesday
2021-04-07,Macau Ferry Terminal,0,0,0,0,0,0,0,0,Wednesday
2021-04-08,Express Rail Link West Kowloon,0,0,0,0,0,0,0,0,Thursday
2021-04-09,Tuen Mun Ferry Terminal,0,0,0,0,0,0,0,0,Friday
2021-04-11,Express Rail Link West Kowloon,0,0,0,0,0,0,0,0,Sunday
2021-04-13,Express Rail Link West Kowloon,0,0,0,0,0,0,0,0,Tuesday
2021-04-13,Hong Kong-Zhuhai-Macao Bridge,94,1,2,97,140,6,0,146,Tuesday
2021-04-13,Kai Tak Cruise Terminal,0,0,0,0,0,0,0,0,Tuesday
2021-04-15,Express Rail Link West Kowloon,0,0,0,0,0,0,0,0,Thursday
2021-04-16,Tuen Mun Ferry Terminal,0,0,0,0,0,0,0,0,Friday
2021-04-18,Hong Kong-Zhuhai-Macao Bridge,111,9,3,123,85,6,5,96,Sunday
2021-04-18,Macau Ferry Terminal,0,0,0,0,0,0,0,0,Sunday
2021-04-19,Express Rail Link West Kowloon,0,0,0,0,0,0,0,0,Monday
2021-04-21,Express Rail Link West Kowloon,0,0,0,0,0,0,0,0,Wednesday
2021-04-22,Kai Tak Cruise Terminal,0,0,0,0,0,0,0,0,Thursday
2021-04-24,Express Rail Link West Kowloon,0,0,0,0,0,0,0,0,Saturday
2021-04-24,Heung Yuen Wai,0,0,0,0,0,0,0,0,Saturday
2021-04-24,Hong Kong-Zhuhai-Macao Bridge,91,6,4,101,96,12,3,111,Saturday
2021-04-26,Express Rail Link West Kowloon,0,0,0,0,0,0,0,0,Monday
2021-04-28,Express Rail Link West Kowloon,0,0,0,0,0,0,0,0,Wednesday
2021-04-29,China Ferry Terminal,0,0,0,0,0,0,0,0,Thursday
2021-04-29,Kai Tak Cruise Terminal,0,0,0,0,0,0,0,0,Thursday
2021-04-29,Macau Ferry Terminal,0,0,0,0,0,0,0,0,Thursday
2021-05-01,Express Rail Link West Kowloon,0,0,0,0,0,0,0,0,Saturday
2021-05-03,Express Rail Link West Kowloon,0,0,0,0,0,0,0,0,Monday
2021-05-04,Kai Tak Cruise Terminal,0,0,0,0,0,0,0,0,Tuesday
2021-05-05,Heung Yuen Wai,0,0,0,0,0,0,0,0,Wednesday
2021-05-05,Tuen Mun Ferry Terminal,0,0,0,0,0,0,0,0,Wednesday
2021-06-25,Total,1799,106,21,1926,2587,166,45,2798,Friday
2021-05-07,Hong Kong-Zhuhai-Macao Bridge,99,3,10,112,187,8,4,199,Friday
2021-05-09,Express Rail Link West Kowloon,0,0,0,0,0,0,0,0,Sunday
2021-05-10,Kai Tak Cruise Terminal,0,0,0,0,0,0,0,0,Monday
2021-05-11,Express Rail Link West Kowloon,0,0,0,0,0,0,0,0,Tuesday
2021-05-12,Kai Tak Cruise Terminal,0,0,0,0,0,0,0,0,Wednesday
2021-05-14,Express Rail Link West Kowloon,0,0,0,0,0,0,0,0,Friday
2021-05-16,Express Rail Link West Kowloon,0,0,0,0,0,0,0,0,Sunday
2021-05-16,Lok Ma Chau Spur Line,0,0,0,0,0,0,0,0,Sunday
2021-05-16,Kai Tak Cruise Terminal,0,0,0,0,0,0,0,0,Sunday
2021-05-18,Express Rail Link West Kowloon,0,0,0,0,0,0,0,0,Tuesday
2021-05-19,Kai Tak Cruise Terminal,0,0,0,0,0,0,0,0,Wednesday
2021-05-21,Hong Kong-Zhuhai-Macao Bridge,101,4,3,108,206,13,0,219,Friday
2021-05-21,Harbour Control,0,0,0,0,0,0,0,0,Friday
2021-05-21,Tuen Mun Ferry Terminal,0,0,0,0,0,0,0,0,Friday
2021-05-23,Express Rail Link West Kowloon,0,0,0,0,0,0,0,0,Sunday
2021-05-25,Express Rail Link West Kowloon,0,0,0,0,0,0,0,0,Tuesday
2021-05-26,Kai Tak Cruise Terminal,0,0,0,0,0,0,0,0,Wednesday
2021-05-27,Lo Wu,0,0,0,0,0,0,0,0,Thursday
2021-05-27,Lok Ma Chau Spur Line,0,0,0,0,0,0,0,0,Thursday
2021-05-28,Hong Kong-Zhuhai-Macao Bridge,157,11,4,172,212,11,0,223,Friday
2021-05-30,Express Rail Link West Kowloon,0,0,0,0,0,0,0,0,Sunday
2021-06-28,Airport,539,5,7,551,1115,1,35,1151,Monday
2021-06-28,Express Rail Link West Kowloon,0,0,0,0,0,0,0,0,Monday
2021-06-28,Hung Hom,0,0,0,0,0,0,0,0,Monday
2021-06-28,Lo Wu,0,0,0,0,0,0,0,0,Monday
2021-06-28,Lok Ma Chau Spur Line,0,0,0,0,0,0,0,0,Monday
2021-06-28,Heung Yuen Wai,0,0,0,0,0,0,0,0,Monday
2021-06-28,Hong Kong-Zhuhai-Macao Bridge,162,8,4,174,214,17,2,233,Monday
2021-06-28,Lok Ma Chau,0,0,0,0,0,0,0,0,Monday
2021-06-28,Man Kam To,0,0,0,0,0,0,0,0,Monday
2021-06-28,Sha Tau Kok,0,0,0,0,0,0,0,0,Monday
2021-06-28,Shenzhen Bay,717,97,1,815,490,71,3,564,Monday
2021-06-28,China Ferry Terminal,0,0,0,0,0,0,0,0,Monday
2021-06-28,Harbour Control,0,0,0,0,0,0,0,0,Monday
2021-06-28,Kai Tak Cruise Terminal,0,0,0,0,0,0,0,0,Monday
2021-06-28,Macau Ferry Terminal,0,0,0,0,0,0,0,0,Monday
2021-06-28,Tuen Mun Ferry Terminal,0,0,0,0,0,0,0,0,Monday
2021-06-28,Total,1418,110,12,1540,1819,89,40,1948,Monday
2021-06-27,Airport,1161,23,12,1196,1402,28,16,1446,Sunday
2021-06-27,Express Rail Link West Kowloon,0,0,0,0,0,0,0,0,Sunday
2021-06-27,Hung Hom,0,0,0,0,0,0,0,0,Sunday
2021-06-27,Lo Wu,0,0,0,0,0,0,0,0,Sunday
2021-06-27,Lok Ma Chau Spur Line,0,0,0,0,0,0,0,0,Sunday
2021-06-27,Heung Yuen Wai,0,0,0,0,0,0,0,0,Sunday
2021-06-27,Hong Kong-Zhuhai-Macao Bridge,153,8,1,162,267,34,3,304,Sunday
2021-06-27,Lok Ma Chau,0,0,0,0,0,0,0,0,Sunday
2021-06-27,Man Kam To,0,0,0,0,0,0,0,0,Sunday
2021-06-27,Sha Tau Kok,0,0,0,0,0,0,0,0,Sunday
2021-06-27,Shenzhen Bay,862,118,1,981,417,90,0,507,Sunday
2021-06-27,China Ferry Terminal,0,0,0,0,0,0,0,0,Sunday
2021-06-27,Harbour Control,0,0,0,0,0,0,0,0,Sunday
2021-06-27,Kai Tak Cruise Terminal,0,0,0,0,0,0,0,0,Sunday
2021-06-27,Macau Ferry Terminal,0,0,0,0,0,0,0,0,Sunday
2021-06-27,Tuen Mun Ferry Terminal,0,0,0,0,0,0,0,0,Sunday
2021-06-27,Total,2176,149,14,2339,2086,152,19,2257,Sunday
2021-06-26,Airport,811,33,28,872,1533,41,32,1606,Saturday
2021-06-26,Express Rail Link West Kowloon,0,0,0,0,0,0,0,0,Saturday
2021-06-26,Hung Hom,0,0,0,0,0,0,0,0,Saturday
2021-06-26,Lo Wu,0,0,0,0,0,0,0,0,Saturday
2021-06-26,Lok Ma Chau Spur Line,0,0,0,0,0,0,0,0,Saturday
2021-06-26,Heung Yuen Wai,0,0,0,0,0,0,0,0,Saturday
2021-06-26,Hong Kong-Zhuhai-Macao Bridge,126,18,1,145,219,73,3,295,Saturday
2021-06-26,Lok Ma Chau,0,0,0,0,0,0,0,0,Saturday
2021-06-26,Man Kam To,0,0,0,0,0,0,0,0,Saturday
2021-06-26,Sha Tau Kok,0,0,0,0,0,0,0,0,Saturday
2021-06-26,Shenzhen Bay,752,100,2,854,642,83,3,728,Saturday
2021-06-26,China Ferry Terminal,0,0,0,0,0,0,0,0,Saturday
2021-06-26,Harbour Control,0,0,0,0,0,0,0,0,Saturday
2021-06-26,Kai Tak Cruise Terminal,0,0,0,0,0,0,0,0,Saturday
2021-06-26,Macau Ferry Terminal,0,0,0,0,0,0,0,0,Saturday
2021-06-26,Tuen Mun Ferry Terminal,0,0,0,0,0,0,0,0,Saturday
2021-06-26,Total,1689,151,31,1871,2394,197,38,2629,Saturday
2021-06-25,Airport,670,18,11,699,1736,41,38,1815,Friday
2021-06-25,Express Rail Link West Kowloon,0,0,0,0,0,0,0,0,Friday
2021-06-25,Hung Hom,0,0,0,0,0,0,0,0,Friday
2021-06-25,Lo Wu,0,0,0,0,0,0,0,0,Friday
2021-06-25,Lok Ma Chau Spur Line,0,0,0,0,0,0,0,0,Friday
2021-06-25,Heung Yuen Wai,0,0,0,0,0,0,0,0,Friday
2021-06-25,Hong Kong-Zhuhai-Macao Bridge,172,4,8,184,204,19,4,227,Friday
2021-06-25,Lok Ma Chau,0,0,0,0,0,0,0,0,Friday
2021-06-25,Man Kam To,0,0,0,0,0,0,0,0,Friday
2021-06-25,Sha Tau Kok,0,0,0,0,0,0,0,0,Friday
2021-06-25,Shenzhen Bay,957,84,2,1043,647,106,3,756,Friday
2021-06-25,China Ferry Terminal,0,0,0,0,0,0,0,0,Friday
2021-06-25,Harbour Control,0,0,0,0,0,0,0,0,Friday
2021-06-25,Kai Tak Cruise Terminal,0,0,0,0,0,0,0,0,Friday
2021-06-25,Macau Ferry Terminal,0,0,0,0,0,0,0,0,Friday
2021-06-19,Lok Ma Chau Spur Line,0,0,0,0,0,0,0,0,Saturday
2021-06-19,Heung Yuen Wai,0,0,0,0,0,0,0,0,Saturday
2021-06-19,Hong Kong-Zhuhai-Macao Bridge,107,3,4,114,189,17,3,209,Saturday
2021-06-19,Lok Ma Chau,0,0,0,0,0,0,0,0,Saturday
2021-06-19,Man Kam To,0,0,0,0,0,0,0,0,Saturday
2021-06-19,Sha Tau Kok,0,0,0,0,0,0,0,0,Saturday
2021-06-19,Shenzhen Bay,692,149,3,844,769,87,1,857,Saturday
2021-06-19,China Ferry Terminal,0,0,0,0,0,0,0,0,Saturday
2021-06-19,Harbour Control,0,0,0,0,0,0,0,0,Saturday
2021-06-19,Kai Tak Cruise Terminal,0,0,0,0,0,0,0,0,Saturday
2021-06-19,Macau Ferry Terminal,0,0,0,0,0,0,0,0,Saturday
2021-06-19,Tuen Mun Ferry Terminal,0,0,0,0,0,0,0,0,Saturday
2021-06-19,Total,1756,162,15,1933,2413,126,27,2566,Saturday
2021-06-18,Airport,705,21,16,742,1533,27,25,1585,Friday
2021-06-18,Express Rail Link West Kowloon,0,0,0,0,0,0,0,0,Friday
2021-06-18,Hung Hom,0,0,0,0,0,0,0,0,Friday
2021-06-18,Lo Wu,0,0,0,0,0,0,0,0,Friday
2021-06-18,Lok Ma Chau Spur Line,0,0,0,0,0,0,0,0,Friday
2021-06-18,Heung Yuen Wai,0,0,0,0,0,0,0,0,Friday
2021-06-18,Hong Kong-Zhuhai-Macao Bridge,174,1,7,182,177,9,1,187,Friday
2021-06-18,Lok Ma Chau,0,0,0,0,0,0,0,0,Friday
2021-06-18,Man Kam To,0,0,0,0,0,0,0,0,Friday
2021-06-18,Sha Tau Kok,0,0,0,0,0,0,0,0,Friday
2021-06-18,Shenzhen Bay,795,91,3,889,750,106,3,859,Friday
2021-06-18,China Ferry Terminal,0,0,0,0,0,0,0,0,Friday
2021-06-18,Harbour Control,0,0,0,0,0,0,0,0,Friday
2021-06-18,Kai Tak Cruise Terminal,0,0,0,0,0,0,0,0,Friday
2021-06-18,Macau Ferry Terminal,0,0,0,0,0,0,0,0,Friday
2021-06-18,Tuen Mun Ferry Terminal,0,0,0,0,0,0,0,0,Friday
2021-06-18,Total,1674,113,26,1813,2460,142,29,2631,Friday
2021-06-17,Airport,533,15,8,556,1402,13,29,1444,Thursday
2021-06-17,Express Rail Link West Kowloon,0,0,0,0,0,0,0,0,Thursday
2021-06-17,Hung Hom,0,0,0,0,0,0,0,0,Thursday
2021-06-17,Lo Wu,0,0,0,0,0,0,0,0,Thursday
2021-06-17,Lok Ma Chau Spur Line,0,0,0,0,0,0,0,0,Thursday
2021-06-17,Heung Yuen Wai,0,0,0,0,0,0,0,0,Thursday
2021-06-17,Hong Kong-Zhuhai-Macao Bridge,112,7,9,128,156,7,4,167,Thursday
2021-06-17,Lok Ma Chau,0,0,0,0,0,0,0,0,Thursday
2021-06-17,Man Kam To,0,0,0,0,0,0,0,0,Thursday
2021-06-17,Sha Tau Kok,0,0,0,0,0,0,0,0,Thursday
2021-06-17,Shenzhen Bay,706,82,2,790,636,65,2,703,Thursday
2021-06-17,China Ferry Terminal,0,0,0,0,0,0,0,0,Thursday
2021-06-17,Harbour Control,0,0,0,0,0,0,0,0,Thursday
2021-06-17,Kai Tak Cruise Terminal,0,0,0,0,0,0,0,0,Thursday
2021-06-17,Macau Ferry Terminal,0,0,0,0,0,0,0,0,Thursday
2021-06-17,Tuen Mun Ferry Terminal,0,0,0,0,0,0,0,0,Thursday
2021-06-17,Total,1351,104,19,1474,2194,85,35,2314,Thursday
2021-06-16,Airport,747,2,14,763,731,10,20,761,Wednesday
2021-06-16,Express Rail Link West Kowloon,0,0,0,0,0,0,0,0,Wednesday
2021-06-16,Hung Hom,0,0,0,0,0,0,0,0,Wednesday
2021-06-16,Lo Wu,0,0,0,0,0,0,0,0,Wednesday
2021-06-16,Lok Ma Chau Spur Line,0,0,0,0,0,0,0,0,Wednesday
2021-06-16,Heung Yuen Wai,0,0,0,0,0,0,0,0,Wednesday
2021-06-16,Hong Kong-Zhuhai-Macao Bridge,106,4,1,111,165,7,1,173,Wednesday
2021-06-16,Lok Ma Chau,0,0,0,0,0,0,0,0,Wednesday
2021-06-16,Man Kam To,0,0,0,0,0,0,0,0,Wednesday
2021-06-16,Sha Tau Kok,0,0,0,0,0,0,0,0,Wednesday
2021-06-16,Shenzhen Bay,797,95,1,893,694,128,4,826,Wednesday
2021-06-16,China Ferry Terminal,0,0,0,0,0,0,0,0,Wednesday
2021-06-16,Harbour Control,0,0,0,0,0,0,0,0,Wednesday
2021-06-16,Kai Tak Cruise Terminal,0,0,0,0,0,0,0,0,Wednesday
2021-06-16,Macau Ferry Terminal,0,0,0,0,0,0,0,0,Wednesday
2021-06-16,Tuen Mun Ferry Terminal,0,0,0,0,0,0,0,0,Wednesday
2021-06-16,Total,1650,101,16,1767,1590,145,25,1760,Wednesday
2021-06-15,Airport,574,13,8,595,1252,17,33,1302,Tuesday
2021-06-15,Express Rail Link West Kowloon,0,0,0,0,0,0,0,0,Tuesday
2021-06-15,Hung Hom,0,0,0,0,0,0,0,0,Tuesday
2021-06-15,Lo Wu,0,0,0,0,0,0,0,0,Tuesday
2021-06-15,Lok Ma Chau Spur Line,0,0,0,0,0,0,0,0,Tuesday
2021-06-15,Heung Yuen Wai,0,0,0,0,0,0,0,0,Tuesday
2021-06-15,Hong Kong-Zhuhai-Macao Bridge,101,5,1,107,165,2,6,173,Tuesday
2021-06-15,Lok Ma Chau,0,0,0,0,0,0,0,0,Tuesday
2021-06-15,Man Kam To,0,0,0,0,0,0,0,0,Tuesday
2021-06-15,Sha Tau Kok,0,0,0,0,0,0,0,0,Tuesday
2021-06-15,Shenzhen Bay,666,69,1,736,587,101,2,690,Tuesday
2021-06-15,China Ferry Terminal,0,0,0,0,0,0,0,0,Tuesday
2021-06-15,Harbour Control,0,0,0,0,0,0,0,0,Tuesday
2021-06-15,Kai Tak Cruise Terminal,0,0,0,0,0,0,0,0,Tuesday
2021-06-15,Macau Ferry Terminal,0,0,0,0,0,0,0,0,Tuesday
2021-06-15,Tuen Mun Ferry Terminal,0,0,0,0,0,0,0,0,Tuesday
2021-06-15,Total,1341,87,10,1438,2004,120,41,2165,Tuesday
2021-06-14,Airport,347,7,7,361,744,0,19,763,Monday
2021-06-14,Express Rail Link West Kowloon,0,0,0,0,0,0,0,0,Monday
2021-06-14,Hung Hom,0,0,0,0,0,0,0,0,Monday
2021-06-14,Lo Wu,0,0,0,0,0,0,0,0,Monday
2021-06-14,Lok Ma Chau Spur Line,0,0,0,0,0,0,0,0,Monday
2021-06-14,Heung Yuen Wai,0,0,0,0,0,0,0,0,Monday
2021-06-14,Hong Kong-Zhuhai-Macao Bridge,82,5,2,89,112,3,1,116,Monday
2021-06-14,Lok Ma Chau,0,0,0,0,0,0,0,0,Monday
2021-06-14,Man Kam To,0,0,0,0,0,0,0,0,Monday
2021-06-14,Sha Tau Kok,0,0,0,0,0,0,0,0,Monday
2021-06-14,Shenzhen Bay,476,63,1,540,331,71,2,404,Monday
2021-06-14,China Ferry Terminal,0,0,0,0,0,0,0,0,Monday
2021-06-14,Harbour Control,0,0,0,0,0,0,0,0,Monday
2021-06-14,Kai Tak Cruise Terminal,0,0,0,0,0,0,0,0,Monday
2021-06-14,Macau Ferry Terminal,0,0,0,0,0,0,0,0,Monday
2021-06-14,Tuen Mun Ferry Terminal,0,0,0,0,0,0,0,0,Monday
2021-06-14,Total,905,75,10,990,1187,74,22,1283,Monday
2021-06-13,Airport,947,25,11,983,1130,14,31,1175,Sunday
2021-06-13,Express Rail Link West Kowloon,0,0,0,0,0,0,0,0,Sunday
2021-06-13,Hung Hom,0,0,0,0,0,0,0,0,Sunday
2021-06-13,Lo Wu,0,0,0,0,0,0,0,0,Sunday
2021-06-13,Lok Ma Chau Spur Line,0,0,0,0,0,0,0,0,Sunday
2021-06-13,Heung Yuen Wai,0,0,0,0,0,0,0,0,Sunday
2021-06-13,Hong Kong-Zhuhai-Macao Bridge,101,5,0,106,126,8,1,135,Sunday
2021-06-13,Lok Ma Chau,0,0,0,0,0,0,0,0,Sunday
2021-06-13,Man Kam To,0,0,0,0,0,0,0,0,Sunday
2021-06-13,Sha Tau Kok,0,0,0,0,0,0,0,0,Sunday
2021-06-13,Shenzhen Bay,735,152,4,891,533,84,3,620,Sunday
2021-06-13,China Ferry Terminal,0,0,0,0,0,0,0,0,Sunday
2021-06-13,Harbour Control,0,0,0,0,0,0,0,0,Sunday
2021-06-13,Kai Tak Cruise Terminal,0,0,0,0,0,0,0,0,Sunday
2021-06-13,Macau Ferry Terminal,0,0,0,0,0,0,0,0,Sunday
2021-06-13,Tuen Mun Ferry Terminal,0,0,0,0,0,0,0,0,Sunday
2021-06-13,Total,1783,182,15,1980,1789,106,35,1930,Sunday
2021-06-12,Airport,652,33,6,691,1182,24,23,1229,Saturday
2021-06-12,Express Rail Link West Kowloon,0,0,0,0,0,0,0,0,Saturday
2021-06-12,Hung Hom,0,0,0,0,0,0,0,0,Saturday
2021-06-12,Lo Wu,0,0,0,0,0,0,0,0,Saturday
2021-06-12,Lok Ma Chau Spur Line,0,0,0,0,0,0,0,0,Saturday
2021-06-12,Heung Yuen Wai,0,0,0,0,0,0,0,0,Saturday
2021-06-12,Hong Kong-Zhuhai-Macao Bridge,126,10,4,140,182,12,0,194,Saturday
2021-06-12,Lok Ma Chau,0,0,0,0,0,0,0,0,Saturday
2021-06-12,Man Kam To,0,0,0,0,0,0,0,0,Saturday
2021-06-12,Sha Tau Kok,0,0,0,0,0,0,0,0,Saturday
2021-06-12,Shenzhen Bay,792,288,0,1080,668,195,0,863,Saturday
2021-06-12,China Ferry Terminal,0,0,0,0,0,0,0,0,Saturday
2021-06-12,Harbour Control,0,0,0,0,0,0,0,0,Saturday
2021-06-12,Kai Tak Cruise Terminal,0,0,0,0,0,0,0,0,Saturday
2021-06-12,Macau Ferry Terminal,0,0,0,0,0,0,0,0,Saturday
2021-06-12,Tuen Mun Ferry Terminal,0,0,0,0,0,0,0,0,Saturday
2021-06-12,Total,1570,331,10,1911,2032,231,23,2286,Saturday
2021-06-11,Airport,724,28,8,760,1445,27,40,1512,Friday
2021-06-11,Express Rail Link West Kowloon,0,0,0,0,0,0,0,0,Friday
2021-06-11,Hung Hom,0,0,0,0,0,0,0,0,Friday
2021-06-11,Lo Wu,0,0,0,0,0,0,0,0,Friday
2021-06-11,Lok Ma Chau Spur Line,0,0,0,0,0,0,0,0,Friday
2021-06-11,Heung Yuen Wai,0,0,0,0,0,0,0,0,Friday
2021-06-11,Hong Kong-Zhuhai-Macao Bridge,128,5,3,136,193,12,5,210,Friday
2021-06-11,Lok Ma Chau,0,0,0,0,0,0,0,0,Friday
2021-06-11,Man Kam To,0,0,0,0,0,0,0,0,Friday
2021-06-11,Sha Tau Kok,0,0,0,0,0,0,0,0,Friday
2021-06-11,Shenzhen Bay,1016,105,1,1122,715,86,3,804,Friday
2021-06-11,China Ferry Terminal,0,0,0,0,0,0,0,0,Friday
2021-06-11,Harbour Control,0,0,0,0,0,0,0,0,Friday
2021-06-11,Kai Tak Cruise Terminal,0,0,0,0,0,0,0,0,Friday
2021-06-11,Macau Ferry Terminal,0,0,0,0,0,0,0,0,Friday
2021-06-11,Tuen Mun Ferry Terminal,0,0,0,0,0,0,0,0,Friday
2021-06-11,Total,1868,138,12,2018,2353,125,48,2526,Friday
2021-06-10,Airport,471,14,25,510,1246,21,29,1296,Thursday
2021-06-10,Express Rail Link West Kowloon,0,0,0,0,0,0,0,0,Thursday
2021-06-10,Hung Hom,0,0,0,0,0,0,0,0,Thursday
2021-06-10,Lo Wu,0,0,0,0,0,0,0,0,Thursday
2021-06-10,Lok Ma Chau Spur Line,0,0,0,0,0,0,0,0,Thursday
2021-06-10,Heung Yuen Wai,0,0,0,0,0,0,0,0,Thursday
2021-06-10,Hong Kong-Zhuhai-Macao Bridge,138,6,3,147,179,9,4,192,Thursday
2021-06-10,Lok Ma Chau,0,0,0,0,0,0,0,0,Thursday
2021-06-10,Man Kam To,0,0,0,0,0,0,0,0,Thursday
2021-06-10,Sha Tau Kok,0,0,0,0,0,0,0,0,Thursday
2021-06-10,Shenzhen Bay,855,115,2,972,710,130,0,840,Thursday
2021-06-10,China Ferry Terminal,0,0,0,0,0,0,0,0,Thursday
2021-06-10,Harbour Control,0,0,0,0,0,0,0,0,Thursday
2021-06-10,Kai Tak Cruise Terminal,0,0,0,0,0,0,0,0,Thursday
2021-06-10,Macau Ferry Terminal,0,0,0,0,0,0,0,0,Thursday
2021-06-10,Tuen Mun Ferry Terminal,0,0,0,0,0,0,0,0,Thursday
2021-06-10,Total,1464,135,30,1629,2135,160,33,2328,Thursday
2021-06-09,Airport,544,13,15,572,594,7,12,613,Wednesday
2021-06-09,Express Rail Link West Kowloon,0,0,0,0,0,0,0,0,Wednesday
2021-06-09,Hung Hom,0,0,0,0,0,0,0,0,Wednesday
2021-06-09,Lo Wu,0,0,0,0,0,0,0,0,Wednesday
2021-06-09,Lok Ma Chau Spur Line,0,0,0,0,0,0,0,0,Wednesday
2021-06-09,Heung Yuen Wai,0,0,0,0,0,0,0,0,Wednesday
2021-06-09,Hong Kong-Zhuhai-Macao Bridge,108,9,4,121,214,23,3,240,Wednesday
2021-06-09,Lok Ma Chau,0,0,0,0,0,0,0,0,Wednesday
2021-06-09,Man Kam To,0,0,0,0,0,0,0,0,Wednesday
2021-06-09,Sha Tau Kok,0,0,0,0,0,0,0,0,Wednesday
2021-06-09,Shenzhen Bay,987,87,1,1075,632,92,0,724,Wednesday
2021-06-09,China Ferry Terminal,0,0,0,0,0,0,0,0,Wednesday
2021-06-09,Harbour Control,0,0,0,0,0,0,0,0,Wednesday
2021-06-09,Kai Tak Cruise Terminal,0,0,0,0,0,0,0,0,Wednesday
2021-06-09,Macau Ferry Terminal,0,0,0,0,0,0,0,0,Wednesday
2021-06-09,Tuen Mun Ferry Terminal,0,0,0,0,0,0,0,0,Wednesday
2021-06-09,Total,1639,109,20,1768,1440,122,15,1577,Wednesday
2021-06-08,Airport,451,9,4,464,845,16,34,895,Tuesday
2021-06-08,Express Rail Link West Kowloon,0,0,0,0,0,0,0,0,Tuesday
2021-06-08,Hung Hom,0,0,0,0,0,0,0,0,Tuesday
2021-06-08,Lok Ma Chau Spur Line,0,0,0,0,0,0,0,0,Tuesday
2021-06-08,Heung Yuen Wai,0,0,0,0,0,0,0,0,Tuesday
2021-06-08,Hong Kong-Zhuhai-Macao Bridge,119,5,1,125,195,12,4,211,Tuesday
2021-06-08,Lok Ma Chau,0,0,0,0,0,0,0,0,Tuesday
2021-06-08,Man Kam To,0,0,0,0,0,0,0,0,Tuesday
2021-06-08,Sha Tau Kok,0,0,0,0,0,0,0,0,Tuesday
2021-06-08,Shenzhen Bay,916,111,1,1028,657,89,1,747,Tuesday
2021-06-08,China Ferry Terminal,0,0,0,0,0,0,0,0,Tuesday
2021-06-08,Harbour Control,0,0,0,0,0,0,0,0,Tuesday
2021-06-08,Kai Tak Cruise Terminal,0,0,0,0,0,0,0,0,Tuesday
2021-06-08,Macau Ferry Terminal,0,0,0,0,0,0,0,0,Tuesday
2021-06-08,Tuen Mun Ferry Terminal,0,0,0,0,0,0,0,0,Tuesday
2021-06-08,Total,1486,125,6,1617,1697,117,39,1853,Tuesday
2021-06-07,Airport,371,4,3,378,726,4,18,748,Monday
2021-06-07,Express Rail Link West Kowloon,0,0,0,0,0,0,0,0,Monday
2021-06-07,Hung Hom,0,0,0,0,0,0,0,0,Monday
2021-06-07,Lo Wu,0,0,0,0,0,0,0,0,Monday
2021-06-07,Lok Ma Chau Spur Line,0,0,0,0,0,0,0,0,Monday
2021-06-07,Heung Yuen Wai,0,0,0,0,0,0,0,0,Monday
2021-06-07,Hong Kong-Zhuhai-Macao Bridge,103,5,4,112,142,6,3,151,Monday
2021-06-07,Lok Ma Chau,0,0,0,0,0,0,0,0,Monday
2021-06-07,Man Kam To,0,0,0,0,0,0,0,0,Monday
2021-06-07,Sha Tau Kok,0,0,0,0,0,0,0,0,Monday
2021-06-07,Shenzhen Bay,675,89,2,766,599,77,4,680,Monday
2021-06-07,China Ferry Terminal,0,0,0,0,0,0,0,0,Monday
2021-06-07,Harbour Control,0,0,0,0,0,0,0,0,Monday
2021-06-07,Kai Tak Cruise Terminal,0,0,0,0,0,0,0,0,Monday
2021-06-07,Macau Ferry Terminal,0,0,0,0,0,0,0,0,Monday
2021-06-07,Tuen Mun Ferry Terminal,0,0,0,0,0,0,0,0,Monday
2021-06-07,Total,1149,98,9,1256,1467,87,25,1579,Monday
2021-06-06,Airport,848,129,25,1002,1007,17,31,1055,Sunday
2021-06-06,Express Rail Link West Kowloon,0,0,0,0,0,0,0,0,Sunday
2021-06-06,Hung Hom,0,0,0,0,0,0,0,0,Sunday
2021-06-06,Lo Wu,0,0,0,0,0,0,0,0,Sunday
2021-06-06,Lok Ma Chau Spur Line,0,0,0,0,0,0,0,0,Sunday
2021-06-06,Heung Yuen Wai,0,0,0,0,0,0,0,0,Sunday
2021-06-06,Hong Kong-Zhuhai-Macao Bridge,138,10,2,150,132,5,1,138,Sunday
2021-06-06,Lok Ma Chau,0,0,0,0,0,0,0,0,Sunday
2021-06-06,Man Kam To,0,0,0,0,0,0,0,0,Sunday
2021-06-06,Sha Tau Kok,0,0,0,0,0,0,0,0,Sunday
2021-06-06,Shenzhen Bay,887,183,2,1072,563,109,1,673,Sunday
2021-06-06,China Ferry Terminal,0,0,0,0,0,0,0,0,Sunday
2021-06-06,Harbour Control,0,0,0,0,0,0,0,0,Sunday
2021-06-06,Kai Tak Cruise Terminal,0,0,0,0,0,0,0,0,Sunday
2021-06-06,Macau Ferry Terminal,0,0,0,0,0,0,0,0,Sunday
2021-06-06,Tuen Mun Ferry Terminal,0,0,0,0,0,0,0,0,Sunday
2021-06-06,Total,1873,322,29,2224,1702,131,33,1866,Sunday
2021-06-05,Airport,808,10,11,829,1015,27,23,1065,Saturday
2021-06-05,Express Rail Link West Kowloon,0,0,0,0,0,0,0,0,Saturday
2021-06-05,Hung Hom,0,0,0,0,0,0,0,0,Saturday
2021-06-05,Lo Wu,0,0,0,0,0,0,0,0,Saturday
2021-06-05,Lok Ma Chau Spur Line,0,0,0,0,0,0,0,0,Saturday
2021-06-05,Heung Yuen Wai,0,0,0,0,0,0,0,0,Saturday
2021-06-05,Hong Kong-Zhuhai-Macao Bridge,119,3,5,127,193,12,2,207,Saturday
2021-06-05,Lok Ma Chau,0,0,0,0,0,0,0,0,Saturday
2021-06-05,Man Kam To,0,0,0,0,0,0,0,0,Saturday
2021-06-05,Sha Tau Kok,0,0,0,0,0,0,0,0,Saturday
2021-06-05,Shenzhen Bay,943,153,1,1097,625,108,2,735,Saturday
2021-06-05,China Ferry Terminal,0,0,0,0,0,0,0,0,Saturday
2021-06-05,Harbour Control,0,0,0,0,0,0,0,0,Saturday
2021-06-05,Kai Tak Cruise Terminal,0,0,0,0,0,0,0,0,Saturday
2021-06-05,Macau Ferry Terminal,0,0,0,0,0,0,0,0,Saturday
2021-06-05,Tuen Mun Ferry Terminal,0,0,0,0,0,0,0,0,Saturday
2021-06-05,Total,1870,166,17,2053,1833,147,27,2007,Saturday
2021-06-04,Airport,708,12,8,728,1088,16,31,1135,Friday
2021-06-04,Express Rail Link West Kowloon,0,0,0,0,0,0,0,0,Friday
2021-06-04,Hung Hom,0,0,0,0,0,0,0,0,Friday
2021-06-04,Lo Wu,0,0,0,0,0,0,0,0,Friday
2021-06-04,Lok Ma Chau Spur Line,0,0,0,0,0,0,0,0,Friday
2021-06-04,Heung Yuen Wai,0,0,0,0,0,0,0,0,Friday
2021-06-04,Hong Kong-Zhuhai-Macao Bridge,145,3,5,153,169,17,1,187,Friday
2021-06-04,Lok Ma Chau,0,0,0,0,0,0,0,0,Friday
2021-06-04,Man Kam To,0,0,0,0,0,0,0,0,Friday
2021-06-04,Sha Tau Kok,0,0,0,0,0,0,0,0,Friday
2021-06-04,Shenzhen Bay,831,96,4,931,646,109,1,756,Friday
2021-06-04,China Ferry Terminal,0,0,0,0,0,0,0,0,Friday
2021-06-04,Harbour Control,0,0,0,0,0,0,0,0,Friday
2021-06-04,Kai Tak Cruise Terminal,0,0,0,0,0,0,0,0,Friday
2021-06-04,Macau Ferry Terminal,0,0,0,0,0,0,0,0,Friday
2021-06-04,Tuen Mun Ferry Terminal,0,0,0,0,0,0,0,0,Friday
2021-06-04,Total,1684,111,17,1812,1903,142,33,2078,Friday
2021-06-03,Airport,346,9,11,366,1201,22,23,1246,Thursday
2021-06-03,Express Rail Link West Kowloon,0,0,0,0,0,0,0,0,Thursday
2021-06-03,Hung Hom,0,0,0,0,0,0,0,0,Thursday
2021-06-03,Lo Wu,0,0,0,0,0,0,0,0,Thursday
2021-06-03,Lok Ma Chau Spur Line,0,0,0,0,0,0,0,0,Thursday
2021-06-03,Heung Yuen Wai,0,0,0,0,0,0,0,0,Thursday
2021-06-03,Hong Kong-Zhuhai-Macao Bridge,137,8,3,148,239,13,1,253,Thursday
2021-06-03,Lok Ma Chau,0,0,0,0,0,0,0,0,Thursday
2021-06-03,Man Kam To,0,0,0,0,0,0,0,0,Thursday
2021-06-03,Sha Tau Kok,0,0,0,0,0,0,0,0,Thursday
2021-06-03,Shenzhen Bay,960,137,4,1101,727,129,3,859,Thursday
2021-06-03,China Ferry Terminal,0,0,0,0,0,0,0,0,Thursday
2021-06-03,Harbour Control,0,0,0,0,0,0,0,0,Thursday
2021-06-03,Kai Tak Cruise Terminal,0,0,0,0,0,0,0,0,Thursday
2021-06-03,Macau Ferry Terminal,0,0,0,0,0,0,0,0,Thursday
2021-06-03,Tuen Mun Ferry Terminal,0,0,0,0,0,0,0,0,Thursday
2021-06-03,Total,1443,154,18,1615,2167,164,27,2358,Thursday
2021-06-02,Airport,811,2,19,832,682,10,22,714,Wednesday
2021-06-02,Express Rail Link West Kowloon,0,0,0,0,0,0,0,0,Wednesday
2021-06-02,Hung Hom,0,0,0,0,0,0,0,0,Wednesday
2021-06-02,Lo Wu,0,0,0,0,0,0,0,0,Wednesday
2021-06-02,Lok Ma Chau Spur Line,0,0,0,0,0,0,0,0,Wednesday
2021-06-02,Heung Yuen Wai,0,0,0,0,0,0,0,0,Wednesday
2021-06-02,Hong Kong-Zhuhai-Macao Bridge,118,3,9,130,221,16,3,240,Wednesday
2021-06-02,Lok Ma Chau,0,0,0,0,0,0,0,0,Wednesday
2021-06-02,Man Kam To,0,0,0,0,0,0,0,0,Wednesday
2021-06-02,Sha Tau Kok,0,0,0,0,0,0,0,0,Wednesday
2021-06-02,Shenzhen Bay,1020,102,1,1123,733,99,1,833,Wednesday
2021-06-02,China Ferry Terminal,0,0,0,0,0,0,0,0,Wednesday
2021-06-02,Harbour Control,0,0,0,0,0,0,0,0,Wednesday
2021-06-02,Kai Tak Cruise Terminal,0,0,0,0,0,0,0,0,Wednesday
2021-06-02,Macau Ferry Terminal,0,0,0,0,0,0,0,0,Wednesday
2021-06-02,Tuen Mun Ferry Terminal,0,0,0,0,0,0,0,0,Wednesday
2021-06-02,Total,1949,107,29,2085,1636,125,26,1787,Wednesday
2021-06-01,Airport,390,9,15,414,1420,18,56,1494,Tuesday
2021-06-01,Express Rail Link West Kowloon,0,0,0,0,0,0,0,0,Tuesday
2021-06-01,Hung Hom,0,0,0,0,0,0,0,0,Tuesday
2021-06-01,Lo Wu,0,0,0,0,0,0,0,0,Tuesday
2021-06-01,Lok Ma Chau Spur Line,0,0,0,0,0,0,0,0,Tuesday
2021-06-01,Heung Yuen Wai,0,0,0,0,0,0,0,0,Tuesday
2021-06-01,Hong Kong-Zhuhai-Macao Bridge,113,5,6,124,285,9,4,298,Tuesday
2021-06-01,Lok Ma Chau,0,0,0,0,0,0,0,0,Tuesday
2021-06-01,Man Kam To,0,0,0,0,0,0,0,0,Tuesday
2021-06-01,Sha Tau Kok,0,0,0,0,0,0,0,0,Tuesday
2021-06-01,Shenzhen Bay,907,130,2,1039,980,102,2,1084,Tuesday
2021-06-01,China Ferry Terminal,0,0,0,0,0,0,0,0,Tuesday
2021-06-01,Harbour Control,0,0,0,0,0,0,0,0,Tuesday
2021-06-01,Kai Tak Cruise Terminal,0,0,0,0,0,0,0,0,Tuesday
2021-06-01,Macau Ferry Terminal,0,0,0,0,0,0,0,0,Tuesday
2021-06-01,Tuen Mun Ferry Terminal,0,0,0,0,0,0,0,0,Tuesday
2021-06-01,Total,1410,144,23,1577,2685,129,62,2876,Tuesday
2021-05-31,Airport,377,3,4,384,899,4,34,937,Monday
2021-05-31,Express Rail Link West Kowloon,0,0,0,0,0,0,0,0,Monday
2021-05-31,Hung Hom,0,0,0,0,0,0,0,0,Monday
2021-05-31,Lo Wu,0,0,0,0,0,0,0,0,Monday
2021-05-31,Lok Ma Chau Spur Line,0,0,0,0,0,0,0,0,Monday
2021-05-31,Heung Yuen Wai,0,0,0,0,0,0,0,0,Monday
2021-05-31,Hong Kong-Zhuhai-Macao Bridge,125,5,3,133,185,5,2,192,Monday
2021-05-31,Lok Ma Chau,0,0,0,0,0,0,0,0,Monday
2021-05-31,Man Kam To,0,0,0,0,0,0,0,0,Monday
2021-05-31,Sha Tau Kok,0,0,0,0,0,0,0,0,Monday
2021-05-31,Shenzhen Bay,971,77,1,1049,754,82,0,836,Monday
2021-05-31,China Ferry Terminal,0,0,0,0,0,0,0,0,Monday
2021-05-31,Harbour Control,0,0,0,0,0,0,0,0,Monday
2021-05-31,Kai Tak Cruise Terminal,0,0,0,0,0,0,0,0,Monday
2021-05-31,Macau Ferry Terminal,0,0,0,0,0,0,0,0,Monday
2021-05-31,Tuen Mun Ferry Terminal,0,0,0,0,0,0,0,0,Monday
2021-05-31,Total,1473,85,8,1566,1838,91,36,1965,Monday
2021-06-29,Airport,876,21,20,917,1622,20,31,1673,Tuesday
2021-06-29,Express Rail Link West Kowloon,0,0,0,0,0,0,0,0,Tuesday
2021-06-29,Hung Hom,0,0,0,0,0,0,0,0,Tuesday
2021-06-29,Lo Wu,0,0,0,0,0,0,0,0,Tuesday
2021-06-29,Lok Ma Chau Spur Line,0,0,0,0,0,0,0,0,Tuesday
2021-06-29,Heung Yuen Wai,0,0,0,0,0,0,0,0,Tuesday
2021-06-29,Hong Kong-Zhuhai-Macao Bridge,175,9,2,186,174,15,3,192,Tuesday
2021-06-29,Lok Ma Chau,0,0,0,0,0,0,0,0,Tuesday
2021-06-29,Man Kam To,0,0,0,0,0,0,0,0,Tuesday
2021-06-29,Sha Tau Kok,0,0,0,0,0,0,0,0,Tuesday
2021-06-29,Shenzhen Bay,821,113,0,934,531,105,1,637,Tuesday
2021-06-29,China Ferry Terminal,0,0,0,0,0,0,0,0,Tuesday
2021-06-29,Harbour Control,0,0,0,0,0,0,0,0,Tuesday
2021-06-29,Kai Tak Cruise Terminal,0,0,0,0,0,0,0,0,Tuesday
2021-06-29,Macau Ferry Terminal,0,0,0,0,0,0,0,0,Tuesday
2021-06-29,Tuen Mun Ferry Terminal,0,0,0,0,0,0,0,0,Tuesday
2021-06-29,Total,1872,143,22,2037,2327,140,35,2502,Tuesday
2021-06-30,Airport,1630,14,11,1655,1478,17,29,1524,Wednesday
2021-06-30,Express Rail Link West Kowloon,0,0,0,0,0,0,0,0,Wednesday
2021-06-30,Hung Hom,0,0,0,0,0,0,0,0,Wednesday
2021-06-30,Lo Wu,0,0,0,0,0,0,0,0,Wednesday
2021-06-30,Lok Ma Chau Spur Line,0,0,0,0,0,0,0,0,Wednesday
2021-06-30,Heung Yuen Wai,0,0,0,0,0,0,0,0,Wednesday
2021-06-30,Hong Kong-Zhuhai-Macao Bridge,233,9,13,255,238,18,7,263,Wednesday
2021-06-30,Lok Ma Chau,0,0,0,0,0,0,0,0,Wednesday
2021-06-30,Man Kam To,0,0,0,0,0,0,0,0,Wednesday
2021-06-30,Sha Tau Kok,0,0,0,0,0,0,0,0,Wednesday
2021-06-30,Shenzhen Bay,1137,117,0,1254,737,134,0,871,Wednesday
2021-06-30,China Ferry Terminal,0,0,0,0,0,0,0,0,Wednesday
2021-06-30,Harbour Control,0,0,0,0,0,0,0,0,Wednesday
2021-06-30,Kai Tak Cruise Terminal,0,0,0,0,0,0,0,0,Wednesday
2021-06-30,Macau Ferry Terminal,0,0,0,0,0,0,0,0,Wednesday
2021-06-30,Tuen Mun Ferry Terminal,0,0,0,0,0,0,0,0,Wednesday
2021-06-30,Total,3000,140,24,3164,2453,169,36,2658,Wednesday
2021-07-01,Airport,754,22,20,796,1733,31,33,1797,Thursday
2021-07-01,Express Rail Link West Kowloon,0,0,0,0,0,0,0,0,Thursday
2021-07-01,Hung Hom,0,0,0,0,0,0,0,0,Thursday
2021-07-01,Lo Wu,0,0,0,0,0,0,0,0,Thursday
2021-07-01,Lok Ma Chau Spur Line,0,0,0,0,0,0,0,0,Thursday
2021-07-01,Heung Yuen Wai,0,0,0,0,0,0,0,0,Thursday
2021-07-01,Hong Kong-Zhuhai-Macao Bridge,147,9,7,163,266,26,3,295,Thursday
2021-07-01,Lok Ma Chau,0,0,0,0,0,0,0,0,Thursday
2021-07-01,Man Kam To,0,0,0,0,0,0,0,0,Thursday
2021-07-01,Sha Tau Kok,0,0,0,0,0,0,0,0,Thursday
2021-07-01,Shenzhen Bay,739,120,0,859,721,107,2,830,Thursday
2021-07-01,China Ferry Terminal,0,0,0,0,0,0,0,0,Thursday
2021-07-01,Harbour Control,0,0,0,0,0,0,0,0,Thursday
2021-07-01,Kai Tak Cruise Terminal,0,0,0,0,0,0,0,0,Thursday
2021-07-01,Macau Ferry Terminal,0,0,0,0,0,0,0,0,Thursday
2021-07-01,Tuen Mun Ferry Terminal,0,0,0,0,0,0,0,0,Thursday
2021-07-01,Total,1640,151,27,1818,2720,164,38,2922,Thursday
2021-07-02,Airport,568,14,12,594,1865,33,32,1930,Friday
2021-07-02,Express Rail Link West Kowloon,0,0,0,0,0,0,0,0,Friday
2021-07-02,Hung Hom,0,0,0,0,0,0,0,0,Friday
2021-07-02,Lo Wu,0,0,0,0,0,0,0,0,Friday
2021-07-02,Lok Ma Chau Spur Line,0,0,0,0,0,0,0,0,Friday
2021-07-02,Heung Yuen Wai,0,0,0,0,0,0,0,0,Friday
2021-07-02,Hong Kong-Zhuhai-Macao Bridge,167,11,4,182,247,11,5,263,Friday
2021-07-02,Lok Ma Chau,0,0,0,0,0,0,0,0,Friday
2021-07-02,Man Kam To,0,0,0,0,0,0,0,0,Friday
2021-07-02,Sha Tau Kok,0,0,0,0,0,0,0,0,Friday
2021-07-02,Shenzhen Bay,928,141,3,1072,704,85,3,792,Friday
2021-07-02,China Ferry Terminal,0,0,0,0,0,0,0,0,Friday
2021-07-02,Harbour Control,0,0,0,0,0,0,0,0,Friday
2021-07-02,Kai Tak Cruise Terminal,0,0,0,0,0,0,0,0,Friday
2021-07-02,Macau Ferry Terminal,0,0,0,0,0,0,0,0,Friday
2021-07-02,Tuen Mun Ferry Terminal,0,0,0,0,0,0,0,0,Friday
2021-07-02,Total,1663,166,19,1848,2816,129,40,2985,Friday
2021-07-03,Airport,454,24,13,491,1365,33,18,1416,Saturday
2021-07-03,Express Rail Link West Kowloon,0,0,0,0,0,0,0,0,Saturday
2021-07-03,Hung Hom,0,0,0,0,0,0,0,0,Saturday
2021-07-03,Lo Wu,0,0,0,0,0,0,0,0,Saturday
2021-07-03,Lok Ma Chau Spur Line,0,0,0,0,0,0,0,0,Saturday
2021-07-03,Heung Yuen Wai,0,0,0,0,0,0,0,0,Saturday
2021-07-03,Hong Kong-Zhuhai-Macao Bridge,184,8,8,200,223,21,5,249,Saturday
2021-07-03,Lok Ma Chau,0,0,0,0,0,0,0,0,Saturday
2021-07-03,Man Kam To,0,0,0,0,0,0,0,0,Saturday
2021-07-03,Sha Tau Kok,0,0,0,0,0,0,0,0,Saturday
2021-07-03,Shenzhen Bay,920,136,4,1060,695,150,4,849,Saturday
2021-07-03,China Ferry Terminal,0,0,0,0,0,0,0,0,Saturday
2021-07-03,Harbour Control,0,0,0,0,0,0,0,0,Saturday
2021-07-03,Kai Tak Cruise Terminal,0,0,0,0,0,0,0,0,Saturday
2021-07-03,Macau Ferry Terminal,0,0,0,0,0,0,0,0,Saturday
2021-07-03,Tuen Mun Ferry Terminal,0,0,0,0,0,0,0,0,Saturday
2021-07-03,Total,1558,168,25,1751,2283,204,27,2514,Saturday
2021-07-04,Airport,755,26,15,796,1611,33,38,1682,Sunday
2021-07-04,Express Rail Link West Kowloon,0,0,0,0,0,0,0,0,Sunday
2021-07-04,Hung Hom,0,0,0,0,0,0,0,0,Sunday
2021-07-04,Lo Wu,0,0,0,0,0,0,0,0,Sunday
2021-07-04,Lok Ma Chau Spur Line,0,0,0,0,0,0,0,0,Sunday
2021-07-04,Heung Yuen Wai,0,0,0,0,0,0,0,0,Sunday
2021-07-04,Hong Kong-Zhuhai-Macao Bridge,193,7,3,203,236,30,2,268,Sunday
2021-07-04,Lok Ma Chau,0,0,0,0,0,0,0,0,Sunday
2021-07-04,Man Kam To,0,0,0,0,0,0,0,0,Sunday
2021-07-04,Sha Tau Kok,0,0,0,0,0,0,0,0,Sunday
2021-07-04,Shenzhen Bay,1047,179,4,1230,712,125,2,839,Sunday
2021-07-04,China Ferry Terminal,0,0,0,0,0,0,0,0,Sunday
2021-07-04,Harbour Control,0,0,0,0,0,0,0,0,Sunday
2021-07-04,Kai Tak Cruise Terminal,0,0,0,0,0,0,0,0,Sunday
2021-07-04,Macau Ferry Terminal,0,0,0,0,0,0,0,0,Sunday
2021-07-04,Tuen Mun Ferry Terminal,0,0,0,0,0,0,0,0,Sunday
2021-07-04,Total,1995,212,22,2229,2559,188,42,2789,Sunday
2021-07-05,Airport,529,8,3,540,1221,7,11,1239,Monday
2021-07-05,Express Rail Link West Kowloon,0,0,0,0,0,0,0,0,Monday
2021-07-05,Hung Hom,0,0,0,0,0,0,0,0,Monday
2021-07-05,Lo Wu,0,0,0,0,0,0,0,0,Monday
2021-07-05,Lok Ma Chau Spur Line,0,0,0,0,0,0,0,0,Monday
2021-07-05,Heung Yuen Wai,0,0,0,0,0,0,0,0,Monday
2021-07-05,Hong Kong-Zhuhai-Macao Bridge,158,16,3,177,256,21,4,281,Monday
2021-07-05,Lok Ma Chau,0,0,0,0,0,0,0,0,Monday
2021-07-05,Man Kam To,0,0,0,0,0,0,0,0,Monday
2021-07-05,Sha Tau Kok,0,0,0,0,0,0,0,0,Monday
2021-07-05,Shenzhen Bay,1035,123,1,1159,874,134,2,1010,Monday
2021-07-05,China Ferry Terminal,0,0,0,0,0,0,0,0,Monday
2021-07-05,Harbour Control,0,0,0,0,0,0,0,0,Monday
2021-07-05,Kai Tak Cruise Terminal,0,0,0,0,0,0,0,0,Monday
2021-07-05,Macau Ferry Terminal,0,0,0,0,0,0,0,0,Monday
2021-07-05,Tuen Mun Ferry Terminal,0,0,0,0,0,0,0,0,Monday
2021-07-05,Total,1722,147,7,1876,2351,162,17,2530,Monday
2021-07-06,Airport,526,15,10,551,1574,19,19,1612,Tuesday
2021-07-06,Express Rail Link West Kowloon,0,0,0,0,0,0,0,0,Tuesday
2021-07-06,Hung Hom,0,0,0,0,0,0,0,0,Tuesday
2021-07-06,Lo Wu,0,0,0,0,0,0,0,0,Tuesday
2021-07-06,Lok Ma Chau Spur Line,0,0,0,0,0,0,0,0,Tuesday
2021-07-06,Heung Yuen Wai,0,0,0,0,0,0,0,0,Tuesday
2021-07-06,Hong Kong-Zhuhai-Macao Bridge,178,4,1,183,297,20,2,319,Tuesday
2021-07-06,Lok Ma Chau,0,0,0,0,0,0,0,0,Tuesday
2021-07-06,Man Kam To,0,0,0,0,0,0,0,0,Tuesday
2021-07-06,Sha Tau Kok,0,0,0,0,0,0,0,0,Tuesday
2021-07-06,Shenzhen Bay,1078,122,1,1201,801,104,0,905,Tuesday
2021-07-06,China Ferry Terminal,0,0,0,0,0,0,0,0,Tuesday
2021-07-06,Harbour Control,0,0,0,0,0,0,0,0,Tuesday
2021-07-06,Kai Tak Cruise Terminal,0,0,0,0,0,0,0,0,Tuesday
2021-07-06,Macau Ferry Terminal,0,0,0,0,0,0,0,0,Tuesday
2021-07-06,Tuen Mun Ferry Terminal,0,0,0,0,0,0,0,0,Tuesday
2021-07-06,Total,1782,141,12,1935,2672,143,21,2836,Tuesday
2021-07-10,Airport,398,22,6,426,1490,54,18,1562,Saturday
2021-07-10,Express Rail Link West Kowloon,0,0,0,0,0,0,0,0,Saturday
2021-07-10,Hung Hom,0,0,0,0,0,0,0,0,Saturday
2021-07-10,Lo Wu,0,0,0,0,0,0,0,0,Saturday
2021-07-10,Lok Ma Chau Spur Line,0,0,0,0,0,0,0,0,Saturday
2021-07-10,Heung Yuen Wai,0,0,0,0,0,0,0,0,Saturday
2021-07-10,Hong Kong-Zhuhai-Macao Bridge,184,5,3,192,277,23,1,301,Saturday
2021-07-10,Lok Ma Chau,0,0,0,0,0,0,0,0,Saturday
2021-07-10,Man Kam To,0,0,0,0,0,0,0,0,Saturday
2021-07-10,Sha Tau Kok,0,0,0,0,0,0,0,0,Saturday
2021-07-10,Shenzhen Bay,1294,171,4,1469,1405,169,1,1575,Saturday
2021-07-10,China Ferry Terminal,0,0,0,0,0,0,0,0,Saturday
2021-07-10,Harbour Control,0,0,0,0,0,0,0,0,Saturday
2021-07-10,Kai Tak Cruise Terminal,0,0,0,0,0,0,0,0,Saturday
2021-07-10,Macau Ferry Terminal,0,0,0,0,0,0,0,0,Saturday
2021-07-10,Tuen Mun Ferry Terminal,0,0,0,0,0,0,0,0,Saturday
2021-07-10,Total,1876,198,13,2087,3172,246,20,3438,Saturday
2021-07-09,Airport,612,24,19,655,1743,15,30,1788,Friday
2021-07-09,Express Rail Link West Kowloon,0,0,0,0,0,0,0,0,Friday
2021-07-09,Hung Hom,0,0,0,0,0,0,0,0,Friday
2021-07-09,Lo Wu,0,0,0,0,0,0,0,0,Friday
2021-07-09,Lok Ma Chau Spur Line,0,0,0,0,0,0,0,0,Friday
2021-07-09,Heung Yuen Wai,0,0,0,0,0,0,0,0,Friday
2021-07-09,Hong Kong-Zhuhai-Macao Bridge,217,14,4,235,273,19,1,293,Friday
2021-07-09,Lok Ma Chau,0,0,0,0,0,0,0,0,Friday
2021-07-09,Man Kam To,0,0,0,0,0,0,0,0,Friday
2021-07-09,Sha Tau Kok,0,0,0,0,0,0,0,0,Friday
2021-07-09,Shenzhen Bay,1076,130,2,1208,1143,218,0,1361,Friday
2021-07-09,China Ferry Terminal,0,0,0,0,0,0,0,0,Friday
2021-07-09,Harbour Control,0,0,0,0,0,0,0,0,Friday
2021-07-09,Kai Tak Cruise Terminal,0,0,0,0,0,0,0,0,Friday
2021-07-09,Macau Ferry Terminal,0,0,0,0,0,0,0,0,Friday
2021-07-09,Tuen Mun Ferry Terminal,0,0,0,0,0,0,0,0,Friday
2021-07-09,Total,1905,168,25,2098,3159,252,31,3442,Friday
2021-07-08,Airport,374,19,7,400,1575,26,29,1630,Thursday
2021-07-08,Express Rail Link West Kowloon,0,0,0,0,0,0,0,0,Thursday
2021-07-08,Hung Hom,0,0,0,0,0,0,0,0,Thursday
2021-07-08,Lo Wu,0,0,0,0,0,0,0,0,Thursday
2021-07-08,Lok Ma Chau Spur Line,0,0,0,0,0,0,0,0,Thursday
2021-07-08,Heung Yuen Wai,0,0,0,0,0,0,0,0,Thursday
2021-07-08,Hong Kong-Zhuhai-Macao Bridge,183,6,6,195,263,25,4,292,Thursday
2021-07-08,Lok Ma Chau,0,0,0,0,0,0,0,0,Thursday
2021-07-08,Man Kam To,0,0,0,0,0,0,0,0,Thursday
2021-07-08,Sha Tau Kok,0,0,0,0,0,0,0,0,Thursday
2021-07-08,Shenzhen Bay,1003,120,3,1126,951,174,2,1127,Thursday
2021-07-08,China Ferry Terminal,0,0,0,0,0,0,0,0,Thursday
2021-07-08,Harbour Control,0,0,0,0,0,0,0,0,Thursday
2021-07-08,Kai Tak Cruise Terminal,0,0,0,0,0,0,0,0,Thursday
2021-07-08,Macau Ferry Terminal,0,0,0,0,0,0,0,0,Thursday
2021-07-08,Tuen Mun Ferry Terminal,0,0,0,0,0,0,0,0,Thursday
2021-07-08,Total,1560,145,16,1721,2789,225,35,3049,Thursday
2021-07-07,Airport,490,16,8,514,1066,17,10,1093,Wednesday
2021-07-07,Express Rail Link West Kowloon,0,0,0,0,0,0,0,0,Wednesday
2021-07-07,Hung Hom,0,0,0,0,0,0,0,0,Wednesday
2021-07-07,Lo Wu,0,0,0,0,0,0,0,0,Wednesday
2021-07-07,Lok Ma Chau Spur Line,0,0,0,0,0,0,0,0,Wednesday
2021-07-07,Heung Yuen Wai,0,0,0,0,0,0,0,0,Wednesday
2021-07-07,Hong Kong-Zhuhai-Macao Bridge,175,8,4,187,282,21,7,310,Wednesday
2021-07-07,Lok Ma Chau,0,0,0,0,0,0,0,0,Wednesday
2021-07-07,Man Kam To,0,0,0,0,0,0,0,0,Wednesday
2021-07-07,Sha Tau Kok,0,0,0,0,0,0,0,0,Wednesday
2021-07-07,Shenzhen Bay,1095,156,4,1255,921,161,1,1083,Wednesday
2021-07-07,China Ferry Terminal,0,0,0,0,0,0,0,0,Wednesday
2021-07-07,Harbour Control,0,0,0,0,0,0,0,0,Wednesday
2021-07-07,Kai Tak Cruise Terminal,0,0,0,0,0,0,0,0,Wednesday
2021-07-07,Macau Ferry Terminal,0,0,0,0,0,0,0,0,Wednesday
2021-07-07,Tuen Mun Ferry Terminal,0,0,0,0,0,0,0,0,Wednesday
2021-07-07,Total,1760,180,16,1956,2269,199,18,2486,Wednesday
2021-07-11,Airport,1099,37,22,1158,1810,35,32,1877,Sunday
2021-07-11,Express Rail Link West Kowloon,0,0,0,0,0,0,0,0,Sunday
2021-07-11,Hung Hom,0,0,0,0,0,0,0,0,Sunday
2021-07-11,Lo Wu,0,0,0,0,0,0,0,0,Sunday
2021-07-11,Lok Ma Chau Spur Line,0,0,0,0,0,0,0,0,Sunday
2021-07-11,Heung Yuen Wai,0,0,0,0,0,0,0,0,Sunday
2021-07-11,Hong Kong-Zhuhai-Macao Bridge,215,10,5,230,280,22,0,302,Sunday
2021-07-11,Lok Ma Chau,0,0,0,0,0,0,0,0,Sunday
2021-07-11,Man Kam To,0,0,0,0,0,0,0,0,Sunday
2021-07-11,Sha Tau Kok,0,0,0,0,0,0,0,0,Sunday
2021-07-11,Shenzhen Bay,1455,184,1,1640,1195,166,1,1362,Sunday
2021-07-11,China Ferry Terminal,0,0,0,0,0,0,0,0,Sunday
2021-07-11,Harbour Control,0,0,0,0,0,0,0,0,Sunday
2021-07-11,Kai Tak Cruise Terminal,0,0,0,0,0,0,0,0,Sunday
2021-07-11,Macau Ferry Terminal,0,0,0,0,0,0,0,0,Sunday
2021-07-11,Tuen Mun Ferry Terminal,0,0,0,0,0,0,0,0,Sunday
2021-07-11,Total,2769,231,28,3028,3285,223,33,3541,Sunday
2021-07-12,Airport,585,5,5,595,1272,17,18,1307,Monday
2021-07-12,Express Rail Link West Kowloon,0,0,0,0,0,0,0,0,Monday
2021-07-12,Hung Hom,0,0,0,0,0,0,0,0,Monday
2021-07-12,Lo Wu,0,0,0,0,0,0,0,0,Monday
2021-07-12,Lok Ma Chau Spur Line,0,0,0,0,0,0,0,0,Monday
2021-07-12,Heung Yuen Wai,0,0,0,0,0,0,0,0,Monday
2021-07-12,Hong Kong-Zhuhai-Macao Bridge,149,17,2,168,292,15,0,307,Monday
2021-07-12,Lok Ma Chau,0,0,0,0,0,0,0,0,Monday
2021-07-12,Man Kam To,0,0,0,0,0,0,0,0,Monday
2021-07-12,Sha Tau Kok,0,0,0,0,0,0,0,0,Monday
2021-07-12,Shenzhen Bay,1305,122,3,1430,1478,163,1,1642,Monday
2021-07-12,China Ferry Terminal,0,0,0,0,0,0,0,0,Monday
2021-07-12,Harbour Control,0,0,0,0,0,0,0,0,Monday
2021-07-12,Kai Tak Cruise Terminal,0,0,0,0,0,0,0,0,Monday
2021-07-12,Macau Ferry Terminal,0,0,0,0,0,0,0,0,Monday
2021-07-12,Tuen Mun Ferry Terminal,0,0,0,0,0,0,0,0,Monday
2021-07-12,Total,2039,144,10,2193,3042,195,19,3256,Monday
2021-07-13,Airport,714,14,17,745,1432,21,21,1474,Tuesday
2021-07-13,Express Rail Link West Kowloon,0,0,0,0,0,0,0,0,Tuesday
2021-07-13,Hung Hom,0,0,0,0,0,0,0,0,Tuesday
2021-07-13,Lo Wu,0,0,0,0,0,0,0,0,Tuesday
2021-07-13,Lok Ma Chau Spur Line,0,0,0,0,0,0,0,0,Tuesday
2021-07-13,Heung Yuen Wai,0,0,0,0,0,0,0,0,Tuesday
2021-07-13,Hong Kong-Zhuhai-Macao Bridge,152,11,9,172,295,23,1,319,Tuesday
2021-07-13,Lok Ma Chau,0,0,0,0,0,0,0,0,Tuesday
2021-07-13,Man Kam To,0,0,0,0,0,0,0,0,Tuesday
2021-07-13,Sha Tau Kok,0,0,0,0,0,0,0,0,Tuesday
2021-07-13,Shenzhen Bay,1190,150,2,1342,1804,264,4,2072,Tuesday
2021-07-13,China Ferry Terminal,0,0,0,0,0,0,0,0,Tuesday
2021-07-13,Harbour Control,0,0,0,0,0,0,0,0,Tuesday
2021-07-13,Kai Tak Cruise Terminal,0,0,0,0,0,0,0,0,Tuesday
2021-07-13,Macau Ferry Terminal,0,0,0,0,0,0,0,0,Tuesday
2021-07-13,Tuen Mun Ferry Terminal,0,0,0,0,0,0,0,0,Tuesday
2021-07-13,Total,2056,175,28,2259,3531,308,26,3865,Tuesday
2021-07-14,Airport,631,10,19,660,1194,22,20,1236,Wednesday
2021-07-14,Express Rail Link West Kowloon,0,0,0,0,0,0,0,0,Wednesday
2021-07-14,Hung Hom,0,0,0,0,0,0,0,0,Wednesday
2021-07-14,Lo Wu,0,0,0,0,0,0,0,0,Wednesday
2021-07-14,Lok Ma Chau Spur Line,0,0,0,0,0,0,0,0,Wednesday
2021-07-14,Heung Yuen Wai,0,0,0,0,0,0,0,0,Wednesday
2021-07-14,Hong Kong-Zhuhai-Macao Bridge,161,9,5,175,324,15,1,340,Wednesday
2021-07-14,Lok Ma Chau,0,0,0,0,0,0,0,0,Wednesday
2021-07-14,Man Kam To,0,0,0,0,0,0,0,0,Wednesday
2021-07-14,Sha Tau Kok,0,0,0,0,0,0,0,0,Wednesday
2021-07-14,Shenzhen Bay,1265,164,2,1431,1885,297,0,2182,Wednesday
2021-07-14,China Ferry Terminal,0,0,0,0,0,0,0,0,Wednesday
2021-07-14,Harbour Control,0,0,0,0,0,0,0,0,Wednesday
2021-07-14,Kai Tak Cruise Terminal,0,0,0,0,0,0,0,0,Wednesday
2021-07-14,Macau Ferry Terminal,0,0,0,0,0,0,0,0,Wednesday
2021-07-14,Tuen Mun Ferry Terminal,0,0,0,0,0,0,0,0,Wednesday
2021-07-14,Total,2057,183,26,2266,3403,334,21,3758,Wednesday
2021-07-15,Airport,559,18,15,592,1901,46,14,1961,Thursday
2021-07-15,Express Rail Link West Kowloon,0,0,0,0,0,0,0,0,Thursday
2021-07-15,Hung Hom,0,0,0,0,0,0,0,0,Thursday
2021-07-15,Lo Wu,0,0,0,0,0,0,0,0,Thursday
2021-07-15,Lok Ma Chau Spur Line,0,0,0,0,0,0,0,0,Thursday
2021-07-15,Heung Yuen Wai,0,0,0,0,0,0,0,0,Thursday
2021-07-15,Hong Kong-Zhuhai-Macao Bridge,193,6,9,208,384,21,6,411,Thursday
2021-07-15,Lok Ma Chau,0,0,0,0,0,0,0,0,Thursday
2021-07-15,Man Kam To,0,0,0,0,0,0,0,0,Thursday
2021-07-15,Sha Tau Kok,0,0,0,0,0,0,0,0,Thursday
2021-07-15,Shenzhen Bay,1586,188,10,1784,1953,239,3,2195,Thursday
2021-07-15,China Ferry Terminal,0,0,0,0,0,0,0,0,Thursday
2021-07-15,Harbour Control,0,0,0,0,0,0,0,0,Thursday
2021-07-15,Kai Tak Cruise Terminal,0,0,0,0,0,0,0,0,Thursday
2021-07-15,Macau Ferry Terminal,0,0,0,0,0,0,0,0,Thursday
2021-07-15,Tuen Mun Ferry Terminal,0,0,0,0,0,0,0,0,Thursday
2021-07-15,Total,2338,212,34,2584,4238,306,23,4567,Thursday
2021-07-16,Airport,625,22,18,665,1941,31,29,2001,Friday
2021-07-16,Express Rail Link West Kowloon,0,0,0,0,0,0,0,0,Friday
2021-07-16,Hung Hom,0,0,0,0,0,0,0,0,Friday
2021-07-16,Lo Wu,0,0,0,0,0,0,0,0,Friday
2021-07-16,Lok Ma Chau Spur Line,0,0,0,0,0,0,0,0,Friday
2021-07-16,Heung Yuen Wai,0,0,0,0,0,0,0,0,Friday
2021-07-16,Hong Kong-Zhuhai-Macao Bridge,172,4,4,180,357,16,8,381,Friday
2021-07-16,Lok Ma Chau,0,0,0,0,0,0,0,0,Friday
2021-07-16,Man Kam To,0,0,0,0,0,0,0,0,Friday
2021-07-16,Sha Tau Kok,0,0,0,0,0,0,0,0,Friday
2021-07-16,Shenzhen Bay,1385,181,1,1567,1884,297,2,2183,Friday
2021-07-16,China Ferry Terminal,0,0,0,0,0,0,0,0,Friday
2021-07-16,Harbour Control,0,0,0,0,0,0,0,0,Friday
2021-07-16,Kai Tak Cruise Terminal,0,0,0,0,0,0,0,0,Friday
2021-07-16,Macau Ferry Terminal,0,0,0,0,0,0,0,0,Friday
2021-07-16,Tuen Mun Ferry Terminal,0,0,0,0,0,0,0,0,Friday
2021-07-16,Total,2182,207,23,2412,4182,344,39,4565,Friday
2021-07-17,Airport,341,17,14,372,1743,34,15,1792,Saturday
2021-07-17,Express Rail Link West Kowloon,0,0,0,0,0,0,0,0,Saturday
2021-07-17,Hung Hom,0,0,0,0,0,0,0,0,Saturday
2021-07-17,Lo Wu,0,0,0,0,0,0,0,0,Saturday
2021-07-17,Lok Ma Chau Spur Line,0,0,0,0,0,0,0,0,Saturday
2021-07-17,Heung Yuen Wai,0,0,0,0,0,0,0,0,Saturday
2021-07-17,Hong Kong-Zhuhai-Macao Bridge,172,11,4,187,318,8,5,331,Saturday
2021-07-17,Lok Ma Chau,0,0,0,0,0,0,0,0,Saturday
2021-07-17,Man Kam To,0,0,0,0,0,0,0,0,Saturday
2021-07-17,Sha Tau Kok,0,0,0,0,0,0,0,0,Saturday
2021-07-17,Shenzhen Bay,1251,150,4,1405,1892,226,6,2124,Saturday
2021-07-17,China Ferry Terminal,0,0,0,0,0,0,0,0,Saturday
2021-07-17,Harbour Control,0,0,0,0,0,0,0,0,Saturday
2021-07-17,Kai Tak Cruise Terminal,0,0,0,0,0,0,0,0,Saturday
2021-07-17,Macau Ferry Terminal,0,0,0,0,0,0,0,0,Saturday
2021-07-17,Tuen Mun Ferry Terminal,0,0,0,0,0,0,0,0,Saturday
2021-07-17,Total,1764,178,22,1964,3953,268,26,4247,Saturday
2021-07-18,Airport,1257,28,24,1309,2093,44,22,2159,Sunday
2021-07-18,Express Rail Link West Kowloon,0,0,0,0,0,0,0,0,Sunday
2021-07-18,Hung Hom,0,0,0,0,0,0,0,0,Sunday
2021-07-18,Lo Wu,0,0,0,0,0,0,0,0,Sunday
2021-07-18,Lok Ma Chau Spur Line,0,0,0,0,0,0,0,0,Sunday
2021-07-18,Heung Yuen Wai,0,0,0,0,0,0,0,0,Sunday
2021-07-18,Hong Kong-Zhuhai-Macao Bridge,169,10,6,185,295,20,7,322,Sunday
2021-07-18,Lok Ma Chau,0,0,0,0,0,0,0,0,Sunday
2021-07-18,Man Kam To,0,0,0,0,0,0,0,0,Sunday
2021-07-18,Sha Tau Kok,0,0,0,0,0,0,0,0,Sunday
2021-07-18,Shenzhen Bay,1395,180,3,1578,1790,210,5,2005,Sunday
2021-07-18,China Ferry Terminal,0,0,0,0,0,0,0,0,Sunday
2021-07-18,Harbour Control,0,0,0,0,0,0,0,0,Sunday
2021-07-18,Kai Tak Cruise Terminal,0,0,0,0,0,0,0,0,Sunday
2021-07-18,Macau Ferry Terminal,0,0,0,0,0,0,0,0,Sunday
2021-07-18,Tuen Mun Ferry Terminal,0,0,0,0,0,0,0,0,Sunday
2021-07-18,Total,2821,218,33,3072,4178,274,34,4486,Sunday
2021-07-19,Airport,381,10,11,402,1294,11,24,1329,Monday
2021-07-19,Express Rail Link West Kowloon,0,0,0,0,0,0,0,0,Monday
2021-07-19,Hung Hom,0,0,0,0,0,0,0,0,Monday
2021-07-19,Lo Wu,0,0,0,0,0,0,0,0,Monday
2021-07-19,Lok Ma Chau Spur Line,0,0,0,0,0,0,0,0,Monday
2021-07-19,Heung Yuen Wai,0,0,0,0,0,0,0,0,Monday
2021-07-19,Hong Kong-Zhuhai-Macao Bridge,146,2,3,151,253,23,1,277,Monday
2021-07-19,Lok Ma Chau,0,0,0,0,0,0,0,0,Monday
2021-07-19,Man Kam To,0,0,0,0,0,0,0,0,Monday
2021-07-19,Sha Tau Kok,0,0,0,0,0,0,0,0,Monday
2021-07-19,Shenzhen Bay,952,129,4,1085,1700,241,3,1944,Monday
2021-07-19,China Ferry Terminal,0,0,0,0,0,0,0,0,Monday
2021-07-19,Harbour Control,0,0,0,0,0,0,0,0,Monday
2021-07-19,Kai Tak Cruise Terminal,0,0,0,0,0,0,0,0,Monday
2021-07-19,Macau Ferry Terminal,0,0,0,0,0,0,0,0,Monday
2021-07-19,Tuen Mun Ferry Terminal,0,0,0,0,0,0,0,0,Monday
2021-07-19,Total,1479,141,18,1638,3247,275,28,3550,Monday
2021-07-20,Airport,788,7,15,810,1357,3,25,1385,Tuesday
2021-07-20,Express Rail Link West Kowloon,0,0,0,0,0,0,0,0,Tuesday
2021-07-20,Hung Hom,0,0,0,0,0,0,0,0,Tuesday
2021-07-20,Lo Wu,0,0,0,0,0,0,0,0,Tuesday
2021-07-20,Lok Ma Chau Spur Line,0,0,0,0,0,0,0,0,Tuesday
2021-07-20,Heung Yuen Wai,0,0,0,0,0,0,0,0,Tuesday
2021-07-20,Hong Kong-Zhuhai-Macao Bridge,155,12,3,170,261,20,2,283,Tuesday
2021-07-20,Lok Ma Chau,0,0,0,0,0,0,0,0,Tuesday
2021-07-20,Man Kam To,0,0,0,0,0,0,0,0,Tuesday
2021-07-20,Sha Tau Kok,0,0,0,0,0,0,0,0,Tuesday
2021-07-20,Shenzhen Bay,1191,104,3,1298,1755,250,1,2006,Tuesday
2021-07-20,China Ferry Terminal,0,0,0,0,0,0,0,0,Tuesday
2021-07-20,Harbour Control,0,0,0,0,0,0,0,0,Tuesday
2021-07-20,Kai Tak Cruise Terminal,0,0,0,0,0,0,0,0,Tuesday
2021-07-20,Macau Ferry Terminal,0,0,0,0,0,0,0,0,Tuesday
2021-07-20,Tuen Mun Ferry Terminal,0,0,0,0,0,0,0,0,Tuesday
2021-07-20,Total,2134,123,21,2278,3373,273,28,3674,Tuesday
2021-07-21,Airport,665,14,21,700,1276,28,12,1316,Wednesday
2021-07-21,Express Rail Link West Kowloon,0,0,0,0,0,0,0,0,Wednesday
2021-07-21,Hung Hom,0,0,0,0,0,0,0,0,Wednesday
2021-07-21,Lo Wu,0,0,0,0,0,0,0,0,Wednesday
2021-07-21,Lok Ma Chau Spur Line,0,0,0,0,0,0,0,0,Wednesday
2021-07-21,Heung Yuen Wai,0,0,0,0,0,0,0,0,Wednesday
2021-07-21,Hong Kong-Zhuhai-Macao Bridge,120,9,5,134,342,19,0,361,Wednesday
2021-07-21,Lok Ma Chau,0,0,0,0,0,0,0,0,Wednesday
2021-07-21,Man Kam To,0,0,0,0,0,0,0,0,Wednesday
2021-07-21,Sha Tau Kok,0,0,0,0,0,0,0,0,Wednesday
2021-07-21,Shenzhen Bay,1072,111,2,1185,1643,268,4,1915,Wednesday
2021-07-21,China Ferry Terminal,0,0,0,0,0,0,0,0,Wednesday
2021-07-21,Harbour Control,0,0,0,0,0,0,0,0,Wednesday
2021-07-21,Kai Tak Cruise Terminal,0,0,0,0,0,0,0,0,Wednesday
2021-07-21,Macau Ferry Terminal,0,0,0,0,0,0,0,0,Wednesday
2021-07-21,Tuen Mun Ferry Terminal,0,0,0,0,0,0,0,0,Wednesday
2021-07-21,Total,1857,134,28,2019,3261,315,16,3592,Wednesday
2021-07-22,Airport,449,20,11,480,1574,26,27,1627,Thursday
2021-07-22,Express Rail Link West Kowloon,0,0,0,0,0,0,0,0,Thursday
2021-07-22,Hung Hom,0,0,0,0,0,0,0,0,Thursday
2021-07-22,Lo Wu,0,0,0,0,0,0,0,0,Thursday
2021-07-22,Lok Ma Chau Spur Line,0,0,0,0,0,0,0,0,Thursday
2021-07-22,Heung Yuen Wai,0,0,0,0,0,0,0,0,Thursday
2021-07-22,Hong Kong-Zhuhai-Macao Bridge,148,8,6,162,314,18,3,335,Thursday
2021-07-22,Lok Ma Chau,0,0,0,0,0,0,0,0,Thursday
2021-07-22,Man Kam To,0,0,0,0,0,0,0,0,Thursday
2021-07-22,Sha Tau Kok,0,0,0,0,0,0,0,0,Thursday
2021-07-22,Shenzhen Bay,954,125,3,1082,1649,210,2,1861,Thursday
2021-07-22,China Ferry Terminal,0,0,0,0,0,0,0,0,Thursday
2021-07-22,Harbour Control,0,0,0,0,0,0,0,0,Thursday
2021-07-22,Kai Tak Cruise Terminal,0,0,0,0,0,0,0,0,Thursday
2021-07-22,Macau Ferry Terminal,0,0,0,0,0,0,0,0,Thursday
2021-07-22,Tuen Mun Ferry Terminal,0,0,0,0,0,0,0,0,Thursday
2021-07-22,Total,1551,153,20,1724,3537,254,32,3823,Thursday
2021-07-23,Airport,831,18,21,870,1831,18,30,1879,Friday
2021-07-28,Sha Tau Kok,0,0,0,0,0,0,0,0,Wednesday
2021-07-23,Express Rail Link West Kowloon,0,0,0,0,0,0,0,0,Friday
2021-07-23,Hung Hom,0,0,0,0,0,0,0,0,Friday
2021-07-23,Lo Wu,0,0,0,0,0,0,0,0,Friday
2021-07-23,Lok Ma Chau Spur Line,0,0,0,0,0,0,0,0,Friday
2021-07-23,Heung Yuen Wai,0,0,0,0,0,0,0,0,Friday
2021-07-23,Hong Kong-Zhuhai-Macao Bridge,175,9,5,189,292,22,0,314,Friday
2021-07-23,Lok Ma Chau,0,0,0,0,0,0,0,0,Friday
2021-07-23,Man Kam To,0,0,0,0,0,0,0,0,Friday
2021-07-23,Sha Tau Kok,0,0,0,0,0,0,0,0,Friday
2021-07-23,Shenzhen Bay,1174,142,6,1322,1375,166,2,1543,Friday
2021-07-23,China Ferry Terminal,0,0,0,0,0,0,0,0,Friday
2021-07-23,Harbour Control,0,0,0,0,0,0,0,0,Friday
2021-07-23,Kai Tak Cruise Terminal,0,0,0,0,0,0,0,0,Friday
2021-07-23,Macau Ferry Terminal,0,0,0,0,0,0,0,0,Friday
2021-07-23,Tuen Mun Ferry Terminal,0,0,0,0,0,0,0,0,Friday
2021-07-23,Total,2180,169,32,2381,3498,206,32,3736,Friday
2021-07-24,Airport,587,9,13,609,1515,30,18,1563,Saturday
2021-07-24,Express Rail Link West Kowloon,0,0,0,0,0,0,0,0,Saturday
2021-07-24,Hung Hom,0,0,0,0,0,0,0,0,Saturday
2021-07-24,Lo Wu,0,0,0,0,0,0,0,0,Saturday
2021-07-24,Lok Ma Chau Spur Line,0,0,0,0,0,0,0,0,Saturday
2021-07-24,Heung Yuen Wai,0,0,0,0,0,0,0,0,Saturday
2021-07-24,Hong Kong-Zhuhai-Macao Bridge,148,15,9,172,281,12,8,301,Saturday
2021-07-24,Lok Ma Chau,0,0,0,0,0,0,0,0,Saturday
2021-07-24,Man Kam To,0,0,0,0,0,0,0,0,Saturday
2021-07-24,Sha Tau Kok,0,0,0,0,0,0,0,0,Saturday
2021-07-24,Shenzhen Bay,1008,123,3,1134,1062,131,3,1196,Saturday
2021-07-24,China Ferry Terminal,0,0,0,0,0,0,0,0,Saturday
2021-07-24,Harbour Control,0,0,0,0,0,0,0,0,Saturday
2021-07-24,Kai Tak Cruise Terminal,0,0,0,0,0,0,0,0,Saturday
2021-07-24,Macau Ferry Terminal,0,0,0,0,0,0,0,0,Saturday
2021-07-24,Tuen Mun Ferry Terminal,0,0,0,0,0,0,0,0,Saturday
2021-07-24,Total,1743,147,25,1915,2858,173,29,3060,Saturday
2021-07-25,Airport,1263,18,16,1297,1922,17,26,1965,Sunday
2021-07-25,Express Rail Link West Kowloon,0,0,0,0,0,0,0,0,Sunday
2021-07-25,Hung Hom,0,0,0,0,0,0,0,0,Sunday
2021-07-25,Lo Wu,0,0,0,0,0,0,0,0,Sunday
2021-07-25,Lok Ma Chau Spur Line,0,0,0,0,0,0,0,0,Sunday
2021-07-25,Heung Yuen Wai,0,0,0,0,0,0,0,0,Sunday
2021-07-25,Hong Kong-Zhuhai-Macao Bridge,136,10,1,147,226,13,3,242,Sunday
2021-07-25,Lok Ma Chau,0,0,0,0,0,0,0,0,Sunday
2021-07-25,Man Kam To,0,0,0,0,0,0,0,0,Sunday
2021-07-25,Sha Tau Kok,0,0,0,0,0,0,0,0,Sunday
2021-07-25,Shenzhen Bay,1330,149,8,1487,871,131,0,1002,Sunday
2021-07-25,China Ferry Terminal,0,0,0,0,0,0,0,0,Sunday
2021-07-25,Harbour Control,0,0,0,0,0,0,0,0,Sunday
2021-07-25,Kai Tak Cruise Terminal,0,0,0,0,0,0,0,0,Sunday
2021-07-25,Macau Ferry Terminal,0,0,0,0,0,0,0,0,Sunday
2021-07-25,Tuen Mun Ferry Terminal,0,0,0,0,0,0,0,0,Sunday
2021-07-25,Total,2729,177,25,2931,3019,161,29,3209,Sunday
2021-07-26,Airport,210,1,8,219,1186,7,8,1201,Monday
2021-07-26,Express Rail Link West Kowloon,0,0,0,0,0,0,0,0,Monday
2021-07-26,Hung Hom,0,0,0,0,0,0,0,0,Monday
2021-07-26,Lo Wu,0,0,0,0,0,0,0,0,Monday
2021-07-26,Lok Ma Chau Spur Line,0,0,0,0,0,0,0,0,Monday
2021-07-26,Heung Yuen Wai,0,0,0,0,0,0,0,0,Monday
2021-07-26,Hong Kong-Zhuhai-Macao Bridge,126,14,3,143,295,16,4,315,Monday
2021-07-26,Lok Ma Chau,0,0,0,0,0,0,0,0,Monday
2021-07-26,Man Kam To,0,0,0,0,0,0,0,0,Monday
2021-07-26,Sha Tau Kok,0,0,0,0,0,0,0,0,Monday
2021-07-26,Shenzhen Bay,1000,95,3,1098,946,129,0,1075,Monday
2021-07-26,China Ferry Terminal,0,0,0,0,0,0,0,0,Monday
2021-07-26,Harbour Control,0,0,0,0,0,0,0,0,Monday
2021-07-26,Kai Tak Cruise Terminal,0,0,0,0,0,0,0,0,Monday
2021-07-26,Macau Ferry Terminal,0,0,0,0,0,0,0,0,Monday
2021-07-26,Tuen Mun Ferry Terminal,0,0,0,0,0,0,0,0,Monday
2021-07-26,Total,1336,110,14,1460,2427,152,12,2591,Monday
2021-07-27,Airport,1075,8,16,1099,1585,18,14,1617,Tuesday
2021-07-27,Express Rail Link West Kowloon,0,0,0,0,0,0,0,0,Tuesday
2021-07-27,Hung Hom,0,0,0,0,0,0,0,0,Tuesday
2021-07-27,Lo Wu,0,0,0,0,0,0,0,0,Tuesday
2021-07-27,Lok Ma Chau Spur Line,0,0,0,0,0,0,0,0,Tuesday
2021-07-27,Heung Yuen Wai,0,0,0,0,0,0,0,0,Tuesday
2021-07-27,Hong Kong-Zhuhai-Macao Bridge,157,11,3,171,282,14,2,298,Tuesday
2021-07-27,Lok Ma Chau,0,0,0,0,0,0,0,0,Tuesday
2021-07-27,Man Kam To,0,0,0,0,0,0,0,0,Tuesday
2021-07-27,Sha Tau Kok,0,0,0,0,0,0,0,0,Tuesday
2021-07-27,Shenzhen Bay,1097,111,3,1211,936,123,2,1061,Tuesday
2021-07-27,China Ferry Terminal,0,0,0,0,0,0,0,0,Tuesday
2021-07-27,Harbour Control,0,0,0,0,0,0,0,0,Tuesday
2021-07-27,Kai Tak Cruise Terminal,0,0,0,0,0,0,0,0,Tuesday
2021-07-27,Macau Ferry Terminal,0,0,0,0,0,0,0,0,Tuesday
2021-07-27,Tuen Mun Ferry Terminal,0,0,0,0,0,0,0,0,Tuesday
2021-07-27,Total,2329,130,22,2481,2803,155,18,2976,Tuesday
2021-07-28,Airport,636,17,12,665,1317,10,23,1350,Wednesday
2021-07-28,Express Rail Link West Kowloon,0,0,0,0,0,0,0,0,Wednesday
2021-07-28,Hung Hom,0,0,0,0,0,0,0,0,Wednesday
2021-07-28,Lo Wu,0,0,0,0,0,0,0,0,Wednesday
2021-07-28,Lok Ma Chau Spur Line,0,0,0,0,0,0,0,0,Wednesday
2021-07-28,Heung Yuen Wai,0,0,0,0,0,0,0,0,Wednesday
2021-07-28,Hong Kong-Zhuhai-Macao Bridge,149,7,2,158,324,15,1,340,Wednesday
2021-07-28,Lok Ma Chau,0,0,0,0,0,0,0,0,Wednesday
2021-07-28,Man Kam To,0,0,0,0,0,0,0,0,Wednesday
2021-08-13,Total,4320,204,37,4561,4203,114,35,4352,Friday
2021-07-28,Shenzhen Bay,1149,98,5,1252,933,125,1,1059,Wednesday
2021-07-28,China Ferry Terminal,0,0,0,0,0,0,0,0,Wednesday
2021-07-28,Harbour Control,0,0,0,0,0,0,0,0,Wednesday
2021-07-28,Kai Tak Cruise Terminal,0,0,0,0,0,0,0,0,Wednesday
2021-07-28,Macau Ferry Terminal,0,0,0,0,0,0,0,0,Wednesday
2021-07-28,Tuen Mun Ferry Terminal,0,0,0,0,0,0,0,0,Wednesday
2021-07-28,Total,1934,122,19,2075,2574,150,25,2749,Wednesday
2021-07-29,Airport,777,23,21,821,1994,27,16,2037,Thursday
2021-07-29,Express Rail Link West Kowloon,0,0,0,0,0,0,0,0,Thursday
2021-07-29,Hung Hom,0,0,0,0,0,0,0,0,Thursday
2021-07-29,Lo Wu,0,0,0,0,0,0,0,0,Thursday
2021-07-29,Lok Ma Chau Spur Line,0,0,0,0,0,0,0,0,Thursday
2021-07-29,Heung Yuen Wai,0,0,0,0,0,0,0,0,Thursday
2021-07-29,Hong Kong-Zhuhai-Macao Bridge,144,1,12,157,241,19,2,262,Thursday
2021-07-29,Lok Ma Chau,0,0,0,0,0,0,0,0,Thursday
2021-07-29,Man Kam To,0,0,0,0,0,0,0,0,Thursday
2021-07-29,Sha Tau Kok,0,0,0,0,0,0,0,0,Thursday
2021-07-29,Shenzhen Bay,1105,165,3,1273,868,180,4,1052,Thursday
2021-07-29,China Ferry Terminal,0,0,0,0,0,0,0,0,Thursday
2021-07-29,Harbour Control,0,0,0,0,0,0,0,0,Thursday
2021-07-29,Kai Tak Cruise Terminal,0,0,0,0,0,0,0,0,Thursday
2021-07-29,Macau Ferry Terminal,0,0,0,0,0,0,0,0,Thursday
2021-07-29,Tuen Mun Ferry Terminal,0,0,0,0,0,0,0,0,Thursday
2021-07-29,Total,2026,189,36,2251,3103,226,22,3351,Thursday
2021-07-31,Airport,732,22,9,763,2013,23,30,2066,Saturday
2021-07-31,Express Rail Link West Kowloon,0,0,0,0,0,0,0,0,Saturday
2021-07-31,Hung Hom,0,0,0,0,0,0,0,0,Saturday
2021-07-31,Lo Wu,0,0,0,0,0,0,0,0,Saturday
2021-07-31,Lok Ma Chau Spur Line,0,0,0,0,0,0,0,0,Saturday
2021-07-31,Heung Yuen Wai,0,0,0,0,0,0,0,0,Saturday
2021-07-31,Hong Kong-Zhuhai-Macao Bridge,158,9,7,174,257,14,3,274,Saturday
2021-07-31,Lok Ma Chau,0,0,0,0,0,0,0,0,Saturday
2021-07-31,Man Kam To,0,0,0,0,0,0,0,0,Saturday
2021-07-31,Sha Tau Kok,0,0,0,0,0,0,0,0,Saturday
2021-07-31,Shenzhen Bay,1306,140,3,1449,950,128,1,1079,Saturday
2021-07-31,China Ferry Terminal,0,0,0,0,0,0,0,0,Saturday
2021-07-31,Harbour Control,0,0,0,0,0,0,0,0,Saturday
2021-07-31,Kai Tak Cruise Terminal,0,0,0,0,0,0,0,0,Saturday
2021-07-31,Macau Ferry Terminal,0,0,0,0,0,0,0,0,Saturday
2021-07-31,Tuen Mun Ferry Terminal,0,0,0,0,0,0,0,0,Saturday
2021-07-31,Total,2196,171,19,2386,3220,165,34,3419,Saturday
2021-07-30,Airport,732,17,23,772,2339,17,36,2392,Friday
2021-07-30,Express Rail Link West Kowloon,0,0,0,0,0,0,0,0,Friday
2021-07-30,Hung Hom,0,0,0,0,0,0,0,0,Friday
2021-07-30,Lo Wu,0,0,0,0,0,0,0,0,Friday
2021-07-30,Lok Ma Chau Spur Line,0,0,0,0,0,0,0,0,Friday
2021-07-30,Heung Yuen Wai,0,0,0,0,0,0,0,0,Friday
2021-07-30,Hong Kong-Zhuhai-Macao Bridge,157,7,3,167,269,16,2,287,Friday
2021-07-30,Lok Ma Chau,0,0,0,0,0,0,0,0,Friday
2021-07-30,Man Kam To,0,0,0,0,0,0,0,0,Friday
2021-07-30,Sha Tau Kok,0,0,0,0,0,0,0,0,Friday
2021-07-30,Shenzhen Bay,1415,122,7,1544,877,120,1,998,Friday
2021-07-30,China Ferry Terminal,0,0,0,0,0,0,0,0,Friday
2021-07-30,Harbour Control,0,0,0,0,0,0,0,0,Friday
2021-07-30,Kai Tak Cruise Terminal,0,0,0,0,1014,0,0,1014,Friday
2021-07-30,Macau Ferry Terminal,0,0,0,0,0,0,0,0,Friday
2021-07-30,Tuen Mun Ferry Terminal,0,0,0,0,0,0,0,0,Friday
2021-07-30,Total,2304,146,33,2483,4499,153,39,4691,Friday
2021-08-01,Airport,1317,22,20,1359,1630,25,29,1684,Sunday
2021-08-01,Express Rail Link West Kowloon,0,0,0,0,0,0,0,0,Sunday
2021-08-01,Hung Hom,0,0,0,0,0,0,0,0,Sunday
2021-08-01,Lo Wu,0,0,0,0,0,0,0,0,Sunday
2021-08-01,Lok Ma Chau Spur Line,0,0,0,0,0,0,0,0,Sunday
2021-08-01,Heung Yuen Wai,0,0,0,0,0,0,0,0,Sunday
2021-08-01,Hong Kong-Zhuhai-Macao Bridge,158,8,8,174,255,20,2,277,Sunday
2021-08-01,Lok Ma Chau,0,0,0,0,0,0,0,0,Sunday
2021-08-01,Man Kam To,0,0,0,0,0,0,0,0,Sunday
2021-08-01,Sha Tau Kok,0,0,0,0,0,0,0,0,Sunday
2021-08-01,Shenzhen Bay,1604,183,8,1795,1147,150,3,1300,Sunday
2021-08-01,China Ferry Terminal,0,0,0,0,0,0,0,0,Sunday
2021-08-01,Harbour Control,0,0,0,0,0,0,0,0,Sunday
2021-08-01,Kai Tak Cruise Terminal,1014,0,0,1014,1010,0,0,1010,Sunday
2021-08-01,Macau Ferry Terminal,0,0,0,0,0,0,0,0,Sunday
2021-08-01,Tuen Mun Ferry Terminal,0,0,0,0,0,0,0,0,Sunday
2021-08-01,Total,4093,213,36,4342,4042,195,34,4271,Sunday
2021-08-02,Airport,638,14,15,667,1158,11,22,1191,Monday
2021-08-02,Express Rail Link West Kowloon,0,0,0,0,0,0,0,0,Monday
2021-08-02,Hung Hom,0,0,0,0,0,0,0,0,Monday
2021-08-02,Lo Wu,0,0,0,0,0,0,0,0,Monday
2021-08-02,Lok Ma Chau Spur Line,0,0,0,0,0,0,0,0,Monday
2021-08-02,Heung Yuen Wai,0,0,0,0,0,0,0,0,Monday
2021-08-02,Hong Kong-Zhuhai-Macao Bridge,122,6,6,134,307,15,1,323,Monday
2021-08-02,Lok Ma Chau,0,0,0,0,0,0,0,0,Monday
2021-08-02,Man Kam To,0,0,0,0,0,0,0,0,Monday
2021-08-02,Sha Tau Kok,0,0,0,0,0,0,0,0,Monday
2021-08-02,Shenzhen Bay,1177,149,5,1331,1241,135,1,1377,Monday
2021-08-02,China Ferry Terminal,0,0,0,0,0,0,0,0,Monday
2021-08-02,Harbour Control,0,0,0,0,0,0,0,0,Monday
2021-08-02,Kai Tak Cruise Terminal,0,0,0,0,0,0,0,0,Monday
2021-08-02,Macau Ferry Terminal,0,0,0,0,0,0,0,0,Monday
2021-08-02,Tuen Mun Ferry Terminal,0,0,0,0,0,0,0,0,Monday
2021-08-02,Total,1937,169,26,2132,2706,161,24,2891,Monday
2021-08-03,Airport,1187,5,20,1212,1295,8,24,1327,Tuesday
2021-08-14,Airport,867,5,30,902,1672,36,18,1726,Saturday
2021-08-03,Express Rail Link West Kowloon,0,0,0,0,0,0,0,0,Tuesday
2021-08-03,Hung Hom,0,0,0,0,0,0,0,0,Tuesday
2021-08-03,Lo Wu,0,0,0,0,0,0,0,0,Tuesday
2021-08-03,Lok Ma Chau Spur Line,0,0,0,0,0,0,0,0,Tuesday
2021-08-03,Heung Yuen Wai,0,0,0,0,0,0,0,0,Tuesday
2021-08-03,Hong Kong-Zhuhai-Macao Bridge,151,10,12,173,294,12,6,312,Tuesday
2021-08-03,Lok Ma Chau,0,0,0,0,0,0,0,0,Tuesday
2021-08-03,Man Kam To,0,0,0,0,0,0,0,0,Tuesday
2021-08-03,Sha Tau Kok,0,0,0,0,0,0,0,0,Tuesday
2021-08-03,Shenzhen Bay,1244,168,1,1413,1393,147,5,1545,Tuesday
2021-08-03,China Ferry Terminal,0,0,0,0,0,0,0,0,Tuesday
2021-08-03,Harbour Control,0,0,0,0,0,0,0,0,Tuesday
2021-08-03,Kai Tak Cruise Terminal,0,0,0,0,0,0,0,0,Tuesday
2021-08-03,Macau Ferry Terminal,0,0,0,0,0,0,0,0,Tuesday
2021-08-03,Tuen Mun Ferry Terminal,0,0,0,0,0,0,0,0,Tuesday
2021-08-03,Total,2582,183,33,2798,2982,167,35,3184,Tuesday
2021-08-04,Airport,888,12,7,907,1158,10,15,1183,Wednesday
2021-08-04,Express Rail Link West Kowloon,0,0,0,0,0,0,0,0,Wednesday
2021-08-04,Hung Hom,0,0,0,0,0,0,0,0,Wednesday
2021-08-04,Lo Wu,0,0,0,0,0,0,0,0,Wednesday
2021-08-04,Lok Ma Chau Spur Line,0,0,0,0,0,0,0,0,Wednesday
2021-08-04,Heung Yuen Wai,0,0,0,0,0,0,0,0,Wednesday
2021-08-04,Hong Kong-Zhuhai-Macao Bridge,162,4,7,173,240,15,0,255,Wednesday
2021-08-04,Lok Ma Chau,0,0,0,0,0,0,0,0,Wednesday
2021-08-04,Man Kam To,0,0,0,0,0,0,0,0,Wednesday
2021-08-04,Sha Tau Kok,0,0,0,0,0,0,0,0,Wednesday
2021-08-04,Shenzhen Bay,1352,160,3,1515,1235,154,2,1391,Wednesday
2021-08-04,China Ferry Terminal,0,0,0,0,0,0,0,0,Wednesday
2021-08-04,Harbour Control,0,0,0,0,0,0,0,0,Wednesday
2021-08-04,Kai Tak Cruise Terminal,1010,0,0,1010,1051,0,0,1051,Wednesday
2021-08-04,Macau Ferry Terminal,0,0,0,0,0,0,0,0,Wednesday
2021-08-04,Tuen Mun Ferry Terminal,0,0,0,0,0,0,0,0,Wednesday
2021-08-04,Total,3412,176,17,3605,3684,179,17,3880,Wednesday
2021-08-05,Airport,708,9,17,734,1282,22,22,1326,Thursday
2021-08-05,Express Rail Link West Kowloon,0,0,0,0,0,0,0,0,Thursday
2021-08-05,Hung Hom,0,0,0,0,0,0,0,0,Thursday
2021-08-05,Lo Wu,0,0,0,0,0,0,0,0,Thursday
2021-08-05,Lok Ma Chau Spur Line,0,0,0,0,0,0,0,0,Thursday
2021-08-05,Heung Yuen Wai,0,0,0,0,0,0,0,0,Thursday
2021-08-05,Hong Kong-Zhuhai-Macao Bridge,136,7,2,145,213,17,5,235,Thursday
2021-08-05,Lok Ma Chau,0,0,0,0,0,0,0,0,Thursday
2021-08-05,Man Kam To,0,0,0,0,0,0,0,0,Thursday
2021-08-05,Sha Tau Kok,0,0,0,0,0,0,0,0,Thursday
2021-08-05,Shenzhen Bay,1538,136,4,1678,1227,140,2,1369,Thursday
2021-08-05,China Ferry Terminal,0,0,0,0,0,0,0,0,Thursday
2021-08-05,Harbour Control,0,0,0,0,0,0,0,0,Thursday
2021-08-05,Kai Tak Cruise Terminal,0,0,0,0,0,0,0,0,Thursday
2021-08-05,Macau Ferry Terminal,0,0,0,0,0,0,0,0,Thursday
2021-08-05,Tuen Mun Ferry Terminal,0,0,0,0,0,0,0,0,Thursday
2021-08-05,Total,2382,152,23,2557,2722,179,29,2930,Thursday
2021-08-06,Airport,1128,17,21,1166,1592,30,24,1646,Friday
2021-08-06,Express Rail Link West Kowloon,0,0,0,0,0,0,0,0,Friday
2021-08-06,Hung Hom,0,0,0,0,0,0,0,0,Friday
2021-08-06,Lo Wu,0,0,0,0,0,0,0,0,Friday
2021-08-06,Lok Ma Chau Spur Line,0,0,0,0,0,0,0,0,Friday
2021-08-06,Heung Yuen Wai,0,0,0,0,0,0,0,0,Friday
2021-08-06,Hong Kong-Zhuhai-Macao Bridge,102,8,4,114,132,3,6,141,Friday
2021-08-06,Lok Ma Chau,0,0,0,0,0,0,0,0,Friday
2021-08-06,Man Kam To,0,0,0,0,0,0,0,0,Friday
2021-08-06,Sha Tau Kok,0,0,0,0,0,0,0,0,Friday
2021-08-06,Shenzhen Bay,1632,151,4,1787,1159,133,5,1297,Friday
2021-08-06,China Ferry Terminal,0,0,0,0,0,0,0,0,Friday
2021-08-06,Harbour Control,0,0,0,0,0,0,0,0,Friday
2021-08-06,Kai Tak Cruise Terminal,1051,0,0,1051,1374,0,0,1374,Friday
2021-08-06,Macau Ferry Terminal,0,0,0,0,0,0,0,0,Friday
2021-08-06,Tuen Mun Ferry Terminal,0,0,0,0,0,0,0,0,Friday
2021-08-06,Total,3913,176,29,4118,4257,166,35,4458,Friday
2021-08-07,Airport,933,14,18,965,1641,22,19,1682,Saturday
2021-08-07,Express Rail Link West Kowloon,0,0,0,0,0,0,0,0,Saturday
2021-08-07,Hung Hom,0,0,0,0,0,0,0,0,Saturday
2021-08-07,Lo Wu,0,0,0,0,0,0,0,0,Saturday
2021-08-07,Lok Ma Chau Spur Line,0,0,0,0,0,0,0,0,Saturday
2021-08-07,Heung Yuen Wai,0,0,0,0,0,0,0,0,Saturday
2021-08-07,Hong Kong-Zhuhai-Macao Bridge,113,10,4,127,131,10,6,147,Saturday
2021-08-07,Lok Ma Chau,0,0,0,0,0,0,0,0,Saturday
2021-08-07,Man Kam To,0,0,0,0,0,0,0,0,Saturday
2021-08-07,Sha Tau Kok,0,0,0,0,0,0,0,0,Saturday
2021-08-07,Shenzhen Bay,1725,200,5,1930,1174,138,4,1316,Saturday
2021-08-07,China Ferry Terminal,0,0,0,0,0,0,0,0,Saturday
2021-08-07,Harbour Control,0,0,0,0,0,0,0,0,Saturday
2021-08-07,Kai Tak Cruise Terminal,0,0,0,0,0,0,0,0,Saturday
2021-08-07,Macau Ferry Terminal,0,0,0,0,0,0,0,0,Saturday
2021-08-07,Tuen Mun Ferry Terminal,0,0,0,0,0,0,0,0,Saturday
2021-08-07,Total,2771,224,27,3022,2946,170,29,3145,Saturday
2021-08-10,Airport,1398,16,44,1458,1294,13,41,1348,Tuesday
2021-08-10,Express Rail Link West Kowloon,0,0,0,0,0,0,0,0,Tuesday
2021-08-10,Hung Hom,0,0,0,0,0,0,0,0,Tuesday
2021-08-10,Lo Wu,0,0,0,0,0,0,0,0,Tuesday
2021-08-10,Lok Ma Chau Spur Line,0,0,0,0,0,0,0,0,Tuesday
2021-08-10,Heung Yuen Wai,0,0,0,0,0,0,0,0,Tuesday
2021-08-10,Hong Kong-Zhuhai-Macao Bridge,106,4,9,119,177,11,5,193,Tuesday
2021-08-10,Lok Ma Chau,0,0,0,0,0,0,0,0,Tuesday
2021-08-10,Man Kam To,0,0,0,0,0,0,0,0,Tuesday
2021-08-10,Sha Tau Kok,0,0,0,0,0,0,0,0,Tuesday
2021-08-10,Shenzhen Bay,2169,187,3,2359,1241,144,3,1388,Tuesday
2021-08-10,China Ferry Terminal,0,0,0,0,0,0,0,0,Tuesday
2021-08-10,Harbour Control,0,0,0,0,0,0,0,0,Tuesday
2021-08-10,Kai Tak Cruise Terminal,0,0,0,0,0,0,0,0,Tuesday
2021-08-10,Macau Ferry Terminal,0,0,0,0,0,0,0,0,Tuesday
2021-08-10,Tuen Mun Ferry Terminal,0,0,0,0,0,0,0,0,Tuesday
2021-08-10,Total,3673,207,56,3936,2712,168,49,2929,Tuesday
2021-08-09,Airport,838,13,29,880,1099,7,17,1123,Monday
2021-08-09,Express Rail Link West Kowloon,0,0,0,0,0,0,0,0,Monday
2021-08-09,Hung Hom,0,0,0,0,0,0,0,0,Monday
2021-08-09,Lo Wu,0,0,0,0,0,0,0,0,Monday
2021-08-09,Lok Ma Chau Spur Line,0,0,0,0,0,0,0,0,Monday
2021-08-09,Heung Yuen Wai,0,0,0,0,0,0,0,0,Monday
2021-08-09,Hong Kong-Zhuhai-Macao Bridge,105,6,1,112,158,12,3,173,Monday
2021-08-09,Lok Ma Chau,0,0,0,0,0,0,0,0,Monday
2021-08-09,Man Kam To,0,0,0,0,0,0,0,0,Monday
2021-08-09,Sha Tau Kok,0,0,0,0,0,0,0,0,Monday
2021-08-09,Shenzhen Bay,1366,155,4,1525,1292,165,0,1457,Monday
2021-08-09,China Ferry Terminal,0,0,0,0,0,0,0,0,Monday
2021-08-09,Harbour Control,0,0,0,0,0,0,0,0,Monday
2021-08-09,Kai Tak Cruise Terminal,0,0,0,0,0,0,0,0,Monday
2021-08-09,Macau Ferry Terminal,0,0,0,0,0,0,0,0,Monday
2021-08-09,Tuen Mun Ferry Terminal,0,0,0,0,0,0,0,0,Monday
2021-08-09,Total,2309,174,34,2517,2549,184,20,2753,Monday
2021-08-08,Airport,1404,18,19,1441,1559,18,29,1606,Sunday
2021-08-08,Express Rail Link West Kowloon,0,0,0,0,0,0,0,0,Sunday
2021-08-08,Hung Hom,0,0,0,0,0,0,0,0,Sunday
2021-08-08,Lo Wu,0,0,0,0,0,0,0,0,Sunday
2021-08-08,Lok Ma Chau Spur Line,0,0,0,0,0,0,0,0,Sunday
2021-08-08,Heung Yuen Wai,0,0,0,0,0,0,0,0,Sunday
2021-08-08,Hong Kong-Zhuhai-Macao Bridge,126,5,5,136,162,6,3,171,Sunday
2021-08-08,Lok Ma Chau,0,0,0,0,0,0,0,0,Sunday
2021-08-08,Man Kam To,0,0,0,0,0,0,0,0,Sunday
2021-08-08,Sha Tau Kok,0,0,0,0,0,0,0,0,Sunday
2021-08-08,Shenzhen Bay,1902,200,4,2106,913,164,7,1084,Sunday
2021-08-08,China Ferry Terminal,0,0,0,0,0,0,0,0,Sunday
2021-08-08,Harbour Control,0,0,0,0,0,0,0,0,Sunday
2021-08-08,Kai Tak Cruise Terminal,1374,0,0,1374,1355,0,0,1355,Sunday
2021-08-08,Macau Ferry Terminal,0,0,0,0,0,0,0,0,Sunday
2021-08-08,Tuen Mun Ferry Terminal,0,0,0,0,0,0,0,0,Sunday
2021-08-08,Total,4806,223,28,5057,3989,188,39,4216,Sunday
2021-08-12,Airport,833,11,25,869,1263,18,24,1305,Thursday
2021-08-12,Express Rail Link West Kowloon,0,0,0,0,0,0,0,0,Thursday
2021-08-12,Hung Hom,0,0,0,0,0,0,0,0,Thursday
2021-08-12,Lo Wu,0,0,0,0,0,0,0,0,Thursday
2021-08-12,Lok Ma Chau Spur Line,0,0,0,0,0,0,0,0,Thursday
2021-08-12,Heung Yuen Wai,0,0,0,0,0,0,0,0,Thursday
2021-08-12,Hong Kong-Zhuhai-Macao Bridge,101,6,2,109,176,9,8,193,Thursday
2021-08-12,Lok Ma Chau,0,0,0,0,0,0,0,0,Thursday
2021-08-12,Man Kam To,0,0,0,0,0,0,0,0,Thursday
2021-08-12,Sha Tau Kok,0,0,0,0,0,0,0,0,Thursday
2021-08-12,Shenzhen Bay,1853,201,7,2061,1003,113,3,1119,Thursday
2021-08-12,China Ferry Terminal,0,0,0,0,0,0,0,0,Thursday
2021-08-12,Harbour Control,0,0,0,0,0,0,0,0,Thursday
2021-08-12,Kai Tak Cruise Terminal,0,0,0,0,0,0,0,0,Thursday
2021-08-12,Macau Ferry Terminal,0,0,0,0,0,0,0,0,Thursday
2021-08-12,Tuen Mun Ferry Terminal,0,0,0,0,0,0,0,0,Thursday
2021-08-12,Total,2787,218,34,3039,2442,140,35,2617,Thursday
2021-08-11,Airport,1000,12,22,1034,1108,12,20,1140,Wednesday
2021-08-11,Express Rail Link West Kowloon,0,0,0,0,0,0,0,0,Wednesday
2021-08-11,Hung Hom,0,0,0,0,0,0,0,0,Wednesday
2021-08-11,Lo Wu,0,0,0,0,0,0,0,0,Wednesday
2021-08-11,Lok Ma Chau Spur Line,0,0,0,0,0,0,0,0,Wednesday
2021-08-11,Heung Yuen Wai,0,0,0,0,0,0,0,0,Wednesday
2021-08-11,Hong Kong-Zhuhai-Macao Bridge,107,2,9,118,147,11,0,158,Wednesday
2021-08-11,Lok Ma Chau,0,0,0,0,0,0,0,0,Wednesday
2021-08-11,Man Kam To,0,0,0,0,0,0,0,0,Wednesday
2021-08-11,Sha Tau Kok,0,0,0,0,0,0,0,0,Wednesday
2021-08-11,Shenzhen Bay,1787,178,5,1970,1046,98,2,1146,Wednesday
2021-08-11,China Ferry Terminal,0,0,0,0,0,0,0,0,Wednesday
2021-08-11,Harbour Control,0,0,0,0,0,0,0,0,Wednesday
2021-08-11,Kai Tak Cruise Terminal,1356,0,0,1356,1178,0,0,1178,Wednesday
2021-08-11,Macau Ferry Terminal,0,0,0,0,0,0,0,0,Wednesday
2021-08-11,Tuen Mun Ferry Terminal,0,0,0,0,0,0,0,0,Wednesday
2021-08-11,Total,4250,192,36,4478,3479,121,22,3622,Wednesday
2021-08-13,Airport,953,6,28,987,1697,19,31,1747,Friday
2021-08-13,Express Rail Link West Kowloon,0,0,0,0,0,0,0,0,Friday
2021-08-13,Hung Hom,0,0,0,0,0,0,0,0,Friday
2021-08-13,Lo Wu,0,0,0,0,0,0,0,0,Friday
2021-08-13,Lok Ma Chau Spur Line,0,0,0,0,0,0,0,0,Friday
2021-08-13,Heung Yuen Wai,0,0,0,0,0,0,0,0,Friday
2021-08-13,Hong Kong-Zhuhai-Macao Bridge,148,4,9,161,171,6,1,178,Friday
2021-08-13,Lok Ma Chau,0,0,0,0,0,0,0,0,Friday
2021-08-13,Man Kam To,0,0,0,0,0,0,0,0,Friday
2021-08-13,Sha Tau Kok,0,0,0,0,0,0,0,0,Friday
2021-08-13,Shenzhen Bay,2041,194,0,2235,937,89,3,1029,Friday
2021-08-13,China Ferry Terminal,0,0,0,0,0,0,0,0,Friday
2021-08-13,Harbour Control,0,0,0,0,0,0,0,0,Friday
2021-08-13,Kai Tak Cruise Terminal,1178,0,0,1178,1398,0,0,1398,Friday
2021-08-13,Macau Ferry Terminal,0,0,0,0,0,0,0,0,Friday
2021-08-13,Tuen Mun Ferry Terminal,0,0,0,0,0,0,0,0,Friday
2021-08-14,Express Rail Link West Kowloon,0,0,0,0,0,0,0,0,Saturday
2021-08-14,Hung Hom,0,0,0,0,0,0,0,0,Saturday
2021-08-14,Lo Wu,0,0,0,0,0,0,0,0,Saturday
2021-08-14,Lok Ma Chau Spur Line,0,0,0,0,0,0,0,0,Saturday
2021-08-14,Heung Yuen Wai,0,0,0,0,0,0,0,0,Saturday
2021-08-14,Hong Kong-Zhuhai-Macao Bridge,147,2,3,152,171,2,6,179,Saturday
2021-08-14,Lok Ma Chau,0,0,0,0,0,0,0,0,Saturday
2021-08-14,Man Kam To,0,0,0,0,0,0,0,0,Saturday
2021-08-14,Sha Tau Kok,0,0,0,0,0,0,0,0,Saturday
2021-08-14,Shenzhen Bay,2098,204,5,2307,999,93,2,1094,Saturday
2021-08-14,China Ferry Terminal,0,0,0,0,0,0,0,0,Saturday
2021-08-14,Harbour Control,0,0,0,0,0,0,0,0,Saturday
2021-08-14,Kai Tak Cruise Terminal,0,0,0,0,0,0,0,0,Saturday
2021-08-14,Macau Ferry Terminal,0,0,0,0,0,0,0,0,Saturday
2021-08-14,Tuen Mun Ferry Terminal,0,0,0,0,0,0,0,0,Saturday
2021-08-14,Total,3112,211,38,3361,2842,131,26,2999,Saturday
2021-08-15,Airport,1311,21,25,1357,1871,19,25,1915,Sunday
2021-08-15,Express Rail Link West Kowloon,0,0,0,0,0,0,0,0,Sunday
2021-08-15,Hung Hom,0,0,0,0,0,0,0,0,Sunday
2021-08-15,Lo Wu,0,0,0,0,0,0,0,0,Sunday
2021-08-15,Lok Ma Chau Spur Line,0,0,0,0,0,0,0,0,Sunday
2021-08-15,Heung Yuen Wai,0,0,0,0,0,0,0,0,Sunday
2021-08-15,Hong Kong-Zhuhai-Macao Bridge,159,6,6,171,176,17,6,199,Sunday
2021-08-15,Lok Ma Chau,0,0,0,0,0,0,0,0,Sunday
2021-08-15,Man Kam To,0,0,0,0,0,0,0,0,Sunday
2021-08-15,Sha Tau Kok,0,0,0,0,0,0,0,0,Sunday
2021-08-15,Shenzhen Bay,2616,180,5,2801,892,136,1,1029,Sunday
2021-08-15,China Ferry Terminal,0,0,0,0,0,0,0,0,Sunday
2021-08-15,Harbour Control,0,0,0,0,0,0,0,0,Sunday
2021-08-15,Kai Tak Cruise Terminal,1398,0,0,1398,1228,0,0,1228,Sunday
2021-08-15,Macau Ferry Terminal,0,0,0,0,0,0,0,0,Sunday
2021-08-15,Tuen Mun Ferry Terminal,0,0,0,0,0,0,0,0,Sunday
2021-08-15,Total,5484,207,36,5727,4167,172,32,4371,Sunday
2021-08-16,Airport,708,16,18,742,1127,15,18,1160,Monday
2021-08-16,Express Rail Link West Kowloon,0,0,0,0,0,0,0,0,Monday
2021-08-16,Hung Hom,0,0,0,0,0,0,0,0,Monday
2021-08-16,Lo Wu,0,0,0,0,0,0,0,0,Monday
2021-08-16,Lok Ma Chau Spur Line,0,0,0,0,0,0,0,0,Monday
2021-08-16,Heung Yuen Wai,0,0,0,0,0,0,0,0,Monday
2021-08-16,Hong Kong-Zhuhai-Macao Bridge,161,10,3,174,187,7,3,197,Monday
2021-08-16,Lok Ma Chau,0,0,0,0,0,0,0,0,Monday
2021-08-16,Man Kam To,0,0,0,0,0,0,0,0,Monday
2021-08-16,Sha Tau Kok,0,0,0,0,0,0,0,0,Monday
2021-08-16,Shenzhen Bay,3753,306,6,4065,879,112,1,992,Monday
2021-08-16,China Ferry Terminal,0,0,0,0,0,0,0,0,Monday
2021-08-16,Harbour Control,0,0,0,0,0,0,0,0,Monday
2021-08-16,Kai Tak Cruise Terminal,0,0,0,0,0,0,0,0,Monday
2021-08-16,Macau Ferry Terminal,0,0,0,0,0,0,0,0,Monday
2021-08-16,Tuen Mun Ferry Terminal,0,0,0,0,0,0,0,0,Monday
2021-08-16,Total,4622,332,27,4981,2193,134,22,2349,Monday
2021-08-17,Airport,1185,13,27,1225,1565,5,42,1612,Tuesday
2021-08-17,Express Rail Link West Kowloon,0,0,0,0,0,0,0,0,Tuesday
2021-08-17,Hung Hom,0,0,0,0,0,0,0,0,Tuesday
2021-08-17,Lo Wu,0,0,0,0,0,0,0,0,Tuesday
2021-08-17,Lok Ma Chau Spur Line,0,0,0,0,0,0,0,0,Tuesday
2021-08-17,Heung Yuen Wai,0,0,0,0,0,0,0,0,Tuesday
2021-08-17,Hong Kong-Zhuhai-Macao Bridge,133,6,6,145,167,8,2,177,Tuesday
2021-08-17,Lok Ma Chau,0,0,0,0,0,0,0,0,Tuesday
2021-08-17,Man Kam To,0,0,0,0,0,0,0,0,Tuesday
2021-08-17,Sha Tau Kok,0,0,0,0,0,0,0,0,Tuesday
2021-08-17,Shenzhen Bay,2457,236,9,2702,871,102,1,974,Tuesday
2021-08-17,China Ferry Terminal,0,0,0,0,0,0,0,0,Tuesday
2021-08-17,Harbour Control,0,0,0,0,0,0,0,0,Tuesday
2021-08-17,Kai Tak Cruise Terminal,0,0,0,0,0,0,0,0,Tuesday
2021-08-17,Macau Ferry Terminal,0,0,0,0,0,0,0,0,Tuesday
2021-08-17,Tuen Mun Ferry Terminal,0,0,0,0,0,0,0,0,Tuesday
2021-08-17,Total,3775,255,42,4072,2603,115,45,2763,Tuesday
2021-08-18,Airport,1177,19,56,1252,1170,9,20,1199,Wednesday
2021-08-18,Express Rail Link West Kowloon,0,0,0,0,0,0,0,0,Wednesday
2021-08-18,Hung Hom,0,0,0,0,0,0,0,0,Wednesday
2021-08-18,Lo Wu,0,0,0,0,0,0,0,0,Wednesday
2021-08-18,Lok Ma Chau Spur Line,0,0,0,0,0,0,0,0,Wednesday
2021-08-18,Heung Yuen Wai,0,0,0,0,0,0,0,0,Wednesday
2021-08-18,Hong Kong-Zhuhai-Macao Bridge,148,8,3,159,140,9,2,151,Wednesday
2021-08-18,Lok Ma Chau,0,0,0,0,0,0,0,0,Wednesday
2021-08-18,Man Kam To,0,0,0,0,0,0,0,0,Wednesday
2021-08-18,Sha Tau Kok,0,0,0,0,0,0,0,0,Wednesday
2021-08-18,Shenzhen Bay,2495,207,8,2710,895,106,0,1001,Wednesday
2021-08-18,China Ferry Terminal,0,0,0,0,0,0,0,0,Wednesday
2021-08-18,Harbour Control,0,0,0,0,0,0,0,0,Wednesday
2021-08-18,Kai Tak Cruise Terminal,1228,0,0,1228,1504,0,0,1504,Wednesday
2021-08-18,Macau Ferry Terminal,0,0,0,0,0,0,0,0,Wednesday
2021-08-18,Tuen Mun Ferry Terminal,0,0,0,0,0,0,0,0,Wednesday
2021-08-18,Total,5048,234,67,5349,3709,124,22,3855,Wednesday
2021-08-19,Airport,1694,13,83,1790,1615,19,25,1659,Thursday
2021-08-19,Express Rail Link West Kowloon,0,0,0,0,0,0,0,0,Thursday
2021-08-19,Hung Hom,0,0,0,0,0,0,0,0,Thursday
2021-08-19,Lo Wu,0,0,0,0,0,0,0,0,Thursday
2021-08-19,Lok Ma Chau Spur Line,0,0,0,0,0,0,0,0,Thursday
2021-08-19,Heung Yuen Wai,0,0,0,0,0,0,0,0,Thursday
2021-08-19,Hong Kong-Zhuhai-Macao Bridge,161,13,9,183,136,10,6,152,Thursday
2021-08-19,Lok Ma Chau,0,0,0,0,0,0,0,0,Thursday
2021-08-19,Man Kam To,0,0,0,0,0,0,0,0,Thursday
2021-08-19,Sha Tau Kok,0,0,0,0,0,0,0,0,Thursday
2021-08-19,Shenzhen Bay,2299,234,6,2539,729,84,2,815,Thursday
2021-08-19,China Ferry Terminal,0,0,0,0,0,0,0,0,Thursday
2021-08-19,Harbour Control,0,0,0,0,0,0,0,0,Thursday
2021-08-19,Kai Tak Cruise Terminal,0,0,0,0,0,0,0,0,Thursday
2021-08-19,Macau Ferry Terminal,0,0,0,0,0,0,0,0,Thursday
2021-08-19,Tuen Mun Ferry Terminal,0,0,0,0,0,0,0,0,Thursday
2021-08-19,Total,4154,260,98,4512,2480,113,33,2626,Thursday
2021-08-20,Airport,1102,14,45,1161,1664,12,53,1729,Friday
2021-08-20,Express Rail Link West Kowloon,0,0,0,0,0,0,0,0,Friday
2021-08-20,Hung Hom,0,0,0,0,0,0,0,0,Friday
2021-08-20,Lo Wu,0,0,0,0,0,0,0,0,Friday
2021-08-20,Lok Ma Chau Spur Line,0,0,0,0,0,0,0,0,Friday
2021-08-20,Heung Yuen Wai,0,0,0,0,0,0,0,0,Friday
2021-08-20,Hong Kong-Zhuhai-Macao Bridge,197,12,19,228,149,4,3,156,Friday
2021-08-20,Lok Ma Chau,0,0,0,0,0,0,0,0,Friday
2021-08-20,Man Kam To,0,0,0,0,0,0,0,0,Friday
2021-08-20,Sha Tau Kok,0,0,0,0,0,0,0,0,Friday
2021-08-20,Shenzhen Bay,3008,232,4,3244,789,107,3,899,Friday
2021-08-20,China Ferry Terminal,0,0,0,0,0,0,0,0,Friday
2021-08-20,Harbour Control,0,0,0,0,0,0,0,0,Friday
2021-08-20,Kai Tak Cruise Terminal,1504,0,0,1504,1539,0,0,1539,Friday
2021-08-20,Macau Ferry Terminal,0,0,0,0,0,0,0,0,Friday
2021-08-20,Tuen Mun Ferry Terminal,0,0,0,0,0,0,0,0,Friday
2021-08-20,Total,5811,258,68,6137,4141,123,59,4323,Friday
2021-08-21,Airport,693,15,22,730,1773,32,19,1824,Saturday
2021-08-21,Express Rail Link West Kowloon,0,0,0,0,0,0,0,0,Saturday
2021-08-21,Hung Hom,0,0,0,0,0,0,0,0,Saturday
2021-08-21,Lo Wu,0,0,0,0,0,0,0,0,Saturday
2021-08-21,Lok Ma Chau Spur Line,0,0,0,0,0,0,0,0,Saturday
2021-08-21,Heung Yuen Wai,0,0,0,0,0,0,0,0,Saturday
2021-08-21,Hong Kong-Zhuhai-Macao Bridge,182,10,10,202,119,7,0,126,Saturday
2021-08-21,Lok Ma Chau,0,0,0,0,0,0,0,0,Saturday
2021-08-21,Man Kam To,0,0,0,0,0,0,0,0,Saturday
2021-08-21,Sha Tau Kok,0,0,0,0,0,0,0,0,Saturday
2021-08-21,Shenzhen Bay,2577,209,4,2790,568,66,4,638,Saturday
2021-08-21,China Ferry Terminal,0,0,0,0,0,0,0,0,Saturday
2021-08-21,Harbour Control,0,0,0,0,0,0,0,0,Saturday
2021-08-21,Kai Tak Cruise Terminal,0,0,0,0,0,0,0,0,Saturday
2021-08-21,Macau Ferry Terminal,0,0,0,0,0,0,0,0,Saturday
2021-08-21,Tuen Mun Ferry Terminal,0,0,0,0,0,0,0,0,Saturday
2021-08-21,Total,3452,234,36,3722,2460,105,23,2588,Saturday
2021-08-22,Airport,1027,8,28,1063,1370,10,21,1401,Sunday
2021-08-22,Express Rail Link West Kowloon,0,0,0,0,0,0,0,0,Sunday
2021-08-22,Hung Hom,0,0,0,0,0,0,0,0,Sunday
2021-08-22,Lo Wu,0,0,0,0,0,0,0,0,Sunday
2021-08-22,Lok Ma Chau Spur Line,0,0,0,0,0,0,0,0,Sunday
2021-08-22,Heung Yuen Wai,0,0,0,0,0,0,0,0,Sunday
2021-08-22,Hong Kong-Zhuhai-Macao Bridge,217,12,2,231,155,7,3,165,Sunday
2021-08-22,Lok Ma Chau,0,0,0,0,0,0,0,0,Sunday
2021-08-22,Man Kam To,0,0,0,0,0,0,0,0,Sunday
2021-08-22,Sha Tau Kok,0,0,0,0,0,0,0,0,Sunday
2021-08-22,Shenzhen Bay,3239,309,0,3548,498,66,1,565,Sunday
2021-08-22,China Ferry Terminal,0,0,0,0,0,0,0,0,Sunday
2021-08-22,Harbour Control,0,0,0,0,0,0,0,0,Sunday
2021-08-22,Kai Tak Cruise Terminal,1539,0,0,1539,1411,0,0,1411,Sunday
2021-08-22,Macau Ferry Terminal,0,0,0,0,0,0,0,0,Sunday
2021-08-22,Tuen Mun Ferry Terminal,0,0,0,0,0,0,0,0,Sunday
2021-08-22,Total,6022,329,30,6381,3434,83,25,3542,Sunday
2021-08-23,Airport,505,6,23,534,1321,8,27,1356,Monday
2021-08-23,Express Rail Link West Kowloon,0,0,0,0,0,0,0,0,Monday
2021-08-23,Hung Hom,0,0,0,0,0,0,0,0,Monday
2021-08-23,Lo Wu,0,0,0,0,0,0,0,0,Monday
2021-08-23,Lok Ma Chau Spur Line,0,0,0,0,0,0,0,0,Monday
2021-08-23,Heung Yuen Wai,0,0,0,0,0,0,0,0,Monday
2021-08-23,Hong Kong-Zhuhai-Macao Bridge,207,9,4,220,165,7,5,177,Monday
2021-08-23,Lok Ma Chau,0,0,0,0,0,0,0,0,Monday
2021-08-23,Man Kam To,0,0,0,0,0,0,0,0,Monday
2021-08-23,Sha Tau Kok,0,0,0,0,0,0,0,0,Monday
2021-08-23,Shenzhen Bay,3352,282,7,3641,711,83,4,798,Monday
2021-08-23,China Ferry Terminal,0,0,0,0,0,0,0,0,Monday
2021-08-23,Harbour Control,0,0,0,0,0,0,0,0,Monday
2021-08-23,Kai Tak Cruise Terminal,0,0,0,0,0,0,0,0,Monday
2021-08-23,Macau Ferry Terminal,0,0,0,0,0,0,0,0,Monday
2021-08-23,Tuen Mun Ferry Terminal,0,0,0,0,0,0,0,0,Monday
2021-08-23,Total,4064,297,34,4395,2197,98,36,2331,Monday
2021-08-24,Airport,877,5,20,902,1856,17,31,1904,Tuesday
2021-08-24,Express Rail Link West Kowloon,0,0,0,0,0,0,0,0,Tuesday
2021-08-24,Hung Hom,0,0,0,0,0,0,0,0,Tuesday
2021-08-24,Lo Wu,0,0,0,0,0,0,0,0,Tuesday
2021-08-24,Lok Ma Chau Spur Line,0,0,0,0,0,0,0,0,Tuesday
2021-08-24,Heung Yuen Wai,0,0,0,0,0,0,0,0,Tuesday
2021-08-24,Hong Kong-Zhuhai-Macao Bridge,186,13,3,202,152,7,2,161,Tuesday
2021-08-24,Lok Ma Chau,0,0,0,0,0,0,0,0,Tuesday
2021-08-24,Man Kam To,0,0,0,0,0,0,0,0,Tuesday
2021-08-24,Sha Tau Kok,0,0,0,0,0,0,0,0,Tuesday
2021-08-24,Shenzhen Bay,2756,311,11,3078,738,88,1,827,Tuesday
2021-08-24,China Ferry Terminal,0,0,0,0,0,0,0,0,Tuesday
2021-08-24,Harbour Control,0,0,0,0,0,0,0,0,Tuesday
2021-08-24,Kai Tak Cruise Terminal,0,0,0,0,0,0,0,0,Tuesday
2021-08-24,Macau Ferry Terminal,0,0,0,0,0,0,0,0,Tuesday
2021-08-24,Tuen Mun Ferry Terminal,0,0,0,0,0,0,0,0,Tuesday
2021-08-24,Total,3819,329,34,4182,2746,112,34,2892,Tuesday
2021-08-25,Airport,688,16,30,734,1385,13,25,1423,Wednesday
2021-08-25,Express Rail Link West Kowloon,0,0,0,0,0,0,0,0,Wednesday
2021-08-25,Hung Hom,0,0,0,0,0,0,0,0,Wednesday
2021-08-25,Lo Wu,0,0,0,0,0,0,0,0,Wednesday
2021-08-25,Lok Ma Chau Spur Line,0,0,0,0,0,0,0,0,Wednesday
2021-08-25,Heung Yuen Wai,0,0,0,0,0,0,0,0,Wednesday
2021-08-25,Hong Kong-Zhuhai-Macao Bridge,201,8,6,215,143,11,1,155,Wednesday
2021-08-25,Lok Ma Chau,0,0,0,0,0,0,0,0,Wednesday
2021-08-25,Man Kam To,0,0,0,0,0,0,0,0,Wednesday
2021-08-25,Sha Tau Kok,0,0,0,0,0,0,0,0,Wednesday
2021-08-25,Shenzhen Bay,3194,294,3,3491,774,157,5,936,Wednesday
2021-08-25,China Ferry Terminal,0,0,0,0,0,0,0,0,Wednesday
2021-08-25,Harbour Control,0,0,0,0,0,0,0,0,Wednesday
2021-08-25,Kai Tak Cruise Terminal,1411,0,0,1411,1434,0,0,1434,Wednesday
2021-08-25,Macau Ferry Terminal,0,0,0,0,0,0,0,0,Wednesday
2021-08-25,Tuen Mun Ferry Terminal,0,0,0,0,0,0,0,0,Wednesday
2021-08-25,Total,5494,318,39,5851,3736,181,31,3948,Wednesday
2021-08-26,Airport,659,17,21,697,1603,14,25,1642,Thursday
2021-08-26,Express Rail Link West Kowloon,0,0,0,0,0,0,0,0,Thursday
2021-08-26,Hung Hom,0,0,0,0,0,0,0,0,Thursday
2021-08-26,Lo Wu,0,0,0,0,0,0,0,0,Thursday
2021-08-26,Lok Ma Chau Spur Line,0,0,0,0,0,0,0,0,Thursday
2021-08-26,Heung Yuen Wai,0,0,0,0,0,0,0,0,Thursday
2021-08-26,Hong Kong-Zhuhai-Macao Bridge,276,19,2,297,154,8,4,166,Thursday
2021-08-26,Lok Ma Chau,0,0,0,0,0,0,0,0,Thursday
2021-08-26,Man Kam To,0,0,0,0,0,0,0,0,Thursday
2021-08-26,Sha Tau Kok,0,0,0,0,0,0,0,0,Thursday
2021-08-26,Shenzhen Bay,2920,277,6,3203,646,70,3,719,Thursday
2021-08-26,China Ferry Terminal,0,0,0,0,0,0,0,0,Thursday
2021-08-26,Harbour Control,0,0,0,0,0,0,0,0,Thursday
2021-08-26,Kai Tak Cruise Terminal,0,0,0,0,0,0,0,0,Thursday
2021-08-26,Macau Ferry Terminal,0,0,0,0,0,0,0,0,Thursday
2021-08-26,Tuen Mun Ferry Terminal,0,0,0,0,0,0,0,0,Thursday
2021-08-26,Total,3855,313,29,4197,2403,92,32,2527,Thursday
2021-08-27,Airport,747,11,37,795,1896,23,31,1950,Friday
2021-08-27,Express Rail Link West Kowloon,0,0,0,0,0,0,0,0,Friday
2021-08-27,Hung Hom,0,0,0,0,0,0,0,0,Friday
2021-08-27,Lo Wu,0,0,0,0,0,0,0,0,Friday
2021-08-27,Lok Ma Chau Spur Line,0,0,0,0,0,0,0,0,Friday
2021-08-27,Heung Yuen Wai,0,0,0,0,0,0,0,0,Friday
2021-08-27,Hong Kong-Zhuhai-Macao Bridge,267,18,8,293,164,6,2,172,Friday
2021-08-27,Lok Ma Chau,0,0,0,0,0,0,0,0,Friday
2021-08-27,Man Kam To,0,0,0,0,0,0,0,0,Friday
2021-08-27,Sha Tau Kok,0,0,0,0,0,0,0,0,Friday
2021-08-27,Shenzhen Bay,3051,226,6,3283,704,87,7,798,Friday
2021-08-27,China Ferry Terminal,0,0,0,0,0,0,0,0,Friday
2021-08-27,Harbour Control,0,0,0,0,0,0,0,0,Friday
2021-08-27,Kai Tak Cruise Terminal,1434,0,0,1434,1550,0,0,1550,Friday
2021-08-27,Macau Ferry Terminal,0,0,0,0,0,0,0,0,Friday
2021-08-27,Tuen Mun Ferry Terminal,0,0,0,0,0,0,0,0,Friday
2021-08-27,Total,5499,255,51,5805,4314,116,40,4470,Friday
2021-08-28,Airport,915,16,35,966,2156,26,21,2203,Saturday
2021-08-28,Express Rail Link West Kowloon,0,0,0,0,0,0,0,0,Saturday
2021-08-28,Hung Hom,0,0,0,0,0,0,0,0,Saturday
2021-08-28,Lo Wu,0,0,0,0,0,0,0,0,Saturday
2021-08-28,Lok Ma Chau Spur Line,0,0,0,0,0,0,0,0,Saturday
2021-08-28,Heung Yuen Wai,0,0,0,0,0,0,0,0,Saturday
2021-08-28,Hong Kong-Zhuhai-Macao Bridge,285,17,8,310,149,11,11,171,Saturday
2021-08-28,Lok Ma Chau,0,0,0,0,0,0,0,0,Saturday
2021-08-28,Man Kam To,0,0,0,0,0,0,0,0,Saturday
2021-08-28,Sha Tau Kok,0,0,0,0,0,0,0,0,Saturday
2021-08-28,Shenzhen Bay,3524,278,1,3803,813,96,6,915,Saturday
2021-08-28,China Ferry Terminal,0,0,0,0,0,0,0,0,Saturday
2021-08-28,Harbour Control,0,0,0,0,0,0,0,0,Saturday
2021-08-28,Kai Tak Cruise Terminal,0,0,0,0,0,0,0,0,Saturday
2021-08-28,Macau Ferry Terminal,0,0,0,0,0,0,0,0,Saturday
2021-08-28,Tuen Mun Ferry Terminal,0,0,0,0,0,0,0,0,Saturday
2021-08-28,Total,4724,311,44,5079,3118,133,38,3289,Saturday
2021-08-29,Airport,999,5,29,1033,1953,7,32,1992,Sunday
2021-08-29,Express Rail Link West Kowloon,0,0,0,0,0,0,0,0,Sunday
2021-08-29,Hung Hom,0,0,0,0,0,0,0,0,Sunday
2021-08-29,Lo Wu,0,0,0,0,0,0,0,0,Sunday
2021-08-29,Lok Ma Chau Spur Line,0,0,0,0,0,0,0,0,Sunday
2021-08-29,Heung Yuen Wai,0,0,0,0,0,0,0,0,Sunday
2021-08-29,Hong Kong-Zhuhai-Macao Bridge,329,10,6,345,187,13,6,206,Sunday
2021-08-29,Lok Ma Chau,0,0,0,0,0,0,0,0,Sunday
2021-08-29,Man Kam To,0,0,0,0,0,0,0,0,Sunday
2021-08-29,Sha Tau Kok,0,0,0,0,0,0,0,0,Sunday
2021-08-29,Shenzhen Bay,3582,330,1,3913,639,88,3,730,Sunday
2021-08-29,China Ferry Terminal,0,0,0,0,0,0,0,0,Sunday
2021-08-29,Harbour Control,0,0,0,0,0,0,0,0,Sunday
2021-08-29,Kai Tak Cruise Terminal,1550,0,0,1550,1002,0,0,1002,Sunday
2021-08-29,Macau Ferry Terminal,0,0,0,0,0,0,0,0,Sunday
2021-08-29,Tuen Mun Ferry Terminal,0,0,0,0,0,0,0,0,Sunday
2021-08-29,Total,6460,345,36,6841,3781,108,41,3930,Sunday
2021-08-30,Airport,639,8,20,667,1418,15,30,1463,Monday
2021-08-30,Express Rail Link West Kowloon,0,0,0,0,0,0,0,0,Monday
2021-08-30,Hung Hom,0,0,0,0,0,0,0,0,Monday
2021-08-30,Lo Wu,0,0,0,0,0,0,0,0,Monday
2021-08-30,Lok Ma Chau Spur Line,0,0,0,0,0,0,0,0,Monday
2021-08-30,Heung Yuen Wai,0,0,0,0,0,0,0,0,Monday
2021-08-30,Hong Kong-Zhuhai-Macao Bridge,447,20,2,469,200,8,3,211,Monday
2021-08-30,Lok Ma Chau,0,0,0,0,0,0,0,0,Monday
2021-08-30,Man Kam To,0,0,0,0,0,0,0,0,Monday
2021-08-30,Sha Tau Kok,0,0,0,0,0,0,0,0,Monday
2021-08-30,Shenzhen Bay,3430,429,4,3863,619,70,5,694,Monday
2021-08-30,China Ferry Terminal,0,0,0,0,0,0,0,0,Monday
2021-08-30,Harbour Control,0,0,0,0,0,0,0,0,Monday
2021-08-30,Kai Tak Cruise Terminal,0,0,0,0,0,0,0,0,Monday
2021-08-30,Macau Ferry Terminal,0,0,0,0,0,0,0,0,Monday
2021-08-30,Tuen Mun Ferry Terminal,0,0,0,0,0,0,0,0,Monday
2021-08-30,Total,4516,457,26,4999,2237,93,38,2368,Monday
2021-08-31,Airport,898,9,41,948,1782,28,32,1842,Tuesday
2021-08-31,Express Rail Link West Kowloon,0,0,0,0,0,0,0,0,Tuesday
2021-08-31,Hung Hom,0,0,0,0,0,0,0,0,Tuesday
2021-08-31,Lo Wu,0,0,0,0,0,0,0,0,Tuesday
2021-08-31,Lok Ma Chau Spur Line,0,0,0,0,0,0,0,0,Tuesday
2021-08-31,Heung Yuen Wai,0,0,0,0,0,0,0,0,Tuesday
2021-08-31,Hong Kong-Zhuhai-Macao Bridge,412,26,4,442,188,13,6,207,Tuesday
2021-08-31,Lok Ma Chau,0,0,0,0,0,0,0,0,Tuesday
2021-08-31,Man Kam To,0,0,0,0,0,0,0,0,Tuesday
2021-08-31,Sha Tau Kok,0,0,0,0,0,0,0,0,Tuesday
2021-08-31,Shenzhen Bay,3331,344,5,3680,808,100,3,911,Tuesday
2021-08-31,China Ferry Terminal,0,0,0,0,0,0,0,0,Tuesday
2021-08-31,Harbour Control,0,0,0,0,0,0,0,0,Tuesday
2021-08-31,Kai Tak Cruise Terminal,0,0,0,0,0,0,0,0,Tuesday
2021-08-31,Macau Ferry Terminal,0,0,0,0,0,0,0,0,Tuesday
2021-08-31,Tuen Mun Ferry Terminal,0,0,0,0,0,0,0,0,Tuesday
2021-08-31,Total,4641,379,50,5070,2778,141,41,2960,Tuesday
2021-09-02,Airport,972,8,36,1016,1629,15,29,1673,Thursday
2021-09-02,Express Rail Link West Kowloon,0,0,0,0,0,0,0,0,Thursday
2021-09-02,Hung Hom,0,0,0,0,0,0,0,0,Thursday
2021-09-02,Lo Wu,0,0,0,0,0,0,0,0,Thursday
2021-09-02,Lok Ma Chau Spur Line,0,0,0,0,0,0,0,0,Thursday
2021-09-02,Heung Yuen Wai,0,0,0,0,0,0,0,0,Thursday
2021-09-02,Hong Kong-Zhuhai-Macao Bridge,141,7,2,150,218,13,2,233,Thursday
2021-09-02,Lok Ma Chau,0,0,0,0,0,0,0,0,Thursday
2021-09-02,Man Kam To,0,0,0,0,0,0,0,0,Thursday
2021-09-02,Sha Tau Kok,0,0,0,0,0,0,0,0,Thursday
2021-09-02,Shenzhen Bay,1796,202,2,2000,944,101,5,1050,Thursday
2021-09-02,China Ferry Terminal,0,0,0,0,0,0,0,0,Thursday
2021-09-02,Harbour Control,0,0,0,0,0,0,0,0,Thursday
2021-09-02,Kai Tak Cruise Terminal,0,0,0,0,0,0,0,0,Thursday
2021-09-02,Macau Ferry Terminal,0,0,0,0,0,0,0,0,Thursday
2021-09-02,Tuen Mun Ferry Terminal,0,0,0,0,0,0,0,0,Thursday
2021-09-02,Total,2909,217,40,3166,2791,129,36,2956,Thursday
2021-09-01,Airport,762,15,21,798,1476,13,40,1529,Wednesday
2021-09-01,Express Rail Link West Kowloon,0,0,0,0,0,0,0,0,Wednesday
2021-09-01,Hung Hom,0,0,0,0,0,0,0,0,Wednesday
2021-09-01,Lo Wu,0,0,0,0,0,0,0,0,Wednesday
2021-09-01,Lok Ma Chau Spur Line,0,0,0,0,0,0,0,0,Wednesday
2021-09-01,Heung Yuen Wai,0,0,0,0,0,0,0,0,Wednesday
2021-09-01,Hong Kong-Zhuhai-Macao Bridge,311,22,4,337,247,15,2,264,Wednesday
2021-09-01,Lok Ma Chau,0,0,0,0,0,0,0,0,Wednesday
2021-09-01,Man Kam To,0,0,0,0,0,0,0,0,Wednesday
2021-09-01,Sha Tau Kok,0,0,0,0,0,0,0,0,Wednesday
2021-09-01,Shenzhen Bay,3253,321,9,3583,1036,117,7,1160,Wednesday
2021-09-01,China Ferry Terminal,0,0,0,0,0,0,0,0,Wednesday
2021-09-01,Harbour Control,0,0,0,0,0,0,0,0,Wednesday
2021-09-01,Kai Tak Cruise Terminal,1002,0,0,1002,1234,0,0,1234,Wednesday
2021-09-01,Macau Ferry Terminal,0,0,0,0,0,0,0,0,Wednesday
2021-09-01,Tuen Mun Ferry Terminal,0,0,0,0,0,0,0,0,Wednesday
2021-09-01,Total,5328,358,34,5720,3993,145,49,4187,Wednesday
2021-09-03,Airport,860,4,38,902,1990,6,40,2036,Friday
2021-09-03,Express Rail Link West Kowloon,0,0,0,0,0,0,0,0,Friday
2021-09-03,Hung Hom,0,0,0,0,0,0,0,0,Friday
2021-09-03,Lo Wu,0,0,0,0,0,0,0,0,Friday
2021-09-03,Lok Ma Chau Spur Line,0,0,0,0,0,0,0,0,Friday
2021-09-03,Heung Yuen Wai,0,0,0,0,0,0,0,0,Friday
2021-09-03,Hong Kong-Zhuhai-Macao Bridge,160,10,4,174,221,11,6,238,Friday
2021-09-03,Lok Ma Chau,0,0,0,0,0,0,0,0,Friday
2021-09-03,Man Kam To,0,0,0,0,0,0,0,0,Friday
2021-09-03,Sha Tau Kok,0,0,0,0,0,0,0,0,Friday
2021-09-03,Shenzhen Bay,1467,174,5,1646,875,133,6,1014,Friday
2021-09-03,China Ferry Terminal,0,0,0,0,0,0,0,0,Friday
2021-09-03,Harbour Control,0,0,0,0,0,0,0,0,Friday
2021-09-03,Kai Tak Cruise Terminal,1234,0,0,1234,1421,0,0,1421,Friday
2021-09-03,Macau Ferry Terminal,0,0,0,0,0,0,0,0,Friday
2021-09-03,Tuen Mun Ferry Terminal,0,0,0,0,0,0,0,0,Friday
2021-09-03,Total,3721,188,47,3956,4507,150,52,4709,Friday
2021-09-05,Airport,965,9,34,1008,1908,21,37,1966,Sunday
2021-09-05,Express Rail Link West Kowloon,0,0,0,0,0,0,0,0,Sunday
2021-09-05,Hung Hom,0,0,0,0,0,0,0,0,Sunday
2021-09-05,Lo Wu,0,0,0,0,0,0,0,0,Sunday
2021-09-05,Lok Ma Chau Spur Line,0,0,0,0,0,0,0,0,Sunday
2021-09-05,Heung Yuen Wai,0,0,0,0,0,0,0,0,Sunday
2021-09-05,Hong Kong-Zhuhai-Macao Bridge,189,15,6,210,251,17,6,274,Sunday
2021-09-05,Lok Ma Chau,0,0,0,0,0,0,0,0,Sunday
2021-09-05,Man Kam To,0,0,0,0,0,0,0,0,Sunday
2021-09-05,Sha Tau Kok,0,0,0,0,0,0,0,0,Sunday
2021-09-05,Shenzhen Bay,2135,261,3,2399,701,113,3,817,Sunday
2021-09-05,China Ferry Terminal,0,0,0,0,0,0,0,0,Sunday
2021-09-05,Harbour Control,0,0,0,0,0,0,0,0,Sunday
2021-09-05,Kai Tak Cruise Terminal,1421,0,0,1421,951,0,0,951,Sunday
2021-09-05,Macau Ferry Terminal,0,0,0,0,0,0,0,0,Sunday
2021-09-05,Tuen Mun Ferry Terminal,0,0,0,0,0,0,0,0,Sunday
2021-09-05,Total,4710,285,43,5038,3811,151,46,4008,Sunday
2021-09-06,Airport,420,3,21,444,1297,20,21,1338,Monday
2021-09-06,Express Rail Link West Kowloon,0,0,0,0,0,0,0,0,Monday
2021-09-06,Hung Hom,0,0,0,0,0,0,0,0,Monday
2021-09-06,Lo Wu,0,0,0,0,0,0,0,0,Monday
2021-09-06,Lok Ma Chau Spur Line,0,0,0,0,0,0,0,0,Monday
2021-09-06,Heung Yuen Wai,0,0,0,0,0,0,0,0,Monday
2021-09-06,Hong Kong-Zhuhai-Macao Bridge,120,11,4,135,243,13,3,259,Monday
2021-09-06,Lok Ma Chau,0,0,0,0,0,0,0,0,Monday
2021-09-06,Man Kam To,0,0,0,0,0,0,0,0,Monday
2021-09-06,Sha Tau Kok,0,0,0,0,0,0,0,0,Monday
2021-09-06,Shenzhen Bay,1255,155,3,1413,958,133,6,1097,Monday
2021-09-06,China Ferry Terminal,0,0,0,0,0,0,0,0,Monday
2021-09-06,Harbour Control,0,0,0,0,0,0,0,0,Monday
2021-09-06,Kai Tak Cruise Terminal,0,0,0,0,0,0,0,0,Monday
2021-09-06,Macau Ferry Terminal,0,0,0,0,0,0,0,0,Monday
2021-09-06,Tuen Mun Ferry Terminal,0,0,0,0,0,0,0,0,Monday
2021-09-06,Total,1795,169,28,1992,2498,166,30,2694,Monday
2021-09-07,Airport,788,10,31,829,1733,19,38,1790,Tuesday
2021-09-07,Express Rail Link West Kowloon,0,0,0,0,0,0,0,0,Tuesday
2021-09-07,Hung Hom,0,0,0,0,0,0,0,0,Tuesday
2021-09-07,Lo Wu,0,0,0,0,0,0,0,0,Tuesday
2021-09-07,Lok Ma Chau Spur Line,0,0,0,0,0,0,0,0,Tuesday
2021-09-07,Heung Yuen Wai,0,0,0,0,0,0,0,0,Tuesday
2021-09-07,Hong Kong-Zhuhai-Macao Bridge,94,5,3,102,236,19,9,264,Tuesday
2021-09-07,Lok Ma Chau,0,0,0,0,0,0,0,0,Tuesday
2021-09-07,Man Kam To,0,0,0,0,0,0,0,0,Tuesday
2021-09-07,Sha Tau Kok,0,0,0,0,0,0,0,0,Tuesday
2021-09-07,Shenzhen Bay,1130,158,3,1291,880,108,2,990,Tuesday
2021-09-07,China Ferry Terminal,0,0,0,0,0,0,0,0,Tuesday
2021-09-07,Harbour Control,0,0,0,0,0,0,0,0,Tuesday
2021-09-07,Kai Tak Cruise Terminal,0,0,0,0,0,0,0,0,Tuesday
2021-09-07,Macau Ferry Terminal,0,0,0,0,0,0,0,0,Tuesday
2021-09-07,Tuen Mun Ferry Terminal,0,0,0,0,0,0,0,0,Tuesday
2021-09-07,Total,2012,173,37,2222,2849,146,49,3044,Tuesday
2021-09-08,Airport,700,9,32,741,1195,11,34,1240,Wednesday
2021-09-08,Express Rail Link West Kowloon,0,0,0,0,0,0,0,0,Wednesday
2021-09-08,Hung Hom,0,0,0,0,0,0,0,0,Wednesday
2021-09-08,Lo Wu,0,0,0,0,0,0,0,0,Wednesday
2021-09-08,Lok Ma Chau Spur Line,0,0,0,0,0,0,0,0,Wednesday
2021-09-08,Heung Yuen Wai,0,0,0,0,0,0,0,0,Wednesday
2021-09-08,Hong Kong-Zhuhai-Macao Bridge,141,2,0,143,200,18,0,218,Wednesday
2021-09-08,Lok Ma Chau,0,0,0,0,0,0,0,0,Wednesday
2021-09-08,Man Kam To,0,0,0,0,0,0,0,0,Wednesday
2021-09-08,Sha Tau Kok,0,0,0,0,0,0,0,0,Wednesday
2021-09-08,Shenzhen Bay,1189,119,3,1311,730,81,2,813,Wednesday
2021-09-08,China Ferry Terminal,0,0,0,0,0,0,0,0,Wednesday
2021-09-08,Harbour Control,0,0,0,0,0,0,0,0,Wednesday
2021-09-08,Kai Tak Cruise Terminal,951,0,0,951,1308,0,0,1308,Wednesday
2021-09-08,Macau Ferry Terminal,0,0,0,0,0,0,0,0,Wednesday
2021-09-08,Tuen Mun Ferry Terminal,0,0,0,0,0,0,0,0,Wednesday
2021-09-08,Total,2981,130,35,3146,3433,110,36,3579,Wednesday
2021-09-09,Airport,597,6,45,648,1313,21,23,1357,Thursday
2021-09-09,Express Rail Link West Kowloon,0,0,0,0,0,0,0,0,Thursday
2021-09-09,Hung Hom,0,0,0,0,0,0,0,0,Thursday
2021-09-09,Lo Wu,0,0,0,0,0,0,0,0,Thursday
2021-09-09,Lok Ma Chau Spur Line,0,0,0,0,0,0,0,0,Thursday
2021-09-09,Heung Yuen Wai,0,0,0,0,0,0,0,0,Thursday
2021-09-09,Hong Kong-Zhuhai-Macao Bridge,107,6,6,119,160,6,5,171,Thursday
2021-09-09,Lok Ma Chau,0,0,0,0,0,0,0,0,Thursday
2021-09-09,Man Kam To,0,0,0,0,0,0,0,0,Thursday
2021-09-09,Sha Tau Kok,0,0,0,0,0,0,0,0,Thursday
2021-09-09,Shenzhen Bay,1056,108,4,1168,646,69,3,718,Thursday
2021-09-09,China Ferry Terminal,0,0,0,0,0,0,0,0,Thursday
2021-09-09,Harbour Control,0,0,0,0,0,0,0,0,Thursday
2021-09-09,Kai Tak Cruise Terminal,0,0,0,0,0,0,0,0,Thursday
2021-09-09,Macau Ferry Terminal,0,0,0,0,0,0,0,0,Thursday
2021-09-09,Tuen Mun Ferry Terminal,0,0,0,0,0,0,0,0,Thursday
2021-09-09,Total,1760,120,55,1935,2119,96,31,2246,Thursday
2021-09-11,Airport,805,13,32,850,1670,27,29,1726,Saturday
2021-09-11,Express Rail Link West Kowloon,0,0,0,0,0,0,0,0,Saturday
2021-09-11,Hung Hom,0,0,0,0,0,0,0,0,Saturday
2021-09-11,Lo Wu,0,0,0,0,0,0,0,0,Saturday
2021-09-11,Lok Ma Chau Spur Line,0,0,0,0,0,0,0,0,Saturday
2021-09-11,Heung Yuen Wai,0,0,0,0,0,0,0,0,Saturday
2021-09-11,Hong Kong-Zhuhai-Macao Bridge,101,8,4,113,121,6,3,130,Saturday
2021-09-11,Lok Ma Chau,0,0,0,0,0,0,0,0,Saturday
2021-09-11,Man Kam To,0,0,0,0,0,0,0,0,Saturday
2021-09-11,Sha Tau Kok,0,0,0,0,0,0,0,0,Saturday
2021-09-11,Shenzhen Bay,1178,121,3,1302,709,84,8,801,Saturday
2021-09-11,China Ferry Terminal,0,0,0,0,0,0,0,0,Saturday
2021-09-11,Harbour Control,0,0,0,0,0,0,0,0,Saturday
2021-09-11,Kai Tak Cruise Terminal,0,0,0,0,0,0,0,0,Saturday
2021-09-11,Macau Ferry Terminal,0,0,0,0,0,0,0,0,Saturday
2021-09-11,Tuen Mun Ferry Terminal,0,0,0,0,0,0,0,0,Saturday
2021-09-11,Total,2084,142,39,2265,2500,117,40,2657,Saturday
2021-09-10,Airport,932,8,60,1000,1586,12,49,1647,Friday
2021-09-10,Express Rail Link West Kowloon,0,0,0,0,0,0,0,0,Friday
2021-09-10,Hung Hom,0,0,0,0,0,0,0,0,Friday
2021-09-10,Lo Wu,0,0,0,0,0,0,0,0,Friday
2021-09-10,Lok Ma Chau Spur Line,0,0,0,0,0,0,0,0,Friday
2021-09-10,Heung Yuen Wai,0,0,0,0,0,0,0,0,Friday
2021-09-10,Hong Kong-Zhuhai-Macao Bridge,151,4,1,156,214,13,3,230,Friday
2021-11-27,Lo Wu,0,0,0,0,0,0,0,0,Saturday
2021-09-10,Lok Ma Chau,0,0,0,0,0,0,0,0,Friday
2021-09-10,Man Kam To,0,0,0,0,0,0,0,0,Friday
2021-09-10,Sha Tau Kok,0,0,0,0,0,0,0,0,Friday
2021-09-10,Shenzhen Bay,1247,120,0,1367,726,86,6,818,Friday
2021-09-10,China Ferry Terminal,0,0,0,0,0,0,0,0,Friday
2021-09-10,Harbour Control,0,0,0,0,0,0,0,0,Friday
2021-09-10,Kai Tak Cruise Terminal,1308,0,0,1308,1471,0,0,1471,Friday
2021-09-10,Macau Ferry Terminal,0,0,0,0,0,0,0,0,Friday
2021-09-10,Tuen Mun Ferry Terminal,0,0,0,0,0,0,0,0,Friday
2021-09-10,Total,3638,132,61,3831,3997,111,58,4166,Friday
2021-09-13,Airport,470,5,27,502,857,1,22,880,Monday
2021-09-13,Express Rail Link West Kowloon,0,0,0,0,0,0,0,0,Monday
2021-09-13,Hung Hom,0,0,0,0,0,0,0,0,Monday
2021-09-13,Lo Wu,0,0,0,0,0,0,0,0,Monday
2021-09-13,Lok Ma Chau Spur Line,0,0,0,0,0,0,0,0,Monday
2021-09-13,Heung Yuen Wai,0,0,0,0,0,0,0,0,Monday
2021-09-13,Hong Kong-Zhuhai-Macao Bridge,129,1,2,132,174,17,5,196,Monday
2021-09-13,Lok Ma Chau,0,0,0,0,0,0,0,0,Monday
2021-09-13,Man Kam To,0,0,0,0,0,0,0,0,Monday
2021-09-13,Sha Tau Kok,0,0,0,0,0,0,0,0,Monday
2021-09-13,Shenzhen Bay,976,62,3,1041,506,92,1,599,Monday
2021-09-13,China Ferry Terminal,0,0,0,0,0,0,0,0,Monday
2021-09-13,Harbour Control,0,0,0,0,0,0,0,0,Monday
2021-09-13,Kai Tak Cruise Terminal,0,0,0,0,0,0,0,0,Monday
2021-09-13,Macau Ferry Terminal,0,0,0,0,0,0,0,0,Monday
2021-09-13,Tuen Mun Ferry Terminal,0,0,0,0,0,0,0,0,Monday
2021-09-13,Total,1575,68,32,1675,1537,110,28,1675,Monday
2021-09-12,Airport,880,7,37,924,1462,18,44,1524,Sunday
2021-09-12,Express Rail Link West Kowloon,0,0,0,0,0,0,0,0,Sunday
2021-09-12,Hung Hom,0,0,0,0,0,0,0,0,Sunday
2021-09-12,Lo Wu,0,0,0,0,0,0,0,0,Sunday
2021-09-12,Lok Ma Chau Spur Line,0,0,0,0,0,0,0,0,Sunday
2021-09-12,Heung Yuen Wai,0,0,0,0,0,0,0,0,Sunday
2021-09-12,Hong Kong-Zhuhai-Macao Bridge,136,4,1,141,152,9,0,161,Sunday
2021-09-12,Lok Ma Chau,0,0,0,0,0,0,0,0,Sunday
2021-09-12,Man Kam To,0,0,0,0,0,0,0,0,Sunday
2021-09-12,Sha Tau Kok,0,0,0,0,0,0,0,0,Sunday
2021-09-12,Shenzhen Bay,1323,95,1,1419,416,87,3,506,Sunday
2021-09-12,China Ferry Terminal,0,0,0,0,0,0,0,0,Sunday
2021-09-12,Harbour Control,0,0,0,0,0,0,0,0,Sunday
2021-09-12,Kai Tak Cruise Terminal,1471,0,0,1471,980,0,0,980,Sunday
2021-09-12,Macau Ferry Terminal,0,0,0,0,0,0,0,0,Sunday
2021-09-12,Tuen Mun Ferry Terminal,0,0,0,0,0,0,0,0,Sunday
2021-09-12,Total,3810,106,39,3955,3010,114,47,3171,Sunday
2021-09-14,Airport,837,8,42,887,1249,17,50,1316,Tuesday
2021-09-14,Express Rail Link West Kowloon,0,0,0,0,0,0,0,0,Tuesday
2021-09-14,Hung Hom,0,0,0,0,0,0,0,0,Tuesday
2021-09-14,Lo Wu,0,0,0,0,0,0,0,0,Tuesday
2021-09-14,Lok Ma Chau Spur Line,0,0,0,0,0,0,0,0,Tuesday
2021-09-14,Heung Yuen Wai,0,0,0,0,0,0,0,0,Tuesday
2021-09-14,Hong Kong-Zhuhai-Macao Bridge,134,1,1,136,176,8,2,186,Tuesday
2021-09-14,Lok Ma Chau,0,0,0,0,0,0,0,0,Tuesday
2021-09-14,Man Kam To,0,0,0,0,0,0,0,0,Tuesday
2021-09-14,Sha Tau Kok,0,0,0,0,0,0,0,0,Tuesday
2021-09-14,Shenzhen Bay,927,45,1,973,605,92,8,705,Tuesday
2021-09-14,China Ferry Terminal,0,0,0,0,0,0,0,0,Tuesday
2021-09-14,Harbour Control,0,0,0,0,0,0,0,0,Tuesday
2021-09-14,Kai Tak Cruise Terminal,0,0,0,0,0,0,0,0,Tuesday
2021-09-14,Macau Ferry Terminal,0,0,0,0,0,0,0,0,Tuesday
2021-09-14,Tuen Mun Ferry Terminal,0,0,0,0,0,0,0,0,Tuesday
2021-09-14,Total,1898,54,44,1996,2030,117,60,2207,Tuesday
2021-09-15,Airport,530,4,28,562,1570,25,36,1631,Wednesday
2021-09-15,Express Rail Link West Kowloon,0,0,0,0,0,0,0,0,Wednesday
2021-09-15,Hung Hom,0,0,0,0,0,0,0,0,Wednesday
2021-09-15,Lo Wu,0,0,0,0,0,0,0,0,Wednesday
2021-09-15,Lok Ma Chau Spur Line,0,0,0,0,0,0,0,0,Wednesday
2021-09-15,Heung Yuen Wai,0,0,0,0,0,0,0,0,Wednesday
2021-09-15,Hong Kong-Zhuhai-Macao Bridge,169,20,18,207,241,11,10,262,Wednesday
2021-09-15,Lok Ma Chau,0,0,0,0,0,0,0,0,Wednesday
2021-09-15,Man Kam To,0,0,0,0,0,0,0,0,Wednesday
2021-09-15,Sha Tau Kok,0,0,0,0,0,0,0,0,Wednesday
2021-09-15,Shenzhen Bay,1404,255,7,1666,679,82,1,762,Wednesday
2021-09-15,China Ferry Terminal,0,0,0,0,0,0,0,0,Wednesday
2021-09-15,Harbour Control,0,0,0,0,0,0,0,0,Wednesday
2021-09-15,Kai Tak Cruise Terminal,980,0,0,980,1541,0,0,1541,Wednesday
2021-09-15,Macau Ferry Terminal,0,0,0,0,0,0,0,0,Wednesday
2021-09-15,Tuen Mun Ferry Terminal,0,0,0,0,0,0,0,0,Wednesday
2021-09-15,Total,3083,279,53,3415,4031,118,47,4196,Wednesday
2021-09-16,Airport,839,12,34,885,1380,14,33,1427,Thursday
2021-09-16,Express Rail Link West Kowloon,0,0,0,0,0,0,0,0,Thursday
2021-09-16,Hung Hom,0,0,0,0,0,0,0,0,Thursday
2021-09-16,Lo Wu,0,0,0,0,0,0,0,0,Thursday
2021-09-16,Lok Ma Chau Spur Line,0,0,0,0,0,0,0,0,Thursday
2021-09-16,Heung Yuen Wai,0,0,0,0,0,0,0,0,Thursday
2021-09-16,Hong Kong-Zhuhai-Macao Bridge,168,16,19,203,174,7,4,185,Thursday
2021-09-16,Lok Ma Chau,0,0,0,0,0,0,0,0,Thursday
2021-09-16,Man Kam To,0,0,0,0,0,0,0,0,Thursday
2021-09-16,Sha Tau Kok,0,0,0,0,0,0,0,0,Thursday
2021-09-16,Shenzhen Bay,1236,236,14,1486,638,77,9,724,Thursday
2021-09-16,China Ferry Terminal,0,0,0,0,0,0,0,0,Thursday
2021-09-16,Harbour Control,0,0,0,0,0,0,0,0,Thursday
2021-09-16,Kai Tak Cruise Terminal,0,0,0,0,0,0,0,0,Thursday
2021-09-16,Macau Ferry Terminal,0,0,0,0,0,0,0,0,Thursday
2021-09-16,Tuen Mun Ferry Terminal,0,0,0,0,0,0,0,0,Thursday
2021-09-16,Total,2243,264,67,2574,2192,98,46,2336,Thursday
2021-09-17,Airport,734,8,22,764,1890,12,46,1948,Friday
2021-09-17,Express Rail Link West Kowloon,0,0,0,0,0,0,0,0,Friday
2021-09-17,Hung Hom,0,0,0,0,0,0,0,0,Friday
2021-09-17,Lo Wu,0,0,0,0,0,0,0,0,Friday
2021-09-17,Lok Ma Chau Spur Line,0,0,0,0,0,0,0,0,Friday
2021-09-17,Heung Yuen Wai,0,0,0,0,0,0,0,0,Friday
2021-09-17,Hong Kong-Zhuhai-Macao Bridge,160,13,18,191,180,13,8,201,Friday
2021-09-17,Lok Ma Chau,0,0,0,0,0,0,0,0,Friday
2021-09-17,Man Kam To,0,0,0,0,0,0,0,0,Friday
2021-09-17,Sha Tau Kok,0,0,0,0,0,0,0,0,Friday
2021-09-17,Shenzhen Bay,1338,254,9,1601,620,74,4,698,Friday
2021-09-17,China Ferry Terminal,0,0,0,0,0,0,0,0,Friday
2021-09-17,Harbour Control,0,0,0,0,0,0,0,0,Friday
2021-09-17,Kai Tak Cruise Terminal,1541,0,0,1541,1518,0,0,1518,Friday
2021-09-17,Macau Ferry Terminal,0,0,0,0,0,0,0,0,Friday
2021-09-17,Tuen Mun Ferry Terminal,0,0,0,0,0,0,0,0,Friday
2021-09-17,Total,3773,275,49,4097,4208,99,58,4365,Friday
2021-09-18,Airport,933,17,35,985,1770,30,34,1834,Saturday
2021-09-18,Express Rail Link West Kowloon,0,0,0,0,0,0,0,0,Saturday
2021-09-18,Hung Hom,0,0,0,0,0,0,0,0,Saturday
2021-09-18,Lo Wu,0,0,0,0,0,0,0,0,Saturday
2021-09-18,Lok Ma Chau Spur Line,0,0,0,0,0,0,0,0,Saturday
2021-09-18,Heung Yuen Wai,0,0,0,0,0,0,0,0,Saturday
2021-09-18,Hong Kong-Zhuhai-Macao Bridge,180,18,15,213,166,9,3,178,Saturday
2021-09-18,Lok Ma Chau,0,0,0,0,0,0,0,0,Saturday
2021-09-18,Man Kam To,0,0,0,0,0,0,0,0,Saturday
2021-09-18,Sha Tau Kok,0,0,0,0,0,0,0,0,Saturday
2021-09-18,Shenzhen Bay,1717,301,10,2028,739,88,3,830,Saturday
2021-09-18,China Ferry Terminal,0,0,0,0,0,0,0,0,Saturday
2021-09-18,Harbour Control,0,0,0,0,0,0,0,0,Saturday
2021-09-18,Kai Tak Cruise Terminal,0,0,0,0,0,0,0,0,Saturday
2021-09-18,Macau Ferry Terminal,0,0,0,0,0,0,0,0,Saturday
2021-09-18,Tuen Mun Ferry Terminal,0,0,0,0,0,0,0,0,Saturday
2021-09-18,Total,2830,336,60,3226,2675,127,40,2842,Saturday
2021-09-19,Airport,906,9,24,939,1340,28,33,1401,Sunday
2021-09-19,Express Rail Link West Kowloon,0,0,0,0,0,0,0,0,Sunday
2021-09-19,Hung Hom,0,0,0,0,0,0,0,0,Sunday
2021-09-19,Lo Wu,0,0,0,0,0,0,0,0,Sunday
2021-09-19,Lok Ma Chau Spur Line,0,0,0,0,0,0,0,0,Sunday
2021-09-19,Heung Yuen Wai,0,0,0,0,0,0,0,0,Sunday
2021-09-19,Hong Kong-Zhuhai-Macao Bridge,147,32,13,192,136,9,5,150,Sunday
2021-09-19,Lok Ma Chau,0,0,0,0,0,0,0,0,Sunday
2021-09-19,Man Kam To,0,0,0,0,0,0,0,0,Sunday
2021-09-19,Sha Tau Kok,0,0,0,0,0,0,0,0,Sunday
2021-09-19,Shenzhen Bay,1282,287,11,1580,394,62,0,456,Sunday
2021-09-19,China Ferry Terminal,0,0,0,0,0,0,0,0,Sunday
2021-09-19,Harbour Control,0,0,0,0,0,0,0,0,Sunday
2021-09-19,Kai Tak Cruise Terminal,1518,0,0,1518,1297,0,0,1297,Sunday
2021-09-19,Macau Ferry Terminal,0,0,0,0,0,0,0,0,Sunday
2021-09-19,Tuen Mun Ferry Terminal,0,0,0,0,0,0,0,0,Sunday
2021-09-19,Total,3853,328,48,4229,3167,99,38,3304,Sunday
2021-09-20,Airport,541,14,16,571,783,26,25,834,Monday
2021-09-20,Express Rail Link West Kowloon,0,0,0,0,0,0,0,0,Monday
2021-09-20,Hung Hom,0,0,0,0,0,0,0,0,Monday
2021-09-20,Lo Wu,0,0,0,0,0,0,0,0,Monday
2021-09-20,Lok Ma Chau Spur Line,0,0,0,0,0,0,0,0,Monday
2021-09-20,Heung Yuen Wai,0,0,0,0,0,0,0,0,Monday
2021-09-20,Hong Kong-Zhuhai-Macao Bridge,137,29,12,178,114,8,5,127,Monday
2021-09-20,Lok Ma Chau,0,0,0,0,0,0,0,0,Monday
2021-09-20,Man Kam To,0,0,0,0,0,0,0,0,Monday
2021-09-20,Sha Tau Kok,0,0,0,0,0,0,0,0,Monday
2021-09-20,Shenzhen Bay,884,184,5,1073,367,57,3,427,Monday
2021-09-20,China Ferry Terminal,0,0,0,0,0,0,0,0,Monday
2021-09-20,Harbour Control,0,0,0,0,0,0,0,0,Monday
2021-09-20,Kai Tak Cruise Terminal,0,0,0,0,0,0,0,0,Monday
2021-09-20,Macau Ferry Terminal,0,0,0,0,0,0,0,0,Monday
2021-09-20,Tuen Mun Ferry Terminal,0,0,0,0,0,0,0,0,Monday
2021-09-20,Total,1562,227,33,1822,1264,91,33,1388,Monday
2021-09-21,Airport,899,3,31,933,1060,24,33,1117,Tuesday
2021-09-21,Express Rail Link West Kowloon,0,0,0,0,0,0,0,0,Tuesday
2021-09-21,Hung Hom,0,0,0,0,0,0,0,0,Tuesday
2021-09-21,Lo Wu,0,0,0,0,0,0,0,0,Tuesday
2021-09-21,Lok Ma Chau Spur Line,0,0,0,0,0,0,0,0,Tuesday
2021-09-21,Heung Yuen Wai,0,0,0,0,0,0,0,0,Tuesday
2021-09-21,Hong Kong-Zhuhai-Macao Bridge,99,8,14,121,87,8,2,97,Tuesday
2021-09-21,Lok Ma Chau,0,0,0,0,0,0,0,0,Tuesday
2021-09-21,Man Kam To,0,0,0,0,0,0,0,0,Tuesday
2021-09-21,Sha Tau Kok,0,0,0,0,0,0,0,0,Tuesday
2021-09-21,Shenzhen Bay,427,114,5,546,370,57,1,428,Tuesday
2021-09-21,China Ferry Terminal,0,0,0,0,0,0,0,0,Tuesday
2021-09-21,Harbour Control,0,0,0,0,0,0,0,0,Tuesday
2021-09-21,Kai Tak Cruise Terminal,0,0,0,0,0,0,0,0,Tuesday
2021-09-21,Macau Ferry Terminal,0,0,0,0,0,0,0,0,Tuesday
2021-09-21,Tuen Mun Ferry Terminal,0,0,0,0,0,0,0,0,Tuesday
2021-09-21,Total,1425,125,50,1600,1517,89,36,1642,Tuesday
2021-09-22,Airport,679,14,34,727,1476,26,39,1541,Wednesday
2021-09-22,Express Rail Link West Kowloon,0,0,0,0,0,0,0,0,Wednesday
2021-09-22,Hung Hom,0,0,0,0,0,0,0,0,Wednesday
2021-09-22,Lo Wu,0,0,0,0,0,0,0,0,Wednesday
2021-09-22,Lok Ma Chau Spur Line,0,0,0,0,0,0,0,0,Wednesday
2021-09-22,Heung Yuen Wai,0,0,0,0,0,0,0,0,Wednesday
2021-09-22,Hong Kong-Zhuhai-Macao Bridge,112,14,15,141,248,21,7,276,Wednesday
2021-09-22,Lok Ma Chau,0,0,0,0,0,0,0,0,Wednesday
2021-09-22,Man Kam To,0,0,0,0,0,0,0,0,Wednesday
2021-09-22,Sha Tau Kok,0,0,0,0,0,0,0,0,Wednesday
2021-09-22,Shenzhen Bay,945,202,8,1155,798,148,2,948,Wednesday
2021-09-22,China Ferry Terminal,0,0,0,0,0,0,0,0,Wednesday
2021-09-22,Harbour Control,0,0,0,0,0,0,0,0,Wednesday
2021-09-22,Kai Tak Cruise Terminal,1297,0,0,1297,1464,0,0,1464,Wednesday
2021-09-22,Macau Ferry Terminal,0,0,0,0,0,0,0,0,Wednesday
2021-09-22,Tuen Mun Ferry Terminal,0,0,0,0,0,0,0,0,Wednesday
2021-09-22,Total,3033,230,57,3320,3986,195,48,4229,Wednesday
2021-09-23,Airport,763,9,32,804,1407,38,38,1483,Thursday
2021-09-23,Express Rail Link West Kowloon,0,0,0,0,0,0,0,0,Thursday
2021-09-23,Hung Hom,0,0,0,0,0,0,0,0,Thursday
2021-09-23,Lo Wu,0,0,0,0,0,0,0,0,Thursday
2021-09-23,Lok Ma Chau Spur Line,0,0,0,0,0,0,0,0,Thursday
2021-09-23,Heung Yuen Wai,0,0,0,0,0,0,0,0,Thursday
2021-09-23,Hong Kong-Zhuhai-Macao Bridge,129,15,22,166,314,14,2,330,Thursday
2021-09-23,Lok Ma Chau,0,0,0,0,0,0,0,0,Thursday
2021-09-23,Man Kam To,0,0,0,0,0,0,0,0,Thursday
2021-09-23,Sha Tau Kok,0,0,0,0,0,0,0,0,Thursday
2021-09-23,Shenzhen Bay,1087,193,12,1292,779,117,1,897,Thursday
2021-09-23,China Ferry Terminal,0,0,0,0,0,0,0,0,Thursday
2021-09-23,Harbour Control,0,0,0,0,0,0,0,0,Thursday
2021-09-23,Kai Tak Cruise Terminal,0,0,0,0,0,0,0,0,Thursday
2021-09-23,Macau Ferry Terminal,0,0,0,0,0,0,0,0,Thursday
2021-09-23,Tuen Mun Ferry Terminal,0,0,0,0,0,0,0,0,Thursday
2021-09-23,Total,1979,217,66,2262,2500,169,41,2710,Thursday
2021-09-24,Airport,971,6,39,1016,1773,55,55,1883,Friday
2021-09-24,Express Rail Link West Kowloon,0,0,0,0,0,0,0,0,Friday
2021-09-24,Hung Hom,0,0,0,0,0,0,0,0,Friday
2021-09-24,Lo Wu,0,0,0,0,0,0,0,0,Friday
2021-09-24,Lok Ma Chau Spur Line,0,0,0,0,0,0,0,0,Friday
2021-09-24,Heung Yuen Wai,0,0,0,0,0,0,0,0,Friday
2021-09-24,Hong Kong-Zhuhai-Macao Bridge,127,20,8,155,225,13,6,244,Friday
2021-09-24,Lok Ma Chau,0,0,0,0,0,0,0,0,Friday
2021-09-24,Man Kam To,0,0,0,0,0,0,0,0,Friday
2021-09-24,Sha Tau Kok,0,0,0,0,0,0,0,0,Friday
2021-09-24,Shenzhen Bay,1175,217,7,1399,866,132,4,1002,Friday
2021-09-24,China Ferry Terminal,0,0,0,0,0,0,0,0,Friday
2021-09-24,Harbour Control,0,0,0,0,0,0,0,0,Friday
2021-09-24,Kai Tak Cruise Terminal,1464,0,0,1464,1634,0,0,1634,Friday
2021-09-24,Macau Ferry Terminal,0,0,0,0,0,0,0,0,Friday
2021-09-24,Tuen Mun Ferry Terminal,0,0,0,0,0,0,0,0,Friday
2021-09-24,Total,3737,243,54,4034,4498,200,65,4763,Friday
2021-09-25,Airport,766,24,16,806,1375,41,39,1455,Saturday
2021-09-25,Express Rail Link West Kowloon,0,0,0,0,0,0,0,0,Saturday
2021-09-25,Hung Hom,0,0,0,0,0,0,0,0,Saturday
2021-09-25,Lo Wu,0,0,0,0,0,0,0,0,Saturday
2021-09-25,Lok Ma Chau Spur Line,0,0,0,0,0,0,0,0,Saturday
2021-09-25,Heung Yuen Wai,0,0,0,0,0,0,0,0,Saturday
2021-09-25,Hong Kong-Zhuhai-Macao Bridge,156,20,43,219,212,19,7,238,Saturday
2021-09-25,Lok Ma Chau,0,0,0,0,0,0,0,0,Saturday
2021-09-25,Man Kam To,0,0,0,0,0,0,0,0,Saturday
2021-09-25,Sha Tau Kok,0,0,0,0,0,0,0,0,Saturday
2021-09-25,Shenzhen Bay,1145,236,11,1392,989,117,1,1107,Saturday
2021-09-25,China Ferry Terminal,0,0,0,0,0,0,0,0,Saturday
2021-09-25,Harbour Control,0,0,0,0,0,0,0,0,Saturday
2021-09-25,Kai Tak Cruise Terminal,0,0,0,0,0,0,0,0,Saturday
2021-09-25,Macau Ferry Terminal,0,0,0,0,0,0,0,0,Saturday
2021-09-25,Tuen Mun Ferry Terminal,0,0,0,0,0,0,0,0,Saturday
2021-09-25,Total,2067,280,70,2417,2576,177,47,2800,Saturday
2021-09-26,Airport,930,15,33,978,1625,67,40,1732,Sunday
2021-09-26,Express Rail Link West Kowloon,0,0,0,0,0,0,0,0,Sunday
2021-09-26,Hung Hom,0,0,0,0,0,0,0,0,Sunday
2021-09-26,Lo Wu,0,0,0,0,0,0,0,0,Sunday
2021-09-26,Lok Ma Chau Spur Line,0,0,0,0,0,0,0,0,Sunday
2021-09-26,Heung Yuen Wai,0,0,0,0,0,0,0,0,Sunday
2021-09-26,Hong Kong-Zhuhai-Macao Bridge,130,22,7,159,149,23,6,178,Sunday
2021-09-26,Lok Ma Chau,0,0,0,0,0,0,0,0,Sunday
2021-09-26,Man Kam To,0,0,0,0,0,0,0,0,Sunday
2021-09-26,Sha Tau Kok,0,0,0,0,0,0,0,0,Sunday
2021-09-26,Shenzhen Bay,1264,201,13,1478,665,119,9,793,Sunday
2021-09-26,China Ferry Terminal,0,0,0,0,0,0,0,0,Sunday
2021-09-26,Harbour Control,0,0,0,0,0,0,0,0,Sunday
2021-09-26,Kai Tak Cruise Terminal,1634,0,0,1634,1548,0,0,1548,Sunday
2021-09-26,Macau Ferry Terminal,0,0,0,0,0,0,0,0,Sunday
2021-09-26,Tuen Mun Ferry Terminal,0,0,0,0,0,0,0,0,Sunday
2021-09-26,Total,3958,238,53,4249,3987,209,55,4251,Sunday
2021-09-27,Airport,507,9,21,537,875,25,21,921,Monday
2021-09-27,Express Rail Link West Kowloon,0,0,0,0,0,0,0,0,Monday
2021-09-27,Hung Hom,0,0,0,0,0,0,0,0,Monday
2021-09-27,Lo Wu,0,0,0,0,0,0,0,0,Monday
2021-09-27,Lok Ma Chau Spur Line,0,0,0,0,0,0,0,0,Monday
2021-09-27,Heung Yuen Wai,0,0,0,0,0,0,0,0,Monday
2021-09-27,Hong Kong-Zhuhai-Macao Bridge,102,15,4,121,213,15,3,231,Monday
2021-09-27,Lok Ma Chau,0,0,0,0,0,0,0,0,Monday
2021-09-27,Man Kam To,0,0,0,0,0,0,0,0,Monday
2021-09-27,Sha Tau Kok,0,0,0,0,0,0,0,0,Monday
2021-09-27,Shenzhen Bay,995,138,12,1145,669,94,5,768,Monday
2021-09-27,China Ferry Terminal,0,0,0,0,0,0,0,0,Monday
2021-09-27,Harbour Control,0,0,0,0,0,0,0,0,Monday
2021-09-27,Kai Tak Cruise Terminal,0,0,0,0,0,0,0,0,Monday
2021-09-27,Macau Ferry Terminal,0,0,0,0,0,0,0,0,Monday
2021-12-19,Hung Hom,0,0,0,0,0,0,0,0,Sunday
2021-09-27,Tuen Mun Ferry Terminal,0,0,0,0,0,0,0,0,Monday
2021-09-27,Total,1604,162,37,1803,1757,134,29,1920,Monday
2021-09-28,Airport,1077,6,37,1120,1570,38,50,1658,Tuesday
2021-09-28,Express Rail Link West Kowloon,0,0,0,0,0,0,0,0,Tuesday
2021-09-28,Hung Hom,0,0,0,0,0,0,0,0,Tuesday
2021-09-28,Lo Wu,0,0,0,0,0,0,0,0,Tuesday
2021-09-28,Lok Ma Chau Spur Line,0,0,0,0,0,0,0,0,Tuesday
2021-09-28,Heung Yuen Wai,0,0,0,0,0,0,0,0,Tuesday
2021-09-28,Hong Kong-Zhuhai-Macao Bridge,102,17,8,127,199,10,2,211,Tuesday
2021-09-28,Lok Ma Chau,0,0,0,0,0,0,0,0,Tuesday
2021-09-28,Man Kam To,0,0,0,0,0,0,0,0,Tuesday
2021-09-28,Sha Tau Kok,0,0,0,0,0,0,0,0,Tuesday
2021-09-28,Shenzhen Bay,1060,216,15,1291,733,114,5,852,Tuesday
2021-09-28,China Ferry Terminal,0,0,0,0,0,0,0,0,Tuesday
2021-09-28,Harbour Control,0,0,0,0,0,0,0,0,Tuesday
2021-09-28,Kai Tak Cruise Terminal,0,0,0,0,0,0,0,0,Tuesday
2021-09-28,Macau Ferry Terminal,0,0,0,0,0,0,0,0,Tuesday
2021-09-28,Tuen Mun Ferry Terminal,0,0,0,0,0,0,0,0,Tuesday
2021-09-28,Total,2239,239,60,2538,2502,162,57,2721,Tuesday
2021-09-29,Airport,731,13,30,774,1424,54,40,1518,Wednesday
2021-09-29,Express Rail Link West Kowloon,0,0,0,0,0,0,0,0,Wednesday
2021-09-29,Hung Hom,0,0,0,0,0,0,0,0,Wednesday
2021-09-29,Lo Wu,0,0,0,0,0,0,0,0,Wednesday
2021-09-29,Lok Ma Chau Spur Line,0,0,0,0,0,0,0,0,Wednesday
2021-09-29,Heung Yuen Wai,0,0,0,0,0,0,0,0,Wednesday
2021-09-29,Hong Kong-Zhuhai-Macao Bridge,137,27,4,168,193,8,3,204,Wednesday
2021-09-29,Lok Ma Chau,0,0,0,0,0,0,0,0,Wednesday
2021-09-29,Man Kam To,0,0,0,0,0,0,0,0,Wednesday
2021-09-29,Sha Tau Kok,0,0,0,0,0,0,0,0,Wednesday
2021-09-29,Shenzhen Bay,1213,233,10,1456,751,112,5,868,Wednesday
2021-09-29,China Ferry Terminal,0,0,0,0,0,0,0,0,Wednesday
2021-09-29,Harbour Control,0,0,0,0,0,0,0,0,Wednesday
2021-09-29,Kai Tak Cruise Terminal,1548,0,0,1548,1617,0,0,1617,Wednesday
2021-09-29,Macau Ferry Terminal,0,0,0,0,0,0,0,0,Wednesday
2021-09-29,Tuen Mun Ferry Terminal,0,0,0,0,0,0,0,0,Wednesday
2021-09-29,Total,3629,273,44,3946,3985,174,48,4207,Wednesday
2021-09-30,Airport,880,15,40,935,1285,30,36,1351,Thursday
2021-09-30,Express Rail Link West Kowloon,0,0,0,0,0,0,0,0,Thursday
2021-09-30,Hung Hom,0,0,0,0,0,0,0,0,Thursday
2021-09-30,Lo Wu,0,0,0,0,0,0,0,0,Thursday
2021-09-30,Lok Ma Chau Spur Line,0,0,0,0,0,0,0,0,Thursday
2021-09-30,Heung Yuen Wai,0,0,0,0,0,0,0,0,Thursday
2021-09-30,Hong Kong-Zhuhai-Macao Bridge,167,27,5,199,201,9,8,218,Thursday
2021-09-30,Lok Ma Chau,0,0,0,0,0,0,0,0,Thursday
2021-09-30,Man Kam To,0,0,0,0,0,0,0,0,Thursday
2021-09-30,Sha Tau Kok,0,0,0,0,0,0,0,0,Thursday
2021-09-30,Shenzhen Bay,1553,234,16,1803,766,91,5,862,Thursday
2021-09-30,China Ferry Terminal,0,0,0,0,0,0,0,0,Thursday
2021-09-30,Harbour Control,0,0,0,0,0,0,0,0,Thursday
2021-09-30,Kai Tak Cruise Terminal,0,0,0,0,0,0,0,0,Thursday
2021-09-30,Macau Ferry Terminal,0,0,0,0,0,0,0,0,Thursday
2021-09-30,Tuen Mun Ferry Terminal,0,0,0,0,0,0,0,0,Thursday
2021-09-30,Total,2600,276,61,2937,2252,130,49,2431,Thursday
2021-10-01,Airport,1001,8,35,1044,1554,27,49,1630,Friday
2021-10-01,Express Rail Link West Kowloon,0,0,0,0,0,0,0,0,Friday
2021-10-01,Hung Hom,0,0,0,0,0,0,0,0,Friday
2021-10-01,Lo Wu,0,0,0,0,0,0,0,0,Friday
2021-10-01,Lok Ma Chau Spur Line,0,0,0,0,0,0,0,0,Friday
2021-10-01,Heung Yuen Wai,0,0,0,0,0,0,0,0,Friday
2021-10-01,Hong Kong-Zhuhai-Macao Bridge,74,9,5,88,144,9,2,155,Friday
2021-10-01,Lok Ma Chau,0,0,0,0,0,0,0,0,Friday
2021-10-01,Man Kam To,0,0,0,0,0,0,0,0,Friday
2021-10-01,Sha Tau Kok,0,0,0,0,0,0,0,0,Friday
2021-10-01,Shenzhen Bay,831,145,10,986,616,83,3,702,Friday
2021-10-01,China Ferry Terminal,0,0,0,0,0,0,0,0,Friday
2021-10-01,Harbour Control,0,0,0,0,0,0,0,0,Friday
2021-10-01,Kai Tak Cruise Terminal,1617,0,0,1617,1667,0,0,1667,Friday
2021-10-01,Macau Ferry Terminal,0,0,0,0,0,0,0,0,Friday
2021-10-01,Tuen Mun Ferry Terminal,0,0,0,0,0,0,0,0,Friday
2021-10-01,Total,3523,162,50,3735,3981,119,54,4154,Friday
2021-10-02,Airport,738,13,49,800,1544,40,24,1608,Saturday
2021-10-02,Express Rail Link West Kowloon,0,0,0,0,0,0,0,0,Saturday
2021-10-02,Hung Hom,0,0,0,0,0,0,0,0,Saturday
2021-10-02,Lo Wu,0,0,0,0,0,0,0,0,Saturday
2021-10-02,Lok Ma Chau Spur Line,0,0,0,0,0,0,0,0,Saturday
2021-10-02,Heung Yuen Wai,0,0,0,0,0,0,0,0,Saturday
2021-10-02,Hong Kong-Zhuhai-Macao Bridge,53,14,1,68,148,11,7,166,Saturday
2021-10-02,Lok Ma Chau,0,0,0,0,0,0,0,0,Saturday
2021-10-02,Man Kam To,0,0,0,0,0,0,0,0,Saturday
2021-10-02,Sha Tau Kok,0,0,0,0,0,0,0,0,Saturday
2021-10-02,Shenzhen Bay,684,200,9,893,708,105,5,818,Saturday
2021-10-02,China Ferry Terminal,0,0,0,0,0,0,0,0,Saturday
2021-10-02,Harbour Control,0,0,0,0,0,0,0,0,Saturday
2021-10-02,Kai Tak Cruise Terminal,0,0,0,0,0,0,0,0,Saturday
2021-10-02,Macau Ferry Terminal,0,0,0,0,0,0,0,0,Saturday
2021-10-02,Tuen Mun Ferry Terminal,0,0,0,0,0,0,0,0,Saturday
2021-10-02,Total,1475,227,59,1761,2400,156,36,2592,Saturday
2021-10-03,Airport,1046,6,36,1088,1558,41,45,1644,Sunday
2021-10-03,Express Rail Link West Kowloon,0,0,0,0,0,0,0,0,Sunday
2021-10-03,Hung Hom,0,0,0,0,0,0,0,0,Sunday
2021-10-03,Lo Wu,0,0,0,0,0,0,0,0,Sunday
2021-10-03,Lok Ma Chau Spur Line,0,0,0,0,0,0,0,0,Sunday
2021-10-03,Heung Yuen Wai,0,0,0,0,0,0,0,0,Sunday
2021-10-03,Hong Kong-Zhuhai-Macao Bridge,101,15,5,121,166,20,8,194,Sunday
2021-10-03,Lok Ma Chau,0,0,0,0,0,0,0,0,Sunday
2021-10-03,Man Kam To,0,0,0,0,0,0,0,0,Sunday
2021-10-03,Sha Tau Kok,0,0,0,0,0,0,0,0,Sunday
2021-10-03,Shenzhen Bay,1004,211,14,1229,638,90,1,729,Sunday
2021-10-03,China Ferry Terminal,0,0,0,0,0,0,0,0,Sunday
2021-10-03,Harbour Control,0,0,0,0,0,0,0,0,Sunday
2021-10-03,Kai Tak Cruise Terminal,1667,0,0,1667,1482,0,0,1482,Sunday
2021-10-03,Macau Ferry Terminal,0,0,0,0,0,0,0,0,Sunday
2021-10-03,Tuen Mun Ferry Terminal,0,0,0,0,0,0,0,0,Sunday
2021-10-03,Total,3818,232,55,4105,3844,151,54,4049,Sunday
2021-10-04,Airport,573,10,27,610,560,18,24,602,Monday
2021-10-04,Express Rail Link West Kowloon,0,0,0,0,0,0,0,0,Monday
2021-10-04,Hung Hom,0,0,0,0,0,0,0,0,Monday
2021-10-04,Lo Wu,0,0,0,0,0,0,0,0,Monday
2021-10-04,Lok Ma Chau Spur Line,0,0,0,0,0,0,0,0,Monday
2021-10-04,Heung Yuen Wai,0,0,0,0,0,0,0,0,Monday
2021-10-04,Hong Kong-Zhuhai-Macao Bridge,84,16,9,109,225,14,5,244,Monday
2021-10-04,Lok Ma Chau,0,0,0,0,0,0,0,0,Monday
2021-10-04,Man Kam To,0,0,0,0,0,0,0,0,Monday
2021-10-04,Sha Tau Kok,0,0,0,0,0,0,0,0,Monday
2021-10-04,Shenzhen Bay,694,155,14,863,808,101,2,911,Monday
2021-10-04,China Ferry Terminal,0,0,0,0,0,0,0,0,Monday
2021-10-04,Harbour Control,0,0,0,0,0,0,0,0,Monday
2021-10-04,Kai Tak Cruise Terminal,0,0,0,0,0,0,0,0,Monday
2021-10-04,Macau Ferry Terminal,0,0,0,0,0,0,0,0,Monday
2021-10-04,Tuen Mun Ferry Terminal,0,0,0,0,0,0,0,0,Monday
2021-10-04,Total,1351,181,50,1582,1593,133,31,1757,Monday
2021-10-05,Airport,402,3,24,429,951,5,25,981,Tuesday
2021-10-05,Express Rail Link West Kowloon,0,0,0,0,0,0,0,0,Tuesday
2021-10-05,Hung Hom,0,0,0,0,0,0,0,0,Tuesday
2021-10-05,Lo Wu,0,0,0,0,0,0,0,0,Tuesday
2021-10-05,Lok Ma Chau Spur Line,0,0,0,0,0,0,0,0,Tuesday
2021-10-05,Heung Yuen Wai,0,0,0,0,0,0,0,0,Tuesday
2021-10-05,Hong Kong-Zhuhai-Macao Bridge,79,6,11,96,201,20,0,221,Tuesday
2021-10-05,Lok Ma Chau,0,0,0,0,0,0,0,0,Tuesday
2021-10-05,Man Kam To,0,0,0,0,0,0,0,0,Tuesday
2021-10-05,Sha Tau Kok,0,0,0,0,0,0,0,0,Tuesday
2021-10-05,Shenzhen Bay,749,101,6,856,838,120,3,961,Tuesday
2021-10-05,China Ferry Terminal,0,0,0,0,0,0,0,0,Tuesday
2021-10-05,Harbour Control,0,0,0,0,0,0,0,0,Tuesday
2021-10-05,Kai Tak Cruise Terminal,0,0,0,0,0,0,0,0,Tuesday
2021-10-05,Macau Ferry Terminal,0,0,0,0,0,0,0,0,Tuesday
2021-10-05,Tuen Mun Ferry Terminal,0,0,0,0,0,0,0,0,Tuesday
2021-10-05,Total,1230,110,41,1381,1990,145,28,2163,Tuesday
2021-10-06,Airport,970,8,32,1010,1346,39,39,1424,Wednesday
2021-10-06,Express Rail Link West Kowloon,0,0,0,0,0,0,0,0,Wednesday
2021-10-06,Hung Hom,0,0,0,0,0,0,0,0,Wednesday
2021-10-06,Lo Wu,0,0,0,0,0,0,0,0,Wednesday
2021-10-06,Lok Ma Chau Spur Line,0,0,0,0,0,0,0,0,Wednesday
2021-10-06,Heung Yuen Wai,0,0,0,0,0,0,0,0,Wednesday
2021-10-06,Hong Kong-Zhuhai-Macao Bridge,119,6,4,129,167,7,3,177,Wednesday
2021-10-06,Lok Ma Chau,0,0,0,0,0,0,0,0,Wednesday
2021-10-06,Man Kam To,0,0,0,0,0,0,0,0,Wednesday
2021-10-06,Sha Tau Kok,0,0,0,0,0,0,0,0,Wednesday
2021-10-06,Shenzhen Bay,666,137,13,816,836,101,3,940,Wednesday
2021-10-06,China Ferry Terminal,0,0,0,0,0,0,0,0,Wednesday
2021-10-06,Harbour Control,0,0,0,0,0,0,0,0,Wednesday
2021-10-06,Kai Tak Cruise Terminal,1482,0,0,1482,1574,0,0,1574,Wednesday
2021-10-06,Macau Ferry Terminal,0,0,0,0,0,0,0,0,Wednesday
2021-10-06,Tuen Mun Ferry Terminal,0,0,0,0,0,0,0,0,Wednesday
2021-10-06,Total,3237,151,49,3437,3923,147,45,4115,Wednesday
2021-10-07,Airport,701,2,30,733,682,25,23,730,Thursday
2021-10-07,Express Rail Link West Kowloon,0,0,0,0,0,0,0,0,Thursday
2021-10-07,Hung Hom,0,0,0,0,0,0,0,0,Thursday
2021-10-07,Lo Wu,0,0,0,0,0,0,0,0,Thursday
2021-10-07,Lok Ma Chau Spur Line,0,0,0,0,0,0,0,0,Thursday
2021-10-07,Heung Yuen Wai,0,0,0,0,0,0,0,0,Thursday
2021-10-07,Hong Kong-Zhuhai-Macao Bridge,75,11,3,89,167,12,1,180,Thursday
2021-10-07,Lok Ma Chau,0,0,0,0,0,0,0,0,Thursday
2021-10-07,Man Kam To,0,0,0,0,0,0,0,0,Thursday
2021-10-07,Sha Tau Kok,0,0,0,0,0,0,0,0,Thursday
2021-10-07,Shenzhen Bay,573,119,5,697,757,110,1,868,Thursday
2021-10-07,China Ferry Terminal,0,0,0,0,0,0,0,0,Thursday
2021-10-07,Harbour Control,0,0,0,0,0,0,0,0,Thursday
2021-10-07,Kai Tak Cruise Terminal,0,0,0,0,0,0,0,0,Thursday
2021-10-07,Macau Ferry Terminal,0,0,0,0,0,0,0,0,Thursday
2021-10-07,Tuen Mun Ferry Terminal,0,0,0,0,0,0,0,0,Thursday
2021-10-07,Total,1349,132,38,1519,1606,147,25,1778,Thursday
2021-10-08,Airport,671,13,37,721,1235,37,45,1317,Friday
2021-10-08,Express Rail Link West Kowloon,0,0,0,0,0,0,0,0,Friday
2021-10-08,Hung Hom,0,0,0,0,0,0,0,0,Friday
2021-10-08,Lo Wu,0,0,0,0,0,0,0,0,Friday
2021-10-08,Lok Ma Chau Spur Line,0,0,0,0,0,0,0,0,Friday
2021-10-08,Heung Yuen Wai,0,0,0,0,0,0,0,0,Friday
2021-10-08,Hong Kong-Zhuhai-Macao Bridge,116,8,7,131,180,13,13,206,Friday
2021-10-08,Lok Ma Chau,0,0,0,0,0,0,0,0,Friday
2021-10-08,Man Kam To,0,0,0,0,0,0,0,0,Friday
2021-10-08,Sha Tau Kok,0,0,0,0,0,0,0,0,Friday
2021-10-08,Shenzhen Bay,736,149,12,897,968,123,4,1095,Friday
2021-10-08,China Ferry Terminal,0,0,0,0,0,0,0,0,Friday
2021-10-08,Harbour Control,0,0,0,0,0,0,0,0,Friday
2021-10-08,Kai Tak Cruise Terminal,1574,0,0,1574,1591,0,0,1591,Friday
2021-10-08,Macau Ferry Terminal,0,0,0,0,0,0,0,0,Friday
2021-10-08,Tuen Mun Ferry Terminal,0,0,0,0,0,0,0,0,Friday
2021-10-08,Total,3097,170,56,3323,3974,173,62,4209,Friday
2021-10-09,Airport,418,9,35,462,731,76,37,844,Saturday
2021-10-09,Express Rail Link West Kowloon,0,0,0,0,0,0,0,0,Saturday
2021-10-09,Hung Hom,0,0,0,0,0,0,0,0,Saturday
2021-10-09,Lo Wu,0,0,0,0,0,0,0,0,Saturday
2021-10-09,Lok Ma Chau Spur Line,0,0,0,0,0,0,0,0,Saturday
2021-10-09,Heung Yuen Wai,0,0,0,0,0,0,0,0,Saturday
2021-10-09,Hong Kong-Zhuhai-Macao Bridge,0,0,0,0,0,0,0,0,Saturday
2021-10-09,Lok Ma Chau,0,0,0,0,0,0,0,0,Saturday
2021-10-09,Man Kam To,0,0,0,0,0,0,0,0,Saturday
2021-10-09,Sha Tau Kok,0,0,0,0,0,0,0,0,Saturday
2021-10-09,Shenzhen Bay,668,223,8,899,427,56,3,486,Saturday
2021-10-09,China Ferry Terminal,0,0,0,0,0,0,0,0,Saturday
2021-10-09,Harbour Control,0,0,0,0,0,0,0,0,Saturday
2021-10-09,Kai Tak Cruise Terminal,0,0,0,0,0,0,0,0,Saturday
2021-10-09,Macau Ferry Terminal,0,0,0,0,0,0,0,0,Saturday
2021-10-09,Tuen Mun Ferry Terminal,0,0,0,0,0,0,0,0,Saturday
2021-10-09,Total,1086,232,43,1361,1158,132,40,1330,Saturday
2021-10-10,Airport,1299,10,65,1374,1381,40,49,1470,Sunday
2021-10-10,Express Rail Link West Kowloon,0,0,0,0,0,0,0,0,Sunday
2021-10-10,Hung Hom,0,0,0,0,0,0,0,0,Sunday
2021-10-10,Lo Wu,0,0,0,0,0,0,0,0,Sunday
2021-10-10,Lok Ma Chau Spur Line,0,0,0,0,0,0,0,0,Sunday
2021-10-10,Heung Yuen Wai,0,0,0,0,0,0,0,0,Sunday
2021-10-10,Hong Kong-Zhuhai-Macao Bridge,169,29,5,203,57,1,1,59,Sunday
2021-10-10,Lok Ma Chau,0,0,0,0,0,0,0,0,Sunday
2021-10-10,Man Kam To,0,0,0,0,0,0,0,0,Sunday
2021-10-10,Sha Tau Kok,0,0,0,0,0,0,0,0,Sunday
2021-10-10,Shenzhen Bay,1238,240,7,1485,177,13,0,190,Sunday
2021-10-10,China Ferry Terminal,0,0,0,0,0,0,0,0,Sunday
2021-10-10,Harbour Control,0,0,0,0,0,0,0,0,Sunday
2021-10-10,Kai Tak Cruise Terminal,1591,0,0,1591,1611,0,0,1611,Sunday
2021-10-10,Macau Ferry Terminal,0,0,0,0,0,0,0,0,Sunday
2021-10-10,Tuen Mun Ferry Terminal,0,0,0,0,0,0,0,0,Sunday
2021-10-10,Total,4297,279,77,4653,3226,54,50,3330,Sunday
2021-10-11,Airport,499,3,25,527,827,22,20,869,Monday
2021-10-11,Express Rail Link West Kowloon,0,0,0,0,0,0,0,0,Monday
2021-10-11,Hung Hom,0,0,0,0,0,0,0,0,Monday
2021-10-11,Lo Wu,0,0,0,0,0,0,0,0,Monday
2021-10-11,Lok Ma Chau Spur Line,0,0,0,0,0,0,0,0,Monday
2021-10-11,Heung Yuen Wai,0,0,0,0,0,0,0,0,Monday
2021-10-11,Hong Kong-Zhuhai-Macao Bridge,123,15,8,146,301,20,10,331,Monday
2021-10-11,Lok Ma Chau,0,0,0,0,0,0,0,0,Monday
2021-10-11,Man Kam To,0,0,0,0,0,0,0,0,Monday
2021-10-11,Sha Tau Kok,0,0,0,0,0,0,0,0,Monday
2021-10-11,Shenzhen Bay,890,153,6,1049,1693,208,9,1910,Monday
2021-10-11,China Ferry Terminal,0,0,0,0,0,0,0,0,Monday
2021-10-11,Harbour Control,0,0,0,0,0,0,0,0,Monday
2021-10-11,Kai Tak Cruise Terminal,0,0,0,0,0,0,0,0,Monday
2021-10-11,Macau Ferry Terminal,0,0,0,0,0,0,0,0,Monday
2021-10-11,Tuen Mun Ferry Terminal,0,0,0,0,0,0,0,0,Monday
2021-10-11,Total,1512,171,39,1722,2821,250,39,3110,Monday
2021-10-12,Airport,312,5,19,336,510,48,18,576,Tuesday
2021-10-12,Express Rail Link West Kowloon,0,0,0,0,0,0,0,0,Tuesday
2021-10-12,Hung Hom,0,0,0,0,0,0,0,0,Tuesday
2021-10-12,Lo Wu,0,0,0,0,0,0,0,0,Tuesday
2021-10-12,Lok Ma Chau Spur Line,0,0,0,0,0,0,0,0,Tuesday
2021-10-12,Heung Yuen Wai,0,0,0,0,0,0,0,0,Tuesday
2021-10-12,Hong Kong-Zhuhai-Macao Bridge,110,8,5,123,200,15,3,218,Tuesday
2021-10-12,Lok Ma Chau,0,0,0,0,0,0,0,0,Tuesday
2021-10-12,Man Kam To,0,0,0,0,0,0,0,0,Tuesday
2021-10-12,Sha Tau Kok,0,0,0,0,0,0,0,0,Tuesday
2021-10-12,Shenzhen Bay,897,206,8,1111,1049,164,4,1217,Tuesday
2021-10-12,China Ferry Terminal,0,0,0,0,0,0,0,0,Tuesday
2021-10-12,Harbour Control,0,0,0,0,0,0,0,0,Tuesday
2021-10-12,Kai Tak Cruise Terminal,0,0,0,0,0,0,0,0,Tuesday
2021-10-12,Macau Ferry Terminal,0,0,0,0,0,0,0,0,Tuesday
2021-10-12,Tuen Mun Ferry Terminal,0,0,0,0,0,0,0,0,Tuesday
2021-10-12,Total,1319,219,32,1570,1759,227,25,2011,Tuesday
2021-10-13,Airport,839,6,40,885,1151,142,48,1341,Wednesday
2021-10-13,Express Rail Link West Kowloon,0,0,0,0,0,0,0,0,Wednesday
2021-10-13,Hung Hom,0,0,0,0,0,0,0,0,Wednesday
2021-10-13,Lo Wu,0,0,0,0,0,0,0,0,Wednesday
2021-10-13,Lok Ma Chau Spur Line,0,0,0,0,0,0,0,0,Wednesday
2021-10-13,Heung Yuen Wai,0,0,0,0,0,0,0,0,Wednesday
2021-10-13,Hong Kong-Zhuhai-Macao Bridge,0,0,0,0,0,0,0,0,Wednesday
2021-10-13,Lok Ma Chau,0,0,0,0,0,0,0,0,Wednesday
2021-10-13,Man Kam To,0,0,0,0,0,0,0,0,Wednesday
2021-10-13,Sha Tau Kok,0,0,0,0,0,0,0,0,Wednesday
2021-10-13,Shenzhen Bay,459,206,23,688,239,43,1,283,Wednesday
2021-10-13,China Ferry Terminal,0,0,0,0,0,0,0,0,Wednesday
2021-10-13,Harbour Control,0,0,0,0,0,0,0,0,Wednesday
2021-10-13,Kai Tak Cruise Terminal,1611,0,0,1611,1178,0,0,1178,Wednesday
2021-10-13,Macau Ferry Terminal,0,0,0,0,0,0,0,0,Wednesday
2021-10-13,Tuen Mun Ferry Terminal,0,0,0,0,0,0,0,0,Wednesday
2021-10-13,Total,2909,212,63,3184,2568,185,49,2802,Wednesday
2021-10-14,Airport,870,12,63,945,1358,33,40,1431,Thursday
2021-10-14,Express Rail Link West Kowloon,0,0,0,0,0,0,0,0,Thursday
2021-10-14,Hung Hom,0,0,0,0,0,0,0,0,Thursday
2021-10-14,Lo Wu,0,0,0,0,0,0,0,0,Thursday
2021-10-14,Lok Ma Chau Spur Line,0,0,0,0,0,0,0,0,Thursday
2021-10-14,Heung Yuen Wai,0,0,0,0,0,0,0,0,Thursday
2021-10-14,Hong Kong-Zhuhai-Macao Bridge,85,18,4,107,54,4,2,60,Thursday
2021-10-14,Lok Ma Chau,0,0,0,0,0,0,0,0,Thursday
2021-10-14,Man Kam To,0,0,0,0,0,0,0,0,Thursday
2021-10-14,Sha Tau Kok,0,0,0,0,0,0,0,0,Thursday
2021-10-14,Shenzhen Bay,662,203,8,873,140,39,0,179,Thursday
2021-10-14,China Ferry Terminal,0,0,0,0,0,0,0,0,Thursday
2021-10-14,Harbour Control,0,0,0,0,0,0,0,0,Thursday
2021-10-14,Kai Tak Cruise Terminal,0,0,0,0,1843,0,0,1843,Thursday
2021-10-14,Macau Ferry Terminal,0,0,0,0,0,0,0,0,Thursday
2021-10-14,Tuen Mun Ferry Terminal,0,0,0,0,0,0,0,0,Thursday
2021-10-14,Total,1617,233,75,1925,3395,76,42,3513,Thursday
2021-10-15,Airport,827,6,34,867,1374,23,30,1427,Friday
2021-10-15,Express Rail Link West Kowloon,0,0,0,0,0,0,0,0,Friday
2021-10-15,Hung Hom,0,0,0,0,0,0,0,0,Friday
2021-10-15,Lo Wu,0,0,0,0,0,0,0,0,Friday
2021-10-15,Lok Ma Chau Spur Line,0,0,0,0,0,0,0,0,Friday
2021-10-15,Heung Yuen Wai,0,0,0,0,0,0,0,0,Friday
2021-10-15,Hong Kong-Zhuhai-Macao Bridge,129,11,8,148,261,21,4,286,Friday
2021-10-15,Lok Ma Chau,0,0,0,0,0,0,0,0,Friday
2021-10-15,Man Kam To,0,0,0,0,0,0,0,0,Friday
2021-10-15,Sha Tau Kok,0,0,0,0,0,0,0,0,Friday
2021-10-15,Shenzhen Bay,1021,188,3,1212,928,147,4,1079,Friday
2021-10-15,China Ferry Terminal,0,0,0,0,0,0,0,0,Friday
2021-10-15,Harbour Control,0,0,0,0,0,0,0,0,Friday
2021-10-15,Kai Tak Cruise Terminal,1178,0,0,1178,1669,0,0,1669,Friday
2021-10-15,Macau Ferry Terminal,0,0,0,0,0,0,0,0,Friday
2021-10-15,Tuen Mun Ferry Terminal,0,0,0,0,0,0,0,0,Friday
2021-10-15,Total,3155,205,45,3405,4232,191,38,4461,Friday
2021-10-16,Airport,769,10,43,822,1016,29,26,1071,Saturday
2021-10-16,Express Rail Link West Kowloon,0,0,0,0,0,0,0,0,Saturday
2021-10-16,Hung Hom,0,0,0,0,0,0,0,0,Saturday
2021-10-16,Lo Wu,0,0,0,0,0,0,0,0,Saturday
2021-10-16,Lok Ma Chau Spur Line,0,0,0,0,0,0,0,0,Saturday
2021-10-16,Heung Yuen Wai,0,0,0,0,0,0,0,0,Saturday
2021-10-16,Hong Kong-Zhuhai-Macao Bridge,132,14,5,151,218,14,6,238,Saturday
2021-10-16,Lok Ma Chau,0,0,0,0,0,0,0,0,Saturday
2021-10-16,Man Kam To,0,0,0,0,0,0,0,0,Saturday
2021-10-16,Sha Tau Kok,0,0,0,0,0,0,0,0,Saturday
2021-10-16,Shenzhen Bay,1025,187,8,1220,1008,145,2,1155,Saturday
2021-10-16,China Ferry Terminal,0,0,0,0,0,0,0,0,Saturday
2021-10-16,Harbour Control,0,0,0,0,0,0,0,0,Saturday
2021-10-16,Kai Tak Cruise Terminal,0,0,0,0,0,0,0,0,Saturday
2021-10-16,Macau Ferry Terminal,0,0,0,0,0,0,0,0,Saturday
2021-10-16,Tuen Mun Ferry Terminal,0,0,0,0,0,0,0,0,Saturday
2021-10-16,Total,1926,211,56,2193,2242,188,34,2464,Saturday
2021-10-17,Airport,1307,17,55,1379,1484,45,54,1583,Sunday
2021-10-17,Express Rail Link West Kowloon,0,0,0,0,0,0,0,0,Sunday
2021-10-17,Hung Hom,0,0,0,0,0,0,0,0,Sunday
2021-10-17,Lo Wu,0,0,0,0,0,0,0,0,Sunday
2021-10-17,Lok Ma Chau Spur Line,0,0,0,0,0,0,0,0,Sunday
2021-10-17,Heung Yuen Wai,0,0,0,0,0,0,0,0,Sunday
2021-10-17,Hong Kong-Zhuhai-Macao Bridge,103,20,4,127,301,26,2,329,Sunday
2021-10-17,Lok Ma Chau,0,0,0,0,0,0,0,0,Sunday
2021-10-17,Man Kam To,0,0,0,0,0,0,0,0,Sunday
2021-10-17,Sha Tau Kok,0,0,0,0,0,0,0,0,Sunday
2021-10-17,Shenzhen Bay,1127,221,12,1360,727,95,2,824,Sunday
2021-10-17,China Ferry Terminal,0,0,0,0,0,0,0,0,Sunday
2021-10-17,Harbour Control,0,0,0,0,0,0,0,0,Sunday
2021-10-17,Kai Tak Cruise Terminal,3512,0,0,3512,2900,0,0,2900,Sunday
2021-10-17,Macau Ferry Terminal,0,0,0,0,0,0,0,0,Sunday
2021-10-17,Tuen Mun Ferry Terminal,0,0,0,0,0,0,0,0,Sunday
2021-10-17,Total,6049,258,71,6378,5412,166,58,5636,Sunday
2021-10-19,Airport,409,3,22,434,804,9,36,849,Tuesday
2021-10-19,Express Rail Link West Kowloon,0,0,0,0,0,0,0,0,Tuesday
2021-10-19,Hung Hom,0,0,0,0,0,0,0,0,Tuesday
2021-10-19,Lo Wu,0,0,0,0,0,0,0,0,Tuesday
2021-10-19,Lok Ma Chau Spur Line,0,0,0,0,0,0,0,0,Tuesday
2021-10-19,Heung Yuen Wai,0,0,0,0,0,0,0,0,Tuesday
2021-10-19,Hong Kong-Zhuhai-Macao Bridge,175,8,3,186,187,24,8,219,Tuesday
2021-10-19,Lok Ma Chau,0,0,0,0,0,0,0,0,Tuesday
2021-10-19,Man Kam To,0,0,0,0,0,0,0,0,Tuesday
2021-10-19,Sha Tau Kok,0,0,0,0,0,0,0,0,Tuesday
2021-10-19,Shenzhen Bay,860,165,13,1038,840,127,4,971,Tuesday
2021-10-19,China Ferry Terminal,0,0,0,0,0,0,0,0,Tuesday
2021-10-19,Harbour Control,0,0,0,0,0,0,0,0,Tuesday
2021-10-19,Kai Tak Cruise Terminal,0,0,0,0,0,0,0,0,Tuesday
2021-10-19,Macau Ferry Terminal,0,0,0,0,0,0,0,0,Tuesday
2021-10-19,Tuen Mun Ferry Terminal,0,0,0,0,0,0,0,0,Tuesday
2021-10-19,Total,1444,176,38,1658,1831,160,48,2039,Tuesday
2021-10-18,Airport,512,5,31,548,584,6,18,608,Monday
2021-10-18,Express Rail Link West Kowloon,0,0,0,0,0,0,0,0,Monday
2021-10-18,Hung Hom,0,0,0,0,0,0,0,0,Monday
2021-10-18,Lo Wu,0,0,0,0,0,0,0,0,Monday
2021-10-18,Lok Ma Chau Spur Line,0,0,0,0,0,0,0,0,Monday
2021-10-18,Heung Yuen Wai,0,0,0,0,0,0,0,0,Monday
2021-10-18,Hong Kong-Zhuhai-Macao Bridge,91,10,9,110,200,17,9,226,Monday
2021-10-18,Lok Ma Chau,0,0,0,0,0,0,0,0,Monday
2021-10-18,Man Kam To,0,0,0,0,0,0,0,0,Monday
2021-10-18,Sha Tau Kok,0,0,0,0,0,0,0,0,Monday
2021-10-18,Shenzhen Bay,918,176,12,1106,792,100,2,894,Monday
2021-10-18,China Ferry Terminal,0,0,0,0,0,0,0,0,Monday
2021-10-18,Harbour Control,0,0,0,0,0,0,0,0,Monday
2021-10-18,Kai Tak Cruise Terminal,0,0,0,0,0,0,0,0,Monday
2021-10-18,Macau Ferry Terminal,0,0,0,0,0,0,0,0,Monday
2021-10-18,Tuen Mun Ferry Terminal,0,0,0,0,0,0,0,0,Monday
2021-10-18,Total,1521,191,52,1764,1576,123,29,1728,Monday
2021-10-20,Airport,785,8,48,841,1163,36,39,1238,Wednesday
2021-10-20,Express Rail Link West Kowloon,0,0,0,0,0,0,0,0,Wednesday
2021-10-20,Hung Hom,0,0,0,0,0,0,0,0,Wednesday
2021-10-20,Lo Wu,0,0,0,0,0,0,0,0,Wednesday
2021-10-20,Lok Ma Chau Spur Line,0,0,0,0,0,0,0,0,Wednesday
2021-10-20,Heung Yuen Wai,0,0,0,0,0,0,0,0,Wednesday
2021-10-20,Hong Kong-Zhuhai-Macao Bridge,128,9,10,147,198,11,5,214,Wednesday
2021-10-20,Lok Ma Chau,0,0,0,0,0,0,0,0,Wednesday
2021-10-20,Man Kam To,0,0,0,0,0,0,0,0,Wednesday
2021-10-20,Sha Tau Kok,0,0,0,0,0,0,0,0,Wednesday
2021-10-20,Shenzhen Bay,1046,176,12,1234,739,105,2,846,Wednesday
2021-10-20,China Ferry Terminal,0,0,0,0,0,0,0,0,Wednesday
2021-10-20,Harbour Control,0,0,0,0,0,0,0,0,Wednesday
2021-10-20,Kai Tak Cruise Terminal,1590,0,0,1590,1655,0,0,1655,Wednesday
2021-10-20,Macau Ferry Terminal,0,0,0,0,0,0,0,0,Wednesday
2021-10-20,Tuen Mun Ferry Terminal,0,0,0,0,0,0,0,0,Wednesday
2021-10-20,Total,3549,193,70,3812,3755,152,46,3953,Wednesday
2021-10-21,Airport,539,5,24,568,603,18,33,654,Thursday
2021-10-21,Express Rail Link West Kowloon,0,0,0,0,0,0,0,0,Thursday
2021-10-21,Hung Hom,0,0,0,0,0,0,0,0,Thursday
2021-10-21,Lo Wu,0,0,0,0,0,0,0,0,Thursday
2021-10-21,Lok Ma Chau Spur Line,0,0,0,0,0,0,0,0,Thursday
2021-10-21,Heung Yuen Wai,0,0,0,0,0,0,0,0,Thursday
2021-10-21,Hong Kong-Zhuhai-Macao Bridge,73,11,4,88,202,16,2,220,Thursday
2021-10-21,Lok Ma Chau,0,0,0,0,0,0,0,0,Thursday
2021-10-21,Man Kam To,0,0,0,0,0,0,0,0,Thursday
2021-10-21,Sha Tau Kok,0,0,0,0,0,0,0,0,Thursday
2021-10-21,Shenzhen Bay,712,149,8,869,748,100,0,848,Thursday
2021-10-21,China Ferry Terminal,0,0,0,0,0,0,0,0,Thursday
2021-10-21,Harbour Control,0,0,0,0,0,0,0,0,Thursday
2021-10-21,Kai Tak Cruise Terminal,1310,0,0,1310,0,0,0,0,Thursday
2021-10-21,Macau Ferry Terminal,0,0,0,0,0,0,0,0,Thursday
2021-10-21,Tuen Mun Ferry Terminal,0,0,0,0,0,0,0,0,Thursday
2021-10-21,Total,2634,165,36,2835,1553,134,35,1722,Thursday
2021-10-22,Airport,1019,5,43,1067,965,23,22,1010,Friday
2021-10-22,Express Rail Link West Kowloon,0,0,0,0,0,0,0,0,Friday
2021-10-22,Hung Hom,0,0,0,0,0,0,0,0,Friday
2021-10-22,Lo Wu,0,0,0,0,0,0,0,0,Friday
2021-10-22,Lok Ma Chau Spur Line,0,0,0,0,0,0,0,0,Friday
2021-10-22,Heung Yuen Wai,0,0,0,0,0,0,0,0,Friday
2021-10-22,Hong Kong-Zhuhai-Macao Bridge,77,16,2,95,193,19,5,217,Friday
2021-10-22,Lok Ma Chau,0,0,0,0,0,0,0,0,Friday
2021-10-22,Man Kam To,0,0,0,0,0,0,0,0,Friday
2021-10-22,Sha Tau Kok,0,0,0,0,0,0,0,0,Friday
2021-10-22,Shenzhen Bay,819,164,7,990,653,110,2,765,Friday
2021-10-22,China Ferry Terminal,0,0,0,0,0,0,0,0,Friday
2021-10-22,Harbour Control,0,0,0,0,0,0,0,0,Friday
2021-10-22,Kai Tak Cruise Terminal,1655,0,0,1655,1665,0,0,1665,Friday
2021-10-22,Macau Ferry Terminal,0,0,0,0,0,0,0,0,Friday
2021-10-22,Tuen Mun Ferry Terminal,0,0,0,0,0,0,0,0,Friday
2021-10-22,Total,3570,185,52,3807,3476,152,29,3657,Friday
2021-10-23,Airport,656,14,45,715,689,20,26,735,Saturday
2021-10-23,Express Rail Link West Kowloon,0,0,0,0,0,0,0,0,Saturday
2021-10-23,Hung Hom,0,0,0,0,0,0,0,0,Saturday
2021-10-23,Lo Wu,0,0,0,0,0,0,0,0,Saturday
2021-10-23,Lok Ma Chau Spur Line,0,0,0,0,0,0,0,0,Saturday
2021-10-23,Heung Yuen Wai,0,0,0,0,0,0,0,0,Saturday
2021-10-23,Hong Kong-Zhuhai-Macao Bridge,70,15,6,91,130,10,5,145,Saturday
2021-10-23,Lok Ma Chau,0,0,0,0,0,0,0,0,Saturday
2021-10-23,Man Kam To,0,0,0,0,0,0,0,0,Saturday
2021-10-23,Sha Tau Kok,0,0,0,0,0,0,0,0,Saturday
2021-10-23,Shenzhen Bay,752,173,11,936,549,79,5,633,Saturday
2021-10-23,China Ferry Terminal,0,0,0,0,0,0,0,0,Saturday
2021-10-23,Harbour Control,0,0,0,0,0,0,0,0,Saturday
2021-10-23,Kai Tak Cruise Terminal,0,0,0,0,0,0,0,0,Saturday
2021-10-23,Macau Ferry Terminal,0,0,0,0,0,0,0,0,Saturday
2021-10-23,Tuen Mun Ferry Terminal,0,0,0,0,0,0,0,0,Saturday
2021-10-23,Total,1478,202,62,1742,1368,109,36,1513,Saturday
2021-10-24,Airport,1340,7,55,1402,1171,20,55,1246,Sunday
2021-10-24,Express Rail Link West Kowloon,0,0,0,0,0,0,0,0,Sunday
2021-10-24,Hung Hom,0,0,0,0,0,0,0,0,Sunday
2021-10-24,Lo Wu,0,0,0,0,0,0,0,0,Sunday
2021-10-24,Lok Ma Chau Spur Line,0,0,0,0,0,0,0,0,Sunday
2021-10-24,Heung Yuen Wai,0,0,0,0,0,0,0,0,Sunday
2021-10-24,Hong Kong-Zhuhai-Macao Bridge,86,14,5,105,95,19,12,126,Sunday
2021-10-24,Lok Ma Chau,0,0,0,0,0,0,0,0,Sunday
2021-10-24,Man Kam To,0,0,0,0,0,0,0,0,Sunday
2021-10-24,Sha Tau Kok,0,0,0,0,0,0,0,0,Sunday
2021-10-24,Shenzhen Bay,968,241,11,1220,435,92,6,533,Sunday
2021-10-24,China Ferry Terminal,0,0,0,0,0,0,0,0,Sunday
2021-10-24,Harbour Control,0,0,0,0,0,0,0,0,Sunday
2021-10-24,Kai Tak Cruise Terminal,1665,0,0,1665,1643,0,0,1643,Sunday
2021-10-24,Macau Ferry Terminal,0,0,0,0,0,0,0,0,Sunday
2021-10-24,Tuen Mun Ferry Terminal,0,0,0,0,0,0,0,0,Sunday
2021-10-24,Total,4059,262,71,4392,3344,131,73,3548,Sunday
2021-10-26,Airport,327,3,26,356,886,31,38,955,Tuesday
2021-10-26,Express Rail Link West Kowloon,0,0,0,0,0,0,0,0,Tuesday
2021-10-26,Hung Hom,0,0,0,0,0,0,0,0,Tuesday
2021-10-26,Lo Wu,0,0,0,0,0,0,0,0,Tuesday
2021-10-26,Lok Ma Chau Spur Line,0,0,0,0,0,0,0,0,Tuesday
2021-10-26,Heung Yuen Wai,0,0,0,0,0,0,0,0,Tuesday
2021-10-26,Hong Kong-Zhuhai-Macao Bridge,95,7,5,107,182,16,4,202,Tuesday
2021-10-26,Lok Ma Chau,0,0,0,0,0,0,0,0,Tuesday
2021-10-26,Man Kam To,0,0,0,0,0,0,0,0,Tuesday
2021-10-26,Sha Tau Kok,0,0,0,0,0,0,0,0,Tuesday
2021-10-26,Shenzhen Bay,1032,202,18,1252,668,125,7,800,Tuesday
2021-10-26,China Ferry Terminal,0,0,0,0,0,0,0,0,Tuesday
2021-10-26,Harbour Control,0,0,0,0,0,0,0,0,Tuesday
2021-10-26,Kai Tak Cruise Terminal,0,0,0,0,0,0,0,0,Tuesday
2021-10-26,Macau Ferry Terminal,0,0,0,0,0,0,0,0,Tuesday
2021-10-26,Tuen Mun Ferry Terminal,0,0,0,0,0,0,0,0,Tuesday
2021-10-26,Total,1454,212,49,1715,1736,172,49,1957,Tuesday
2021-10-25,Airport,560,20,45,625,564,12,28,604,Monday
2021-10-25,Express Rail Link West Kowloon,0,0,0,0,0,0,0,0,Monday
2021-10-25,Hung Hom,0,0,0,0,0,0,0,0,Monday
2021-10-25,Lo Wu,0,0,0,0,0,0,0,0,Monday
2021-10-25,Lok Ma Chau Spur Line,0,0,0,0,0,0,0,0,Monday
2021-10-25,Heung Yuen Wai,0,0,0,0,0,0,0,0,Monday
2021-10-25,Hong Kong-Zhuhai-Macao Bridge,104,9,6,119,175,19,3,197,Monday
2021-10-25,Lok Ma Chau,0,0,0,0,0,0,0,0,Monday
2021-10-25,Man Kam To,0,0,0,0,0,0,0,0,Monday
2021-10-25,Sha Tau Kok,0,0,0,0,0,0,0,0,Monday
2021-10-25,Shenzhen Bay,833,176,17,1026,670,98,2,770,Monday
2021-10-25,China Ferry Terminal,0,0,0,0,0,0,0,0,Monday
2021-10-25,Harbour Control,0,0,0,0,0,0,0,0,Monday
2021-10-25,Kai Tak Cruise Terminal,0,0,0,0,0,0,0,0,Monday
2021-10-25,Macau Ferry Terminal,0,0,0,0,0,0,0,0,Monday
2021-10-25,Tuen Mun Ferry Terminal,0,0,0,0,0,0,0,0,Monday
2021-10-25,Total,1497,205,68,1770,1409,129,33,1571,Monday
2021-10-27,Airport,1187,12,46,1245,882,26,40,948,Wednesday
2021-10-27,Express Rail Link West Kowloon,0,0,0,0,0,0,0,0,Wednesday
2021-10-27,Hung Hom,0,0,0,0,0,0,0,0,Wednesday
2021-10-27,Lo Wu,0,0,0,0,0,0,0,0,Wednesday
2021-10-27,Lok Ma Chau Spur Line,0,0,0,0,0,0,0,0,Wednesday
2021-10-27,Heung Yuen Wai,0,0,0,0,0,0,0,0,Wednesday
2021-10-27,Hong Kong-Zhuhai-Macao Bridge,76,14,3,93,139,19,7,165,Wednesday
2021-10-27,Lok Ma Chau,0,0,0,0,0,0,0,0,Wednesday
2021-10-27,Man Kam To,0,0,0,0,0,0,0,0,Wednesday
2021-10-27,Sha Tau Kok,0,0,0,0,0,0,0,0,Wednesday
2021-10-27,Shenzhen Bay,972,188,3,1163,638,109,3,750,Wednesday
2021-10-27,China Ferry Terminal,0,0,0,0,0,0,0,0,Wednesday
2021-10-27,Harbour Control,0,0,0,0,0,0,0,0,Wednesday
2021-10-27,Kai Tak Cruise Terminal,1643,0,0,1643,1656,0,0,1656,Wednesday
2021-10-27,Macau Ferry Terminal,0,0,0,0,0,0,0,0,Wednesday
2021-10-27,Tuen Mun Ferry Terminal,0,0,0,0,0,0,0,0,Wednesday
2021-10-27,Total,3878,214,52,4144,3315,154,50,3519,Wednesday
2021-10-28,Airport,483,9,35,527,614,7,26,647,Thursday
2021-10-28,Express Rail Link West Kowloon,0,0,0,0,0,0,0,0,Thursday
2021-10-28,Hung Hom,0,0,0,0,0,0,0,0,Thursday
2021-10-28,Lo Wu,0,0,0,0,0,0,0,0,Thursday
2021-10-28,Lok Ma Chau Spur Line,0,0,0,0,0,0,0,0,Thursday
2021-10-28,Heung Yuen Wai,0,0,0,0,0,0,0,0,Thursday
2021-10-28,Hong Kong-Zhuhai-Macao Bridge,81,11,6,98,137,11,7,155,Thursday
2021-10-28,Lok Ma Chau,0,0,0,0,0,0,0,0,Thursday
2021-10-28,Man Kam To,0,0,0,0,0,0,0,0,Thursday
2021-10-28,Sha Tau Kok,0,0,0,0,0,0,0,0,Thursday
2021-10-28,Shenzhen Bay,884,132,9,1025,602,99,4,705,Thursday
2021-10-28,China Ferry Terminal,0,0,0,0,0,0,0,0,Thursday
2021-10-28,Harbour Control,0,0,0,0,0,0,0,0,Thursday
2021-10-28,Kai Tak Cruise Terminal,0,0,0,0,0,0,0,0,Thursday
2021-10-28,Macau Ferry Terminal,0,0,0,0,0,0,0,0,Thursday
2021-10-28,Tuen Mun Ferry Terminal,0,0,0,0,0,0,0,0,Thursday
2021-10-28,Total,1448,152,50,1650,1353,117,37,1507,Thursday
2021-10-29,Airport,831,8,39,878,1011,19,58,1088,Friday
2021-10-29,Express Rail Link West Kowloon,0,0,0,0,0,0,0,0,Friday
2021-10-29,Hung Hom,0,0,0,0,0,0,0,0,Friday
2021-10-29,Lo Wu,0,0,0,0,0,0,0,0,Friday
2021-10-29,Lok Ma Chau Spur Line,0,0,0,0,0,0,0,0,Friday
2021-10-29,Heung Yuen Wai,0,0,0,0,0,0,0,0,Friday
2021-10-29,Hong Kong-Zhuhai-Macao Bridge,78,19,2,99,136,26,0,162,Friday
2021-10-29,Lok Ma Chau,0,0,0,0,0,0,0,0,Friday
2021-10-29,Man Kam To,0,0,0,0,0,0,0,0,Friday
2021-10-29,Sha Tau Kok,0,0,0,0,0,0,0,0,Friday
2021-10-29,Shenzhen Bay,883,144,9,1036,540,91,0,631,Friday
2021-10-29,China Ferry Terminal,0,0,0,0,0,0,0,0,Friday
2021-10-29,Harbour Control,0,0,0,0,0,0,0,0,Friday
2021-10-29,Kai Tak Cruise Terminal,1656,0,0,1656,1653,0,0,1653,Friday
2021-10-29,Macau Ferry Terminal,0,0,0,0,0,0,0,0,Friday
2021-10-29,Tuen Mun Ferry Terminal,0,0,0,0,0,0,0,0,Friday
2021-10-29,Total,3448,171,50,3669,3340,136,58,3534,Friday
2021-10-30,Airport,555,8,38,601,807,7,35,849,Saturday
2021-10-30,Express Rail Link West Kowloon,0,0,0,0,0,0,0,0,Saturday
2021-10-30,Hung Hom,0,0,0,0,0,0,0,0,Saturday
2021-10-30,Lo Wu,0,0,0,0,0,0,0,0,Saturday
2021-10-30,Lok Ma Chau Spur Line,0,0,0,0,0,0,0,0,Saturday
2021-10-30,Heung Yuen Wai,0,0,0,0,0,0,0,0,Saturday
2021-10-30,Hong Kong-Zhuhai-Macao Bridge,82,8,4,94,115,9,2,126,Saturday
2021-10-30,Lok Ma Chau,0,0,0,0,0,0,0,0,Saturday
2021-10-30,Man Kam To,0,0,0,0,0,0,0,0,Saturday
2021-10-30,Sha Tau Kok,0,0,0,0,0,0,0,0,Saturday
2021-10-30,Shenzhen Bay,1032,175,7,1214,477,98,8,583,Saturday
2021-10-30,China Ferry Terminal,0,0,0,0,0,0,0,0,Saturday
2021-10-30,Harbour Control,0,0,0,0,0,0,0,0,Saturday
2021-10-30,Kai Tak Cruise Terminal,0,0,0,0,0,0,0,0,Saturday
2021-10-30,Macau Ferry Terminal,0,0,0,0,0,0,0,0,Saturday
2021-10-30,Tuen Mun Ferry Terminal,0,0,0,0,0,0,0,0,Saturday
2021-10-30,Total,1669,191,49,1909,1399,114,45,1558,Saturday
2021-10-31,Airport,1107,24,50,1181,1457,30,57,1544,Sunday
2021-10-31,Express Rail Link West Kowloon,0,0,0,0,0,0,0,0,Sunday
2021-10-31,Hung Hom,0,0,0,0,0,0,0,0,Sunday
2021-10-31,Lo Wu,0,0,0,0,0,0,0,0,Sunday
2021-10-31,Lok Ma Chau Spur Line,0,0,0,0,0,0,0,0,Sunday
2021-10-31,Heung Yuen Wai,0,0,0,0,0,0,0,0,Sunday
2021-10-31,Hong Kong-Zhuhai-Macao Bridge,72,12,2,86,146,17,9,172,Sunday
2021-10-31,Lok Ma Chau,0,0,0,0,0,0,0,0,Sunday
2021-10-31,Man Kam To,0,0,0,0,0,0,0,0,Sunday
2021-10-31,Sha Tau Kok,0,0,0,0,0,0,0,0,Sunday
2021-10-31,Shenzhen Bay,1095,155,11,1261,444,66,3,513,Sunday
2021-10-31,China Ferry Terminal,0,0,0,0,0,0,0,0,Sunday
2021-10-31,Harbour Control,0,0,0,0,0,0,0,0,Sunday
2021-10-31,Kai Tak Cruise Terminal,1653,0,0,1653,1622,0,0,1622,Sunday
2021-10-31,Macau Ferry Terminal,0,0,0,0,0,0,0,0,Sunday
2021-10-31,Tuen Mun Ferry Terminal,0,0,0,0,0,0,0,0,Sunday
2021-10-31,Total,3927,191,63,4181,3669,113,69,3851,Sunday
2021-11-01,Airport,787,3,51,841,714,16,31,761,Monday
2021-11-01,Express Rail Link West Kowloon,0,0,0,0,0,0,0,0,Monday
2021-11-01,Hung Hom,0,0,0,0,0,0,0,0,Monday
2021-11-01,Lo Wu,0,0,0,0,0,0,0,0,Monday
2021-11-01,Lok Ma Chau Spur Line,0,0,0,0,0,0,0,0,Monday
2021-11-01,Heung Yuen Wai,0,0,0,0,0,0,0,0,Monday
2021-11-01,Hong Kong-Zhuhai-Macao Bridge,63,8,3,74,235,14,5,254,Monday
2021-11-01,Lok Ma Chau,0,0,0,0,0,0,0,0,Monday
2021-11-01,Man Kam To,0,0,0,0,0,0,0,0,Monday
2021-11-01,Sha Tau Kok,0,0,0,0,0,0,0,0,Monday
2021-11-01,Shenzhen Bay,725,148,13,886,737,101,3,841,Monday
2021-11-01,China Ferry Terminal,0,0,0,0,0,0,0,0,Monday
2021-11-01,Harbour Control,0,0,0,0,0,0,0,0,Monday
2021-11-01,Kai Tak Cruise Terminal,0,0,0,0,0,0,0,0,Monday
2021-11-01,Macau Ferry Terminal,0,0,0,0,0,0,0,0,Monday
2021-11-01,Tuen Mun Ferry Terminal,0,0,0,0,0,0,0,0,Monday
2021-11-01,Total,1575,159,67,1801,1686,131,39,1856,Monday
2021-11-02,Airport,752,6,36,794,1132,29,32,1193,Tuesday
2021-11-02,Express Rail Link West Kowloon,0,0,0,0,0,0,0,0,Tuesday
2021-11-02,Hung Hom,0,0,0,0,0,0,0,0,Tuesday
2021-11-02,Lo Wu,0,0,0,0,0,0,0,0,Tuesday
2021-11-02,Lok Ma Chau Spur Line,0,0,0,0,0,0,0,0,Tuesday
2021-11-02,Heung Yuen Wai,0,0,0,0,0,0,0,0,Tuesday
2021-11-02,Hong Kong-Zhuhai-Macao Bridge,129,21,11,161,175,14,3,192,Tuesday
2021-11-02,Lok Ma Chau,0,0,0,0,0,0,0,0,Tuesday
2021-11-02,Man Kam To,0,0,0,0,0,0,0,0,Tuesday
2021-11-02,Sha Tau Kok,0,0,0,0,0,0,0,0,Tuesday
2021-11-02,Shenzhen Bay,839,144,7,990,786,114,1,901,Tuesday
2021-11-02,China Ferry Terminal,0,0,0,0,0,0,0,0,Tuesday
2021-11-02,Harbour Control,0,0,0,0,0,0,0,0,Tuesday
2021-11-02,Kai Tak Cruise Terminal,0,0,0,0,0,0,0,0,Tuesday
2021-11-02,Macau Ferry Terminal,0,0,0,0,0,0,0,0,Tuesday
2021-11-02,Tuen Mun Ferry Terminal,0,0,0,0,0,0,0,0,Tuesday
2021-11-02,Total,1720,171,54,1945,2093,157,36,2286,Tuesday
2021-11-03,Airport,1094,15,32,1141,931,18,43,992,Wednesday
2021-11-03,Express Rail Link West Kowloon,0,0,0,0,0,0,0,0,Wednesday
2021-11-03,Hung Hom,0,0,0,0,0,0,0,0,Wednesday
2021-11-03,Lo Wu,0,0,0,0,0,0,0,0,Wednesday
2021-11-03,Lok Ma Chau Spur Line,0,0,0,0,0,0,0,0,Wednesday
2021-11-03,Heung Yuen Wai,0,0,0,0,0,0,0,0,Wednesday
2021-11-03,Hong Kong-Zhuhai-Macao Bridge,148,11,13,172,198,7,2,207,Wednesday
2021-11-03,Lok Ma Chau,0,0,0,0,0,0,0,0,Wednesday
2021-11-03,Man Kam To,0,0,0,0,0,0,0,0,Wednesday
2021-11-03,Sha Tau Kok,0,0,0,0,0,0,0,0,Wednesday
2021-11-03,Shenzhen Bay,998,207,9,1214,775,186,7,968,Wednesday
2021-11-03,China Ferry Terminal,0,0,0,0,0,0,0,0,Wednesday
2021-11-03,Harbour Control,0,0,0,0,0,0,0,0,Wednesday
2021-11-03,Kai Tak Cruise Terminal,1622,0,0,1622,1458,0,0,1458,Wednesday
2021-11-03,Macau Ferry Terminal,0,0,0,0,0,0,0,0,Wednesday
2021-11-03,Tuen Mun Ferry Terminal,0,0,0,0,0,0,0,0,Wednesday
2021-11-03,Total,3862,233,54,4149,3362,211,52,3625,Wednesday
2021-11-04,Airport,644,19,40,703,635,18,20,673,Thursday
2021-11-04,Express Rail Link West Kowloon,0,0,0,0,0,0,0,0,Thursday
2021-11-04,Hung Hom,0,0,0,0,0,0,0,0,Thursday
2021-11-04,Lo Wu,0,0,0,0,0,0,0,0,Thursday
2021-11-04,Lok Ma Chau Spur Line,0,0,0,0,0,0,0,0,Thursday
2021-11-04,Heung Yuen Wai,0,0,0,0,0,0,0,0,Thursday
2021-11-04,Hong Kong-Zhuhai-Macao Bridge,123,2,15,140,187,13,12,212,Thursday
2021-11-04,Lok Ma Chau,0,0,0,0,0,0,0,0,Thursday
2021-11-04,Man Kam To,0,0,0,0,0,0,0,0,Thursday
2021-11-04,Sha Tau Kok,0,0,0,0,0,0,0,0,Thursday
2021-11-04,Shenzhen Bay,786,140,9,935,637,101,3,741,Thursday
2021-11-04,China Ferry Terminal,0,0,0,0,0,0,0,0,Thursday
2021-11-04,Harbour Control,0,0,0,0,0,0,0,0,Thursday
2021-11-04,Kai Tak Cruise Terminal,0,0,0,0,0,0,0,0,Thursday
2021-11-04,Macau Ferry Terminal,0,0,0,0,0,0,0,0,Thursday
2021-11-04,Tuen Mun Ferry Terminal,0,0,0,0,0,0,0,0,Thursday
2021-11-04,Total,1553,161,64,1778,1459,132,35,1626,Thursday
2021-11-05,Airport,879,62,46,987,1039,16,46,1101,Friday
2021-11-05,Express Rail Link West Kowloon,0,0,0,0,0,0,0,0,Friday
2021-11-05,Hung Hom,0,0,0,0,0,0,0,0,Friday
2021-11-05,Lo Wu,0,0,0,0,0,0,0,0,Friday
2021-11-05,Lok Ma Chau Spur Line,0,0,0,0,0,0,0,0,Friday
2021-11-05,Heung Yuen Wai,0,0,0,0,0,0,0,0,Friday
2021-11-05,Hong Kong-Zhuhai-Macao Bridge,143,10,26,179,195,31,13,239,Friday
2021-11-05,Lok Ma Chau,0,0,0,0,0,0,0,0,Friday
2021-11-05,Man Kam To,0,0,0,0,0,0,0,0,Friday
2021-11-05,Sha Tau Kok,0,0,0,0,0,0,0,0,Friday
2021-11-05,Shenzhen Bay,915,189,7,1111,744,131,9,884,Friday
2021-11-05,China Ferry Terminal,0,0,0,0,0,0,0,0,Friday
2021-11-05,Harbour Control,0,0,0,0,0,0,0,0,Friday
2021-11-05,Kai Tak Cruise Terminal,1458,0,0,1458,1612,0,0,1612,Friday
2021-11-05,Macau Ferry Terminal,0,0,0,0,0,0,0,0,Friday
2021-11-05,Tuen Mun Ferry Terminal,0,0,0,0,0,0,0,0,Friday
2021-11-05,Total,3395,261,79,3735,3590,178,68,3836,Friday
2021-11-06,Airport,566,174,34,774,955,33,59,1047,Saturday
2021-11-06,Express Rail Link West Kowloon,0,0,0,0,0,0,0,0,Saturday
2021-11-06,Hung Hom,0,0,0,0,0,0,0,0,Saturday
2021-11-06,Lo Wu,0,0,0,0,0,0,0,0,Saturday
2021-11-06,Lok Ma Chau Spur Line,0,0,0,0,0,0,0,0,Saturday
2021-11-06,Heung Yuen Wai,0,0,0,0,0,0,0,0,Saturday
2021-11-06,Hong Kong-Zhuhai-Macao Bridge,99,13,18,130,158,25,4,187,Saturday
2021-11-06,Lok Ma Chau,0,0,0,0,0,0,0,0,Saturday
2021-11-06,Man Kam To,0,0,0,0,0,0,0,0,Saturday
2021-11-06,Sha Tau Kok,0,0,0,0,0,0,0,0,Saturday
2021-11-06,Shenzhen Bay,740,275,11,1026,620,130,4,754,Saturday
2021-11-06,China Ferry Terminal,0,0,0,0,0,0,0,0,Saturday
2021-11-06,Harbour Control,0,0,0,0,0,0,0,0,Saturday
2021-11-06,Kai Tak Cruise Terminal,0,0,0,0,0,0,0,0,Saturday
2021-11-06,Macau Ferry Terminal,0,0,0,0,0,0,0,0,Saturday
2021-11-06,Tuen Mun Ferry Terminal,0,0,0,0,0,0,0,0,Saturday
2021-11-06,Total,1405,462,63,1930,1733,188,67,1988,Saturday
2021-11-07,Airport,1191,75,44,1310,1409,26,39,1474,Sunday
2021-11-07,Express Rail Link West Kowloon,0,0,0,0,0,0,0,0,Sunday
2021-11-07,Hung Hom,0,0,0,0,0,0,0,0,Sunday
2021-11-07,Lo Wu,0,0,0,0,0,0,0,0,Sunday
2021-11-07,Lok Ma Chau Spur Line,0,0,0,0,0,0,0,0,Sunday
2021-11-07,Heung Yuen Wai,0,0,0,0,0,0,0,0,Sunday
2021-11-07,Hong Kong-Zhuhai-Macao Bridge,94,5,14,113,122,15,7,144,Sunday
2021-11-07,Lok Ma Chau,0,0,0,0,0,0,0,0,Sunday
2021-11-07,Man Kam To,0,0,0,0,0,0,0,0,Sunday
2021-11-07,Sha Tau Kok,0,0,0,0,0,0,0,0,Sunday
2021-11-07,Shenzhen Bay,898,195,11,1104,439,92,2,533,Sunday
2021-11-07,China Ferry Terminal,0,0,0,0,0,0,0,0,Sunday
2021-11-07,Harbour Control,0,0,0,0,0,0,0,0,Sunday
2021-11-07,Kai Tak Cruise Terminal,1612,0,0,1612,1239,0,0,1239,Sunday
2021-11-07,Macau Ferry Terminal,0,0,0,0,0,0,0,0,Sunday
2021-11-07,Tuen Mun Ferry Terminal,0,0,0,0,0,0,0,0,Sunday
2021-11-07,Total,3795,275,69,4139,3209,133,48,3390,Sunday
2021-11-08,Airport,446,6,40,492,658,14,29,701,Monday
2021-11-08,Express Rail Link West Kowloon,0,0,0,0,0,0,0,0,Monday
2021-11-08,Hung Hom,0,0,0,0,0,0,0,0,Monday
2021-11-08,Lo Wu,0,0,0,0,0,0,0,0,Monday
2021-11-08,Lok Ma Chau Spur Line,0,0,0,0,0,0,0,0,Monday
2021-11-08,Heung Yuen Wai,0,0,0,0,0,0,0,0,Monday
2021-11-08,Hong Kong-Zhuhai-Macao Bridge,102,13,13,128,187,21,3,211,Monday
2021-11-08,Lok Ma Chau,0,0,0,0,0,0,0,0,Monday
2021-11-08,Man Kam To,0,0,0,0,0,0,0,0,Monday
2021-11-08,Sha Tau Kok,0,0,0,0,0,0,0,0,Monday
2021-11-08,Shenzhen Bay,692,152,4,848,729,134,0,863,Monday
2021-11-08,China Ferry Terminal,0,0,0,0,0,0,0,0,Monday
2021-11-08,Harbour Control,0,0,0,0,0,0,0,0,Monday
2021-11-08,Kai Tak Cruise Terminal,0,0,0,0,0,0,0,0,Monday
2021-11-08,Macau Ferry Terminal,0,0,0,0,0,0,0,0,Monday
2021-11-08,Tuen Mun Ferry Terminal,0,0,0,0,0,0,0,0,Monday
2021-11-08,Total,1240,171,57,1468,1574,169,32,1775,Monday
2021-11-09,Airport,693,11,30,734,834,17,33,884,Tuesday
2021-11-09,Express Rail Link West Kowloon,0,0,0,0,0,0,0,0,Tuesday
2021-11-09,Hung Hom,0,0,0,0,0,0,0,0,Tuesday
2021-11-09,Lo Wu,0,0,0,0,0,0,0,0,Tuesday
2021-11-09,Lok Ma Chau Spur Line,0,0,0,0,0,0,0,0,Tuesday
2021-11-09,Heung Yuen Wai,0,0,0,0,0,0,0,0,Tuesday
2021-11-09,Hong Kong-Zhuhai-Macao Bridge,99,11,15,125,187,12,9,208,Tuesday
2021-11-09,Lok Ma Chau,0,0,0,0,0,0,0,0,Tuesday
2021-11-09,Man Kam To,0,0,0,0,0,0,0,0,Tuesday
2021-11-09,Sha Tau Kok,0,0,0,0,0,0,0,0,Tuesday
2021-11-09,Shenzhen Bay,730,160,10,900,772,133,2,907,Tuesday
2021-11-09,China Ferry Terminal,0,0,0,0,0,0,0,0,Tuesday
2021-11-09,Harbour Control,0,0,0,0,0,0,0,0,Tuesday
2021-11-09,Kai Tak Cruise Terminal,0,0,0,0,0,0,0,0,Tuesday
2021-11-09,Macau Ferry Terminal,0,0,0,0,0,0,0,0,Tuesday
2021-11-09,Tuen Mun Ferry Terminal,0,0,0,0,0,0,0,0,Tuesday
2021-11-09,Total,1522,182,55,1759,1793,162,44,1999,Tuesday
2021-11-10,Airport,1073,10,52,1135,1093,10,53,1156,Wednesday
2021-11-10,Express Rail Link West Kowloon,0,0,0,0,0,0,0,0,Wednesday
2021-11-10,Hung Hom,0,0,0,0,0,0,0,0,Wednesday
2021-11-10,Lo Wu,0,0,0,0,0,0,0,0,Wednesday
2021-11-10,Lok Ma Chau Spur Line,0,0,0,0,0,0,0,0,Wednesday
2021-11-10,Heung Yuen Wai,0,0,0,0,0,0,0,0,Wednesday
2021-11-10,Hong Kong-Zhuhai-Macao Bridge,120,9,11,140,204,17,8,229,Wednesday
2021-11-10,Lok Ma Chau,0,0,0,0,0,0,0,0,Wednesday
2021-11-10,Man Kam To,0,0,0,0,0,0,0,0,Wednesday
2021-11-10,Sha Tau Kok,0,0,0,0,0,0,0,0,Wednesday
2021-11-10,Shenzhen Bay,1003,199,11,1213,827,114,4,945,Wednesday
2021-11-10,China Ferry Terminal,0,0,0,0,0,0,0,0,Wednesday
2021-11-10,Harbour Control,0,0,0,0,0,0,0,0,Wednesday
2021-11-10,Kai Tak Cruise Terminal,1239,0,0,1239,1517,0,0,1517,Wednesday
2021-11-10,Macau Ferry Terminal,0,0,0,0,0,0,0,0,Wednesday
2021-11-10,Tuen Mun Ferry Terminal,0,0,0,0,0,0,0,0,Wednesday
2021-11-10,Total,3435,218,74,3727,3641,141,65,3847,Wednesday
2021-11-11,Airport,689,6,36,731,589,28,27,644,Thursday
2021-11-11,Express Rail Link West Kowloon,0,0,0,0,0,0,0,0,Thursday
2021-11-11,Hung Hom,0,0,0,0,0,0,0,0,Thursday
2021-11-11,Lo Wu,0,0,0,0,0,0,0,0,Thursday
2021-11-11,Lok Ma Chau Spur Line,0,0,0,0,0,0,0,0,Thursday
2021-11-11,Heung Yuen Wai,0,0,0,0,0,0,0,0,Thursday
2021-11-11,Hong Kong-Zhuhai-Macao Bridge,124,7,6,137,188,9,3,200,Thursday
2021-11-11,Lok Ma Chau,0,0,0,0,0,0,0,0,Thursday
2021-11-11,Man Kam To,0,0,0,0,0,0,0,0,Thursday
2021-11-11,Sha Tau Kok,0,0,0,0,0,0,0,0,Thursday
2021-11-11,Shenzhen Bay,772,194,7,973,539,134,2,675,Thursday
2021-11-11,China Ferry Terminal,0,0,0,0,0,0,0,0,Thursday
2021-11-11,Harbour Control,0,0,0,0,0,0,0,0,Thursday
2021-11-11,Kai Tak Cruise Terminal,0,0,0,0,1250,0,0,1250,Thursday
2021-11-11,Macau Ferry Terminal,0,0,0,0,0,0,0,0,Thursday
2021-11-11,Tuen Mun Ferry Terminal,0,0,0,0,0,0,0,0,Thursday
2021-11-11,Total,1585,207,49,1841,2566,171,32,2769,Thursday
2021-11-12,Airport,825,15,68,908,943,21,55,1019,Friday
2021-11-12,Express Rail Link West Kowloon,0,0,0,0,0,0,0,0,Friday
2021-11-12,Hung Hom,0,0,0,0,0,0,0,0,Friday
2021-11-12,Lo Wu,0,0,0,0,0,0,0,0,Friday
2021-11-12,Lok Ma Chau Spur Line,0,0,0,0,0,0,0,0,Friday
2021-11-12,Heung Yuen Wai,0,0,0,0,0,0,0,0,Friday
2021-11-12,Hong Kong-Zhuhai-Macao Bridge,85,16,12,113,136,16,8,160,Friday
2021-11-12,Lok Ma Chau,0,0,0,0,0,0,0,0,Friday
2021-11-12,Man Kam To,0,0,0,0,0,0,0,0,Friday
2021-11-12,Sha Tau Kok,0,0,0,0,0,0,0,0,Friday
2021-11-12,Shenzhen Bay,696,167,8,871,665,99,1,765,Friday
2021-11-12,China Ferry Terminal,0,0,0,0,0,0,0,0,Friday
2021-11-12,Harbour Control,0,0,0,0,0,0,0,0,Friday
2021-11-12,Kai Tak Cruise Terminal,1517,0,0,1517,1617,0,0,1617,Friday
2021-11-12,Macau Ferry Terminal,0,0,0,0,0,0,0,0,Friday
2021-11-12,Tuen Mun Ferry Terminal,0,0,0,0,0,0,0,0,Friday
2021-11-12,Total,3123,198,88,3409,3361,136,64,3561,Friday
2021-11-13,Airport,399,11,35,445,885,20,33,938,Saturday
2021-11-13,Express Rail Link West Kowloon,0,0,0,0,0,0,0,0,Saturday
2021-11-13,Hung Hom,0,0,0,0,0,0,0,0,Saturday
2021-11-13,Lo Wu,0,0,0,0,0,0,0,0,Saturday
2021-11-13,Lok Ma Chau Spur Line,0,0,0,0,0,0,0,0,Saturday
2021-11-13,Heung Yuen Wai,0,0,0,0,0,0,0,0,Saturday
2021-11-13,Hong Kong-Zhuhai-Macao Bridge,81,24,8,113,168,25,1,194,Saturday
2021-11-13,Lok Ma Chau,0,0,0,0,0,0,0,0,Saturday
2021-11-13,Man Kam To,0,0,0,0,0,0,0,0,Saturday
2021-11-13,Sha Tau Kok,0,0,0,0,0,0,0,0,Saturday
2021-11-13,Shenzhen Bay,627,211,11,849,650,104,8,762,Saturday
2021-11-13,China Ferry Terminal,0,0,0,0,0,0,0,0,Saturday
2021-11-13,Harbour Control,0,0,0,0,0,0,0,0,Saturday
2021-11-13,Kai Tak Cruise Terminal,0,0,0,0,0,0,0,0,Saturday
2021-11-13,Macau Ferry Terminal,0,0,0,0,0,0,0,0,Saturday
2021-11-13,Tuen Mun Ferry Terminal,0,0,0,0,0,0,0,0,Saturday
2021-11-13,Total,1107,246,54,1407,1703,149,42,1894,Saturday
2021-11-14,Airport,1333,30,90,1453,1472,34,74,1580,Sunday
2021-11-14,Express Rail Link West Kowloon,0,0,0,0,0,0,0,0,Sunday
2021-11-14,Hung Hom,0,0,0,0,0,0,0,0,Sunday
2021-11-14,Lo Wu,0,0,0,0,0,0,0,0,Sunday
2021-11-14,Lok Ma Chau Spur Line,0,0,0,0,0,0,0,0,Sunday
2021-11-14,Heung Yuen Wai,0,0,0,0,0,0,0,0,Sunday
2021-11-14,Hong Kong-Zhuhai-Macao Bridge,112,12,15,139,133,30,12,175,Sunday
2021-11-14,Lok Ma Chau,0,0,0,0,0,0,0,0,Sunday
2021-11-14,Man Kam To,0,0,0,0,0,0,0,0,Sunday
2021-11-14,Sha Tau Kok,0,0,0,0,0,0,0,0,Sunday
2021-11-14,Shenzhen Bay,832,139,9,980,438,134,1,573,Sunday
2021-11-14,China Ferry Terminal,0,0,0,0,0,0,0,0,Sunday
2021-11-14,Harbour Control,0,0,0,0,0,0,0,0,Sunday
2021-11-14,Kai Tak Cruise Terminal,2867,0,0,2867,2393,0,0,2393,Sunday
2021-11-14,Macau Ferry Terminal,0,0,0,0,0,0,0,0,Sunday
2021-11-14,Tuen Mun Ferry Terminal,0,0,0,0,0,0,0,0,Sunday
2021-11-14,Total,5144,181,114,5439,4436,198,87,4721,Sunday
2021-11-15,Airport,703,5,56,764,791,162,32,985,Monday
2021-11-15,Express Rail Link West Kowloon,0,0,0,0,0,0,0,0,Monday
2021-11-15,Hung Hom,0,0,0,0,0,0,0,0,Monday
2021-11-15,Lo Wu,0,0,0,0,0,0,0,0,Monday
2021-11-15,Lok Ma Chau Spur Line,0,0,0,0,0,0,0,0,Monday
2021-11-15,Heung Yuen Wai,0,0,0,0,0,0,0,0,Monday
2021-11-15,Hong Kong-Zhuhai-Macao Bridge,81,12,13,106,189,34,6,229,Monday
2021-11-15,Lok Ma Chau,0,0,0,0,0,0,0,0,Monday
2021-11-15,Man Kam To,0,0,0,0,0,0,0,0,Monday
2021-11-15,Sha Tau Kok,0,0,0,0,0,0,0,0,Monday
2021-11-15,Shenzhen Bay,853,151,5,1009,727,251,0,978,Monday
2021-11-15,China Ferry Terminal,0,0,0,0,0,0,0,0,Monday
2021-11-15,Harbour Control,0,0,0,0,0,0,0,0,Monday
2021-11-15,Kai Tak Cruise Terminal,0,0,0,0,0,0,0,0,Monday
2021-11-15,Macau Ferry Terminal,0,0,0,0,0,0,0,0,Monday
2021-11-15,Tuen Mun Ferry Terminal,0,0,0,0,0,0,0,0,Monday
2021-11-15,Total,1637,168,74,1879,1707,447,38,2192,Monday
2021-11-16,Airport,600,8,37,645,1122,74,55,1251,Tuesday
2021-11-16,Express Rail Link West Kowloon,0,0,0,0,0,0,0,0,Tuesday
2021-11-16,Hung Hom,0,0,0,0,0,0,0,0,Tuesday
2021-11-16,Lo Wu,0,0,0,0,0,0,0,0,Tuesday
2021-11-16,Lok Ma Chau Spur Line,0,0,0,0,0,0,0,0,Tuesday
2021-11-16,Heung Yuen Wai,0,0,0,0,0,0,0,0,Tuesday
2021-11-16,Hong Kong-Zhuhai-Macao Bridge,90,8,13,111,173,25,4,202,Tuesday
2021-11-16,Lok Ma Chau,0,0,0,0,0,0,0,0,Tuesday
2021-11-16,Man Kam To,0,0,0,0,0,0,0,0,Tuesday
2021-11-16,Sha Tau Kok,0,0,0,0,0,0,0,0,Tuesday
2021-11-16,Shenzhen Bay,820,147,9,976,806,150,3,959,Tuesday
2021-11-16,China Ferry Terminal,0,0,0,0,0,0,0,0,Tuesday
2021-11-16,Harbour Control,0,0,0,0,0,0,0,0,Tuesday
2021-11-16,Kai Tak Cruise Terminal,0,0,0,0,0,0,0,0,Tuesday
2021-11-16,Macau Ferry Terminal,0,0,0,0,0,0,0,0,Tuesday
2021-11-16,Tuen Mun Ferry Terminal,0,0,0,0,0,0,0,0,Tuesday
2021-11-16,Total,1510,163,59,1732,2101,249,62,2412,Tuesday
2021-11-18,Airport,740,12,37,789,710,30,46,786,Thursday
2021-11-18,Express Rail Link West Kowloon,0,0,0,0,0,0,0,0,Thursday
2021-11-18,Hung Hom,0,0,0,0,0,0,0,0,Thursday
2021-11-18,Lo Wu,0,0,0,0,0,0,0,0,Thursday
2021-11-18,Lok Ma Chau Spur Line,0,0,0,0,0,0,0,0,Thursday
2021-11-18,Heung Yuen Wai,0,0,0,0,0,0,0,0,Thursday
2021-11-18,Hong Kong-Zhuhai-Macao Bridge,108,10,13,131,142,17,7,166,Thursday
2021-11-18,Lok Ma Chau,0,0,0,0,0,0,0,0,Thursday
2021-11-18,Man Kam To,0,0,0,0,0,0,0,0,Thursday
2021-11-18,Sha Tau Kok,0,0,0,0,0,0,0,0,Thursday
2021-11-18,Shenzhen Bay,834,109,9,952,635,105,3,743,Thursday
2021-11-18,China Ferry Terminal,0,0,0,0,0,0,0,0,Thursday
2021-11-18,Harbour Control,0,0,0,0,0,0,0,0,Thursday
2021-11-18,Kai Tak Cruise Terminal,1180,0,0,1180,1124,0,0,1124,Thursday
2021-11-18,Macau Ferry Terminal,0,0,0,0,0,0,0,0,Thursday
2021-11-18,Tuen Mun Ferry Terminal,0,0,0,0,0,0,0,0,Thursday
2021-11-18,Total,2862,131,59,3052,2611,152,56,2819,Thursday
2021-11-17,Airport,1115,20,88,1223,983,63,54,1100,Wednesday
2021-11-17,Express Rail Link West Kowloon,0,0,0,0,0,0,0,0,Wednesday
2021-11-17,Hung Hom,0,0,0,0,0,0,0,0,Wednesday
2021-11-17,Lo Wu,0,0,0,0,0,0,0,0,Wednesday
2021-11-17,Lok Ma Chau Spur Line,0,0,0,0,0,0,0,0,Wednesday
2021-11-17,Heung Yuen Wai,0,0,0,0,0,0,0,0,Wednesday
2021-11-17,Hong Kong-Zhuhai-Macao Bridge,90,11,10,111,138,19,11,168,Wednesday
2021-11-17,Lok Ma Chau,0,0,0,0,0,0,0,0,Wednesday
2021-11-17,Man Kam To,0,0,0,0,0,0,0,0,Wednesday
2021-11-17,Sha Tau Kok,0,0,0,0,0,0,0,0,Wednesday
2021-11-17,Shenzhen Bay,819,126,14,959,700,88,4,792,Wednesday
2021-11-17,China Ferry Terminal,0,0,0,0,0,0,0,0,Wednesday
2021-11-17,Harbour Control,0,0,0,0,0,0,0,0,Wednesday
2021-11-17,Kai Tak Cruise Terminal,1213,0,0,1213,1492,0,0,1492,Wednesday
2021-11-17,Macau Ferry Terminal,0,0,0,0,0,0,0,0,Wednesday
2021-11-17,Tuen Mun Ferry Terminal,0,0,0,0,0,0,0,0,Wednesday
2021-11-17,Total,3237,157,112,3506,3313,170,69,3552,Wednesday
2021-11-19,Airport,736,9,43,788,944,24,46,1014,Friday
2021-11-19,Express Rail Link West Kowloon,0,0,0,0,0,0,0,0,Friday
2021-11-19,Hung Hom,0,0,0,0,0,0,0,0,Friday
2021-11-19,Lo Wu,0,0,0,0,0,0,0,0,Friday
2021-11-19,Lok Ma Chau Spur Line,0,0,0,0,0,0,0,0,Friday
2021-11-19,Heung Yuen Wai,0,0,0,0,0,0,0,0,Friday
2021-11-19,Hong Kong-Zhuhai-Macao Bridge,87,6,14,107,128,21,11,160,Friday
2021-11-19,Lok Ma Chau,0,0,0,0,0,0,0,0,Friday
2021-11-19,Man Kam To,0,0,0,0,0,0,0,0,Friday
2021-11-19,Sha Tau Kok,0,0,0,0,0,0,0,0,Friday
2021-11-19,Shenzhen Bay,742,147,5,894,574,108,2,684,Friday
2021-11-19,China Ferry Terminal,0,0,0,0,0,0,0,0,Friday
2021-11-19,Harbour Control,0,0,0,0,0,0,0,0,Friday
2021-11-19,Kai Tak Cruise Terminal,1492,0,0,1492,1654,0,0,1654,Friday
2021-11-19,Macau Ferry Terminal,0,0,0,0,0,0,0,0,Friday
2021-11-19,Tuen Mun Ferry Terminal,0,0,0,0,0,0,0,0,Friday
2021-11-19,Total,3057,162,62,3281,3300,153,59,3512,Friday
2021-11-20,Airport,639,19,32,690,1092,21,45,1158,Saturday
2021-11-20,Express Rail Link West Kowloon,0,0,0,0,0,0,0,0,Saturday
2021-11-20,Hung Hom,0,0,0,0,0,0,0,0,Saturday
2021-11-20,Lo Wu,0,0,0,0,0,0,0,0,Saturday
2021-11-20,Lok Ma Chau Spur Line,0,0,0,0,0,0,0,0,Saturday
2021-11-20,Heung Yuen Wai,0,0,0,0,0,0,0,0,Saturday
2021-11-20,Hong Kong-Zhuhai-Macao Bridge,88,15,12,115,149,17,8,174,Saturday
2021-11-20,Lok Ma Chau,0,0,0,0,0,0,0,0,Saturday
2021-11-20,Man Kam To,0,0,0,0,0,0,0,0,Saturday
2021-11-20,Sha Tau Kok,0,0,0,0,0,0,0,0,Saturday
2021-11-20,Shenzhen Bay,727,192,1,920,727,110,6,843,Saturday
2021-11-20,China Ferry Terminal,0,0,0,0,0,0,0,0,Saturday
2021-11-20,Harbour Control,0,0,0,0,0,0,0,0,Saturday
2021-11-20,Kai Tak Cruise Terminal,0,0,0,0,0,0,0,0,Saturday
2021-11-20,Macau Ferry Terminal,0,0,0,0,0,0,0,0,Saturday
2021-11-20,Tuen Mun Ferry Terminal,0,0,0,0,0,0,0,0,Saturday
2021-11-20,Total,1454,226,45,1725,1968,148,59,2175,Saturday
2021-11-21,Airport,1051,15,37,1103,1337,27,53,1417,Sunday
2021-11-21,Express Rail Link West Kowloon,0,0,0,0,0,0,0,0,Sunday
2021-11-21,Hung Hom,0,0,0,0,0,0,0,0,Sunday
2021-11-21,Lo Wu,0,0,0,0,0,0,0,0,Sunday
2021-11-21,Lok Ma Chau Spur Line,0,0,0,0,0,0,0,0,Sunday
2021-11-21,Heung Yuen Wai,0,0,0,0,0,0,0,0,Sunday
2021-11-21,Hong Kong-Zhuhai-Macao Bridge,97,9,18,124,79,13,3,95,Sunday
2021-11-21,Lok Ma Chau,0,0,0,0,0,0,0,0,Sunday
2021-11-21,Man Kam To,0,0,0,0,0,0,0,0,Sunday
2021-11-21,Sha Tau Kok,0,0,0,0,0,0,0,0,Sunday
2021-11-21,Shenzhen Bay,864,157,7,1028,456,102,2,560,Sunday
2021-11-21,China Ferry Terminal,0,0,0,0,0,0,0,0,Sunday
2021-11-21,Harbour Control,0,0,0,0,0,0,0,0,Sunday
2021-11-21,Kai Tak Cruise Terminal,2778,0,0,2778,2498,0,0,2498,Sunday
2021-11-21,Macau Ferry Terminal,0,0,0,0,0,0,0,0,Sunday
2021-11-21,Tuen Mun Ferry Terminal,0,0,0,0,0,0,0,0,Sunday
2021-11-21,Total,4790,181,62,5033,4370,142,58,4570,Sunday
2021-11-22,Airport,516,4,29,549,719,7,31,757,Monday
2021-11-22,Express Rail Link West Kowloon,0,0,0,0,0,0,0,0,Monday
2021-11-22,Hung Hom,0,0,0,0,0,0,0,0,Monday
2021-11-22,Lo Wu,0,0,0,0,0,0,0,0,Monday
2021-11-22,Lok Ma Chau Spur Line,0,0,0,0,0,0,0,0,Monday
2021-11-22,Heung Yuen Wai,0,0,0,0,0,0,0,0,Monday
2021-11-22,Hong Kong-Zhuhai-Macao Bridge,102,4,8,114,139,12,8,159,Monday
2021-11-22,Lok Ma Chau,0,0,0,0,0,0,0,0,Monday
2021-11-22,Man Kam To,0,0,0,0,0,0,0,0,Monday
2021-11-22,Sha Tau Kok,0,0,0,0,0,0,0,0,Monday
2021-11-22,Shenzhen Bay,1105,100,9,1214,944,75,2,1021,Monday
2021-11-22,China Ferry Terminal,0,0,0,0,0,0,0,0,Monday
2021-11-22,Harbour Control,0,0,0,0,0,0,0,0,Monday
2021-11-22,Kai Tak Cruise Terminal,0,0,0,0,0,0,0,0,Monday
2021-11-22,Macau Ferry Terminal,0,0,0,0,0,0,0,0,Monday
2021-11-22,Tuen Mun Ferry Terminal,0,0,0,0,0,0,0,0,Monday
2021-11-22,Total,1723,108,46,1877,1802,94,41,1937,Monday
2021-11-23,Airport,438,2,34,474,1127,29,49,1205,Tuesday
2021-11-23,Express Rail Link West Kowloon,0,0,0,0,0,0,0,0,Tuesday
2021-11-23,Hung Hom,0,0,0,0,0,0,0,0,Tuesday
2021-11-23,Lo Wu,0,0,0,0,0,0,0,0,Tuesday
2021-11-23,Lok Ma Chau Spur Line,0,0,0,0,0,0,0,0,Tuesday
2021-11-23,Heung Yuen Wai,0,0,0,0,0,0,0,0,Tuesday
2021-11-23,Hong Kong-Zhuhai-Macao Bridge,88,4,6,98,132,10,7,149,Tuesday
2021-11-23,Lok Ma Chau,0,0,0,0,0,0,0,0,Tuesday
2021-11-23,Man Kam To,0,0,0,0,0,0,0,0,Tuesday
2021-11-23,Sha Tau Kok,0,0,0,0,0,0,0,0,Tuesday
2021-11-23,Shenzhen Bay,1133,146,11,1290,903,121,2,1026,Tuesday
2021-11-23,China Ferry Terminal,0,0,0,0,0,0,0,0,Tuesday
2021-11-23,Harbour Control,0,0,0,0,0,0,0,0,Tuesday
2021-11-23,Kai Tak Cruise Terminal,0,0,0,0,0,0,0,0,Tuesday
2021-11-23,Macau Ferry Terminal,0,0,0,0,0,0,0,0,Tuesday
2021-11-23,Tuen Mun Ferry Terminal,0,0,0,0,0,0,0,0,Tuesday
2021-11-23,Total,1659,152,51,1862,2162,160,58,2380,Tuesday
2021-11-24,Airport,1128,12,56,1196,856,14,41,911,Wednesday
2021-11-24,Express Rail Link West Kowloon,0,0,0,0,0,0,0,0,Wednesday
2021-11-24,Hung Hom,0,0,0,0,0,0,0,0,Wednesday
2021-11-24,Lo Wu,0,0,0,0,0,0,0,0,Wednesday
2021-11-24,Lok Ma Chau Spur Line,0,0,0,0,0,0,0,0,Wednesday
2021-11-24,Heung Yuen Wai,0,0,0,0,0,0,0,0,Wednesday
2021-11-24,Hong Kong-Zhuhai-Macao Bridge,98,3,10,111,134,8,5,147,Wednesday
2021-11-24,Lok Ma Chau,0,0,0,0,0,0,0,0,Wednesday
2021-11-24,Man Kam To,0,0,0,0,0,0,0,0,Wednesday
2021-11-24,Sha Tau Kok,0,0,0,0,0,0,0,0,Wednesday
2021-11-24,Shenzhen Bay,1116,114,13,1243,917,88,4,1009,Wednesday
2021-11-24,China Ferry Terminal,0,0,0,0,0,0,0,0,Wednesday
2021-11-24,Harbour Control,0,0,0,0,0,0,0,0,Wednesday
2021-11-24,Kai Tak Cruise Terminal,1236,0,0,1236,1472,0,0,1472,Wednesday
2021-11-24,Macau Ferry Terminal,0,0,0,0,0,0,0,0,Wednesday
2021-11-24,Tuen Mun Ferry Terminal,0,0,0,0,0,0,0,0,Wednesday
2021-11-24,Total,3578,129,79,3786,3379,110,50,3539,Wednesday
2021-11-25,Airport,733,8,48,789,716,25,53,794,Thursday
2021-11-25,Express Rail Link West Kowloon,0,0,0,0,0,0,0,0,Thursday
2021-11-25,Hung Hom,0,0,0,0,0,0,0,0,Thursday
2021-11-25,Lo Wu,0,0,0,0,0,0,0,0,Thursday
2021-11-25,Lok Ma Chau Spur Line,0,0,0,0,0,0,0,0,Thursday
2021-11-25,Heung Yuen Wai,0,0,0,0,0,0,0,0,Thursday
2021-11-25,Hong Kong-Zhuhai-Macao Bridge,113,5,11,129,139,7,5,151,Thursday
2021-11-25,Lok Ma Chau,0,0,0,0,0,0,0,0,Thursday
2021-11-25,Man Kam To,0,0,0,0,0,0,0,0,Thursday
2021-11-25,Sha Tau Kok,0,0,0,0,0,0,0,0,Thursday
2021-11-25,Shenzhen Bay,1120,155,8,1283,833,69,3,905,Thursday
2021-11-25,China Ferry Terminal,0,0,0,0,0,0,0,0,Thursday
2021-11-25,Harbour Control,0,0,0,0,0,0,0,0,Thursday
2021-11-25,Kai Tak Cruise Terminal,1262,0,0,1262,1165,0,0,1165,Thursday
2021-11-25,Macau Ferry Terminal,0,0,0,0,0,0,0,0,Thursday
2021-11-25,Tuen Mun Ferry Terminal,0,0,0,0,0,0,0,0,Thursday
2021-11-25,Total,3228,168,67,3463,2853,101,61,3015,Thursday
2021-11-26,Airport,724,12,42,778,1274,12,66,1352,Friday
2021-11-26,Express Rail Link West Kowloon,0,0,0,0,0,0,0,0,Friday
2021-11-26,Hung Hom,0,0,0,0,0,0,0,0,Friday
2021-11-26,Lo Wu,0,0,0,0,0,0,0,0,Friday
2021-11-26,Lok Ma Chau Spur Line,0,0,0,0,0,0,0,0,Friday
2021-11-26,Heung Yuen Wai,0,0,0,0,0,0,0,0,Friday
2021-11-26,Hong Kong-Zhuhai-Macao Bridge,115,9,11,135,109,7,9,125,Friday
2021-11-26,Lok Ma Chau,0,0,0,0,0,0,0,0,Friday
2021-11-26,Man Kam To,0,0,0,0,0,0,0,0,Friday
2021-11-26,Sha Tau Kok,0,0,0,0,0,0,0,0,Friday
2021-11-26,Shenzhen Bay,1189,127,8,1324,867,82,1,950,Friday
2021-11-26,China Ferry Terminal,0,0,0,0,0,0,0,0,Friday
2021-11-26,Harbour Control,0,0,0,0,0,0,0,0,Friday
2021-11-26,Kai Tak Cruise Terminal,1472,0,0,1472,1588,0,0,1588,Friday
2021-11-26,Macau Ferry Terminal,0,0,0,0,0,0,0,0,Friday
2021-11-26,Tuen Mun Ferry Terminal,0,0,0,0,0,0,0,0,Friday
2021-11-26,Total,3500,148,61,3709,3838,101,76,4015,Friday
2021-11-27,Airport,575,7,40,622,1065,16,66,1147,Saturday
2021-11-27,Express Rail Link West Kowloon,0,0,0,0,0,0,0,0,Saturday
2021-11-27,Hung Hom,0,0,0,0,0,0,0,0,Saturday
2021-11-27,Lok Ma Chau Spur Line,0,0,0,0,0,0,0,0,Saturday
2021-11-27,Heung Yuen Wai,0,0,0,0,0,0,0,0,Saturday
2021-11-27,Hong Kong-Zhuhai-Macao Bridge,103,5,9,117,113,14,2,129,Saturday
2021-11-27,Lok Ma Chau,0,0,0,0,0,0,0,0,Saturday
2021-11-27,Man Kam To,0,0,0,0,0,0,0,0,Saturday
2021-11-27,Sha Tau Kok,0,0,0,0,0,0,0,0,Saturday
2021-11-27,Shenzhen Bay,790,164,7,961,565,82,2,649,Saturday
2021-11-27,China Ferry Terminal,0,0,0,0,0,0,0,0,Saturday
2021-11-27,Harbour Control,0,0,0,0,0,0,0,0,Saturday
2021-11-27,Kai Tak Cruise Terminal,0,0,0,0,0,0,0,0,Saturday
2021-11-27,Macau Ferry Terminal,0,0,0,0,0,0,0,0,Saturday
2021-11-27,Tuen Mun Ferry Terminal,0,0,0,0,0,0,0,0,Saturday
2021-11-27,Total,1468,176,56,1700,1743,112,70,1925,Saturday
2021-11-28,Airport,1438,9,30,1477,1793,10,66,1869,Sunday
2021-11-28,Express Rail Link West Kowloon,0,0,0,0,0,0,0,0,Sunday
2021-11-28,Hung Hom,0,0,0,0,0,0,0,0,Sunday
2021-11-28,Lo Wu,0,0,0,0,0,0,0,0,Sunday
2021-11-28,Lok Ma Chau Spur Line,0,0,0,0,0,0,0,0,Sunday
2021-11-28,Heung Yuen Wai,0,0,0,0,0,0,0,0,Sunday
2021-11-28,Hong Kong-Zhuhai-Macao Bridge,103,10,9,122,142,8,7,157,Sunday
2021-11-28,Lok Ma Chau,0,0,0,0,0,0,0,0,Sunday
2021-11-28,Man Kam To,0,0,0,0,0,0,0,0,Sunday
2021-11-28,Sha Tau Kok,0,0,0,0,0,0,0,0,Sunday
2021-11-28,Shenzhen Bay,949,171,15,1135,377,65,2,444,Sunday
2021-11-28,China Ferry Terminal,0,0,0,0,0,0,0,0,Sunday
2021-11-28,Harbour Control,0,0,0,0,0,0,0,0,Sunday
2021-11-28,Kai Tak Cruise Terminal,2753,0,0,2753,2799,0,0,2799,Sunday
2021-11-28,Macau Ferry Terminal,0,0,0,0,0,0,0,0,Sunday
2021-11-28,Tuen Mun Ferry Terminal,0,0,0,0,0,0,0,0,Sunday
2021-11-28,Total,5243,190,54,5487,5111,83,75,5269,Sunday
2021-11-29,Airport,406,6,16,428,716,12,22,750,Monday
2021-11-29,Express Rail Link West Kowloon,0,0,0,0,0,0,0,0,Monday
2021-11-29,Hung Hom,0,0,0,0,0,0,0,0,Monday
2021-11-29,Lo Wu,0,0,0,0,0,0,0,0,Monday
2021-11-29,Lok Ma Chau Spur Line,0,0,0,0,0,0,0,0,Monday
2021-11-29,Heung Yuen Wai,0,0,0,0,0,0,0,0,Monday
2021-11-29,Hong Kong-Zhuhai-Macao Bridge,94,19,10,123,80,8,0,88,Monday
2021-11-29,Lok Ma Chau,0,0,0,0,0,0,0,0,Monday
2021-11-29,Man Kam To,0,0,0,0,0,0,0,0,Monday
2021-11-29,Sha Tau Kok,0,0,0,0,0,0,0,0,Monday
2021-11-29,Shenzhen Bay,786,112,7,905,443,63,4,510,Monday
2021-11-29,China Ferry Terminal,0,0,0,0,0,0,0,0,Monday
2021-11-29,Harbour Control,0,0,0,0,0,0,0,0,Monday
2021-11-29,Kai Tak Cruise Terminal,0,0,0,0,0,0,0,0,Monday
2021-11-29,Macau Ferry Terminal,0,0,0,0,0,0,0,0,Monday
2021-11-29,Tuen Mun Ferry Terminal,0,0,0,0,0,0,0,0,Monday
2021-11-29,Total,1286,137,33,1456,1239,83,26,1348,Monday
2021-11-30,Airport,671,5,31,707,1146,11,45,1202,Tuesday
2021-11-30,Express Rail Link West Kowloon,0,0,0,0,0,0,0,0,Tuesday
2021-11-30,Hung Hom,0,0,0,0,0,0,0,0,Tuesday
2021-11-30,Lo Wu,0,0,0,0,0,0,0,0,Tuesday
2021-11-30,Lok Ma Chau Spur Line,0,0,0,0,0,0,0,0,Tuesday
2021-11-30,Heung Yuen Wai,0,0,0,0,0,0,0,0,Tuesday
2021-11-30,Hong Kong-Zhuhai-Macao Bridge,137,6,15,158,160,12,3,175,Tuesday
2021-11-30,Lok Ma Chau,0,0,0,0,0,0,0,0,Tuesday
2021-11-30,Man Kam To,0,0,0,0,0,0,0,0,Tuesday
2021-11-30,Sha Tau Kok,0,0,0,0,0,0,0,0,Tuesday
2021-11-30,Shenzhen Bay,1041,140,8,1189,502,87,2,591,Tuesday
2021-11-30,China Ferry Terminal,0,0,0,0,0,0,0,0,Tuesday
2021-11-30,Harbour Control,0,0,0,0,0,0,0,0,Tuesday
2021-11-30,Kai Tak Cruise Terminal,0,0,0,0,0,0,0,0,Tuesday
2021-11-30,Macau Ferry Terminal,0,0,0,0,0,0,0,0,Tuesday
2021-11-30,Tuen Mun Ferry Terminal,0,0,0,0,0,0,0,0,Tuesday
2021-11-30,Total,1849,151,54,2054,1808,110,50,1968,Tuesday
2021-12-01,Airport,1962,11,151,2124,1408,25,66,1499,Wednesday
2021-12-01,Express Rail Link West Kowloon,0,0,0,0,0,0,0,0,Wednesday
2021-12-01,Hung Hom,0,0,0,0,0,0,0,0,Wednesday
2021-12-01,Lo Wu,0,0,0,0,0,0,0,0,Wednesday
2021-12-01,Lok Ma Chau Spur Line,0,0,0,0,0,0,0,0,Wednesday
2021-12-01,Heung Yuen Wai,0,0,0,0,0,0,0,0,Wednesday
2021-12-01,Hong Kong-Zhuhai-Macao Bridge,151,7,22,180,182,14,7,203,Wednesday
2021-12-01,Lok Ma Chau,0,0,0,0,0,0,0,0,Wednesday
2021-12-01,Man Kam To,0,0,0,0,0,0,0,0,Wednesday
2021-12-01,Sha Tau Kok,0,0,0,0,0,0,0,0,Wednesday
2021-12-01,Shenzhen Bay,838,172,11,1021,966,120,3,1089,Wednesday
2021-12-01,China Ferry Terminal,0,0,0,0,0,0,0,0,Wednesday
2021-12-01,Harbour Control,0,0,0,0,0,0,0,0,Wednesday
2021-12-01,Kai Tak Cruise Terminal,2799,0,0,2799,1257,0,0,1257,Wednesday
2021-12-01,Macau Ferry Terminal,0,0,0,0,0,0,0,0,Wednesday
2021-12-01,Tuen Mun Ferry Terminal,0,0,0,0,0,0,0,0,Wednesday
2021-12-01,Total,5750,190,184,6124,3813,159,76,4048,Wednesday
2021-12-02,Airport,1141,13,85,1239,1125,15,49,1189,Thursday
2021-12-02,Express Rail Link West Kowloon,0,0,0,0,0,0,0,0,Thursday
2021-12-02,Hung Hom,0,0,0,0,0,0,0,0,Thursday
2021-12-02,Lo Wu,0,0,0,0,0,0,0,0,Thursday
2021-12-02,Lok Ma Chau Spur Line,0,0,0,0,0,0,0,0,Thursday
2021-12-02,Heung Yuen Wai,0,0,0,0,0,0,0,0,Thursday
2021-12-02,Hong Kong-Zhuhai-Macao Bridge,96,13,16,125,145,18,9,172,Thursday
2021-12-02,Lok Ma Chau,0,0,0,0,0,0,0,0,Thursday
2021-12-02,Man Kam To,0,0,0,0,0,0,0,0,Thursday
2021-12-02,Sha Tau Kok,0,0,0,0,0,0,0,0,Thursday
2021-12-02,Shenzhen Bay,755,152,13,920,694,115,0,809,Thursday
2021-12-02,China Ferry Terminal,0,0,0,0,0,0,0,0,Thursday
2021-12-02,Harbour Control,0,0,0,0,0,0,0,0,Thursday
2021-12-02,Kai Tak Cruise Terminal,0,0,0,0,0,0,0,0,Thursday
2021-12-02,Macau Ferry Terminal,0,0,0,0,0,0,0,0,Thursday
2021-12-02,Tuen Mun Ferry Terminal,0,0,0,0,0,0,0,0,Thursday
2021-12-02,Total,1992,178,114,2284,1964,148,58,2170,Thursday
2021-12-03,Airport,979,4,58,1041,1620,14,58,1692,Friday
2021-12-03,Express Rail Link West Kowloon,0,0,0,0,0,0,0,0,Friday
2021-12-03,Hung Hom,0,0,0,0,0,0,0,0,Friday
2021-12-03,Lo Wu,0,0,0,0,0,0,0,0,Friday
2021-12-03,Lok Ma Chau Spur Line,0,0,0,0,0,0,0,0,Friday
2021-12-03,Heung Yuen Wai,0,0,0,0,0,0,0,0,Friday
2021-12-03,Hong Kong-Zhuhai-Macao Bridge,110,12,28,150,173,16,8,197,Friday
2021-12-03,Lok Ma Chau,0,0,0,0,0,0,0,0,Friday
2021-12-03,Man Kam To,0,0,0,0,0,0,0,0,Friday
2021-12-03,Sha Tau Kok,0,0,0,0,0,0,0,0,Friday
2021-12-03,Shenzhen Bay,786,207,12,1005,742,132,3,877,Friday
2021-12-03,China Ferry Terminal,0,0,0,0,0,0,0,0,Friday
2021-12-03,Harbour Control,0,0,0,0,0,0,0,0,Friday
2021-12-03,Kai Tak Cruise Terminal,1257,0,0,1257,3328,0,0,3328,Friday
2021-12-03,Macau Ferry Terminal,0,0,0,0,0,0,0,0,Friday
2021-12-03,Tuen Mun Ferry Terminal,0,0,0,0,0,0,0,0,Friday
2021-12-03,Total,3132,223,98,3453,5863,162,69,6094,Friday
2021-12-04,Airport,679,24,41,744,1252,24,56,1332,Saturday
2021-12-04,Express Rail Link West Kowloon,0,0,0,0,0,0,0,0,Saturday
2021-12-04,Hung Hom,0,0,0,0,0,0,0,0,Saturday
2021-12-04,Lo Wu,0,0,0,0,0,0,0,0,Saturday
2021-12-04,Lok Ma Chau Spur Line,0,0,0,0,0,0,0,0,Saturday
2021-12-04,Heung Yuen Wai,0,0,0,0,0,0,0,0,Saturday
2021-12-04,Hong Kong-Zhuhai-Macao Bridge,99,9,13,121,140,17,4,161,Saturday
2021-12-04,Lok Ma Chau,0,0,0,0,0,0,0,0,Saturday
2021-12-04,Man Kam To,0,0,0,0,0,0,0,0,Saturday
2021-12-04,Sha Tau Kok,0,0,0,0,0,0,0,0,Saturday
2021-12-04,Shenzhen Bay,758,152,10,920,713,126,5,844,Saturday
2021-12-04,China Ferry Terminal,0,0,0,0,0,0,0,0,Saturday
2021-12-04,Harbour Control,0,0,0,0,0,0,0,0,Saturday
2021-12-04,Kai Tak Cruise Terminal,0,0,0,0,0,0,0,0,Saturday
2021-12-04,Macau Ferry Terminal,0,0,0,0,0,0,0,0,Saturday
2021-12-04,Tuen Mun Ferry Terminal,0,0,0,0,0,0,0,0,Saturday
2021-12-04,Total,1536,185,64,1785,2105,167,65,2337,Saturday
2021-12-05,Airport,1465,20,77,1562,1821,32,49,1902,Sunday
2021-12-05,Express Rail Link West Kowloon,0,0,0,0,0,0,0,0,Sunday
2021-12-05,Hung Hom,0,0,0,0,0,0,0,0,Sunday
2021-12-05,Lo Wu,0,0,0,0,0,0,0,0,Sunday
2021-12-05,Lok Ma Chau Spur Line,0,0,0,0,0,0,0,0,Sunday
2021-12-05,Heung Yuen Wai,0,0,0,0,0,0,0,0,Sunday
2021-12-05,Hong Kong-Zhuhai-Macao Bridge,133,7,18,158,105,83,10,198,Sunday
2021-12-05,Lok Ma Chau,0,0,0,0,0,0,0,0,Sunday
2021-12-05,Man Kam To,0,0,0,0,0,0,0,0,Sunday
2021-12-05,Sha Tau Kok,0,0,0,0,0,0,0,0,Sunday
2021-12-05,Shenzhen Bay,873,186,9,1068,603,107,2,712,Sunday
2021-12-05,China Ferry Terminal,0,0,0,0,0,0,0,0,Sunday
2021-12-05,Harbour Control,0,0,0,0,0,0,0,0,Sunday
2021-12-05,Kai Tak Cruise Terminal,3328,0,0,3328,2740,0,0,2740,Sunday
2021-12-05,Macau Ferry Terminal,0,0,0,0,0,0,0,0,Sunday
2021-12-05,Tuen Mun Ferry Terminal,0,0,0,0,0,0,0,0,Sunday
2021-12-05,Total,5799,213,104,6116,5269,222,61,5552,Sunday
2021-12-06,Airport,414,2,13,429,879,9,41,929,Monday
2021-12-06,Express Rail Link West Kowloon,0,0,0,0,0,0,0,0,Monday
2021-12-06,Hung Hom,0,0,0,0,0,0,0,0,Monday
2021-12-06,Lo Wu,0,0,0,0,0,0,0,0,Monday
2021-12-06,Lok Ma Chau Spur Line,0,0,0,0,0,0,0,0,Monday
2021-12-06,Heung Yuen Wai,0,0,0,0,0,0,0,0,Monday
2021-12-06,Hong Kong-Zhuhai-Macao Bridge,103,9,19,131,129,18,5,152,Monday
2021-12-06,Lok Ma Chau,0,0,0,0,0,0,0,0,Monday
2021-12-06,Man Kam To,0,0,0,0,0,0,0,0,Monday
2021-12-06,Sha Tau Kok,0,0,0,0,0,0,0,0,Monday
2021-12-06,Shenzhen Bay,637,141,11,789,528,114,2,644,Monday
2021-12-06,China Ferry Terminal,0,0,0,0,0,0,0,0,Monday
2021-12-06,Harbour Control,0,0,0,0,0,0,0,0,Monday
2021-12-06,Kai Tak Cruise Terminal,0,0,0,0,0,0,0,0,Monday
2021-12-06,Macau Ferry Terminal,0,0,0,0,0,0,0,0,Monday
2021-12-06,Tuen Mun Ferry Terminal,0,0,0,0,0,0,0,0,Monday
2021-12-06,Total,1154,152,43,1349,1536,141,48,1725,Monday
2021-12-07,Airport,599,4,19,622,1173,15,42,1230,Tuesday
2021-12-07,Express Rail Link West Kowloon,0,0,0,0,0,0,0,0,Tuesday
2021-12-07,Hung Hom,0,0,0,0,0,0,0,0,Tuesday
2021-12-07,Lo Wu,0,0,0,0,0,0,0,0,Tuesday
2021-12-07,Lok Ma Chau Spur Line,0,0,0,0,0,0,0,0,Tuesday
2021-12-07,Heung Yuen Wai,0,0,0,0,0,0,0,0,Tuesday
2021-12-07,Hong Kong-Zhuhai-Macao Bridge,108,5,22,135,138,5,5,148,Tuesday
2021-12-07,Lok Ma Chau,0,0,0,0,0,0,0,0,Tuesday
2021-12-07,Man Kam To,0,0,0,0,0,0,0,0,Tuesday
2021-12-07,Sha Tau Kok,0,0,0,0,0,0,0,0,Tuesday
2021-12-07,Shenzhen Bay,737,114,18,869,638,97,4,739,Tuesday
2021-12-07,China Ferry Terminal,0,0,0,0,0,0,0,0,Tuesday
2021-12-07,Harbour Control,0,0,0,0,0,0,0,0,Tuesday
2021-12-07,Kai Tak Cruise Terminal,0,0,0,0,0,0,0,0,Tuesday
2021-12-07,Macau Ferry Terminal,0,0,0,0,0,0,0,0,Tuesday
2021-12-07,Tuen Mun Ferry Terminal,0,0,0,0,0,0,0,0,Tuesday
2021-12-07,Total,1444,123,59,1626,1949,117,51,2117,Tuesday
2021-12-08,Airport,824,17,21,862,1233,10,45,1288,Wednesday
2021-12-08,Express Rail Link West Kowloon,0,0,0,0,0,0,0,0,Wednesday
2021-12-08,Hung Hom,0,0,0,0,0,0,0,0,Wednesday
2021-12-08,Lo Wu,0,0,0,0,0,0,0,0,Wednesday
2021-12-08,Lok Ma Chau Spur Line,0,0,0,0,0,0,0,0,Wednesday
2021-12-08,Heung Yuen Wai,0,0,0,0,0,0,0,0,Wednesday
2021-12-08,Hong Kong-Zhuhai-Macao Bridge,126,15,9,150,143,16,8,167,Wednesday
2021-12-08,Lok Ma Chau,0,0,0,0,0,0,0,0,Wednesday
2021-12-08,Man Kam To,0,0,0,0,0,0,0,0,Wednesday
2021-12-08,Sha Tau Kok,0,0,0,0,0,0,0,0,Wednesday
2021-12-08,Shenzhen Bay,791,124,11,926,651,127,7,785,Wednesday
2021-12-08,China Ferry Terminal,0,0,0,0,0,0,0,0,Wednesday
2021-12-08,Harbour Control,0,0,0,0,0,0,0,0,Wednesday
2021-12-08,Kai Tak Cruise Terminal,1237,0,0,1237,1201,0,0,1201,Wednesday
2021-12-08,Macau Ferry Terminal,0,0,0,0,0,0,0,0,Wednesday
2021-12-08,Tuen Mun Ferry Terminal,0,0,0,0,0,0,0,0,Wednesday
2021-12-08,Total,2978,156,41,3175,3228,153,60,3441,Wednesday
2021-12-09,Airport,719,11,26,756,1439,18,63,1520,Thursday
2021-12-09,Express Rail Link West Kowloon,0,0,0,0,0,0,0,0,Thursday
2021-12-09,Hung Hom,0,0,0,0,0,0,0,0,Thursday
2021-12-09,Lo Wu,0,0,0,0,0,0,0,0,Thursday
2021-12-09,Lok Ma Chau Spur Line,0,0,0,0,0,0,0,0,Thursday
2021-12-09,Heung Yuen Wai,0,0,0,0,0,0,0,0,Thursday
2021-12-09,Hong Kong-Zhuhai-Macao Bridge,117,16,17,150,157,12,6,175,Thursday
2021-12-09,Lok Ma Chau,0,0,0,0,0,0,0,0,Thursday
2021-12-09,Man Kam To,0,0,0,0,0,0,0,0,Thursday
2021-12-09,Sha Tau Kok,0,0,0,0,0,0,0,0,Thursday
2021-12-09,Shenzhen Bay,695,129,11,835,580,84,1,665,Thursday
2021-12-09,China Ferry Terminal,0,0,0,0,0,0,0,0,Thursday
2021-12-09,Harbour Control,0,0,0,0,0,0,0,0,Thursday
2021-12-09,Kai Tak Cruise Terminal,1503,0,0,1503,1269,0,0,1269,Thursday
2021-12-09,Macau Ferry Terminal,0,0,0,0,0,0,0,0,Thursday
2021-12-09,Tuen Mun Ferry Terminal,0,0,0,0,0,0,0,0,Thursday
2021-12-09,Total,3034,156,54,3244,3445,114,70,3629,Thursday
2021-12-10,Airport,1019,15,27,1061,1817,18,65,1900,Friday
2021-12-10,Express Rail Link West Kowloon,0,0,0,0,0,0,0,0,Friday
2021-12-10,Hung Hom,0,0,0,0,0,0,0,0,Friday
2021-12-10,Lo Wu,0,0,0,0,0,0,0,0,Friday
2021-12-10,Lok Ma Chau Spur Line,0,0,0,0,0,0,0,0,Friday
2021-12-10,Heung Yuen Wai,0,0,0,0,0,0,0,0,Friday
2021-12-10,Hong Kong-Zhuhai-Macao Bridge,165,5,22,192,179,5,7,191,Friday
2021-12-10,Lok Ma Chau,0,0,0,0,0,0,0,0,Friday
2021-12-10,Man Kam To,0,0,0,0,0,0,0,0,Friday
2021-12-10,Sha Tau Kok,0,0,0,0,0,0,0,0,Friday
2021-12-10,Shenzhen Bay,913,158,12,1083,814,123,5,942,Friday
2021-12-10,China Ferry Terminal,0,0,0,0,0,0,0,0,Friday
2021-12-10,Harbour Control,0,0,0,0,0,0,0,0,Friday
2021-12-10,Kai Tak Cruise Terminal,1201,0,0,1201,1482,0,0,1482,Friday
2021-12-10,Macau Ferry Terminal,0,0,0,0,0,0,0,0,Friday
2021-12-10,Tuen Mun Ferry Terminal,0,0,0,0,0,0,0,0,Friday
2021-12-10,Total,3298,178,61,3537,4292,146,77,4515,Friday
2021-12-12,Airport,1139,21,36,1196,1606,21,57,1684,Sunday
2021-12-12,Express Rail Link West Kowloon,0,0,0,0,0,0,0,0,Sunday
2021-12-12,Hung Hom,0,0,0,0,0,0,0,0,Sunday
2021-12-12,Lo Wu,0,0,0,0,0,0,0,0,Sunday
2021-12-12,Lok Ma Chau Spur Line,0,0,0,0,0,0,0,0,Sunday
2021-12-12,Heung Yuen Wai,0,0,0,0,0,0,0,0,Sunday
2021-12-12,Hong Kong-Zhuhai-Macao Bridge,116,14,16,146,121,20,7,148,Sunday
2021-12-12,Lok Ma Chau,0,0,0,0,0,0,0,0,Sunday
2021-12-12,Man Kam To,0,0,0,0,0,0,0,0,Sunday
2021-12-12,Sha Tau Kok,0,0,0,0,0,0,0,0,Sunday
2021-12-12,Shenzhen Bay,838,183,13,1034,553,83,5,641,Sunday
2021-12-12,China Ferry Terminal,0,0,0,0,0,0,0,0,Sunday
2021-12-12,Harbour Control,0,0,0,0,0,0,0,0,Sunday
2021-12-12,Kai Tak Cruise Terminal,2751,0,0,2751,3634,0,0,3634,Sunday
2021-12-12,Macau Ferry Terminal,0,0,0,0,0,0,0,0,Sunday
2021-12-12,Tuen Mun Ferry Terminal,0,0,0,0,0,0,0,0,Sunday
2021-12-12,Total,4844,218,65,5127,5914,124,69,6107,Sunday
2021-12-11,Airport,679,20,16,715,1563,26,44,1633,Saturday
2021-12-11,Express Rail Link West Kowloon,0,0,0,0,0,0,0,0,Saturday
2021-12-11,Hung Hom,0,0,0,0,0,0,0,0,Saturday
2021-12-11,Lo Wu,0,0,0,0,0,0,0,0,Saturday
2021-12-11,Lok Ma Chau Spur Line,0,0,0,0,0,0,0,0,Saturday
2021-12-11,Heung Yuen Wai,0,0,0,0,0,0,0,0,Saturday
2021-12-11,Hong Kong-Zhuhai-Macao Bridge,116,6,12,134,167,16,9,192,Saturday
2021-12-11,Lok Ma Chau,0,0,0,0,0,0,0,0,Saturday
2021-12-11,Man Kam To,0,0,0,0,0,0,0,0,Saturday
2021-12-11,Sha Tau Kok,0,0,0,0,0,0,0,0,Saturday
2021-12-11,Shenzhen Bay,804,149,11,964,645,107,2,754,Saturday
2021-12-11,China Ferry Terminal,0,0,0,0,0,0,0,0,Saturday
2021-12-11,Harbour Control,0,0,0,0,0,0,0,0,Saturday
2021-12-11,Kai Tak Cruise Terminal,0,0,0,0,0,0,0,0,Saturday
2021-12-11,Macau Ferry Terminal,0,0,0,0,0,0,0,0,Saturday
2021-12-11,Tuen Mun Ferry Terminal,0,0,0,0,0,0,0,0,Saturday
2021-12-11,Total,1599,175,39,1813,2375,149,55,2579,Saturday
2021-12-13,Airport,621,12,17,650,1255,8,36,1299,Monday
2021-12-13,Express Rail Link West Kowloon,0,0,0,0,0,0,0,0,Monday
2021-12-13,Hung Hom,0,0,0,0,0,0,0,0,Monday
2021-12-13,Lo Wu,0,0,0,0,0,0,0,0,Monday
2021-12-13,Lok Ma Chau Spur Line,0,0,0,0,0,0,0,0,Monday
2021-12-13,Heung Yuen Wai,0,0,0,0,0,0,0,0,Monday
2021-12-13,Hong Kong-Zhuhai-Macao Bridge,87,8,7,102,115,11,4,130,Monday
2021-12-13,Lok Ma Chau,0,0,0,0,0,0,0,0,Monday
2021-12-13,Man Kam To,0,0,0,0,0,0,0,0,Monday
2021-12-13,Sha Tau Kok,0,0,0,0,0,0,0,0,Monday
2021-12-13,Shenzhen Bay,708,128,11,847,668,122,1,791,Monday
2021-12-13,China Ferry Terminal,0,0,0,0,0,0,0,0,Monday
2021-12-13,Harbour Control,0,0,0,0,0,0,0,0,Monday
2021-12-13,Kai Tak Cruise Terminal,0,0,0,0,0,0,0,0,Monday
2021-12-13,Macau Ferry Terminal,0,0,0,0,0,0,0,0,Monday
2021-12-13,Tuen Mun Ferry Terminal,0,0,0,0,0,0,0,0,Monday
2021-12-13,Total,1416,148,35,1599,2038,141,41,2220,Monday
2021-12-14,Airport,484,4,11,499,1522,22,50,1594,Tuesday
2021-12-14,Express Rail Link West Kowloon,0,0,0,0,0,0,0,0,Tuesday
2021-12-14,Hung Hom,0,0,0,0,0,0,0,0,Tuesday
2021-12-14,Lo Wu,0,0,0,0,0,0,0,0,Tuesday
2021-12-14,Lok Ma Chau Spur Line,0,0,0,0,0,0,0,0,Tuesday
2021-12-14,Heung Yuen Wai,0,0,0,0,0,0,0,0,Tuesday
2021-12-14,Hong Kong-Zhuhai-Macao Bridge,111,6,16,133,115,16,2,133,Tuesday
2021-12-14,Lok Ma Chau,0,0,0,0,0,0,0,0,Tuesday
2021-12-14,Man Kam To,0,0,0,0,0,0,0,0,Tuesday
2021-12-14,Sha Tau Kok,0,0,0,0,0,0,0,0,Tuesday
2021-12-14,Shenzhen Bay,852,241,15,1108,738,132,3,873,Tuesday
2021-12-14,China Ferry Terminal,0,0,0,0,0,0,0,0,Tuesday
2021-12-14,Harbour Control,0,0,0,0,0,0,0,0,Tuesday
2021-12-14,Kai Tak Cruise Terminal,0,0,0,0,0,0,0,0,Tuesday
2021-12-14,Macau Ferry Terminal,0,0,0,0,0,0,0,0,Tuesday
2021-12-14,Tuen Mun Ferry Terminal,0,0,0,0,0,0,0,0,Tuesday
2021-12-14,Total,1447,251,42,1740,2375,170,55,2600,Tuesday
2021-12-15,Airport,1493,25,22,1540,1796,32,83,1911,Wednesday
2021-12-15,Express Rail Link West Kowloon,0,0,0,0,0,0,0,0,Wednesday
2021-12-15,Hung Hom,0,0,0,0,0,0,0,0,Wednesday
2021-12-15,Lo Wu,0,0,0,0,0,0,0,0,Wednesday
2021-12-15,Lok Ma Chau Spur Line,0,0,0,0,0,0,0,0,Wednesday
2021-12-15,Heung Yuen Wai,0,0,0,0,0,0,0,0,Wednesday
2021-12-15,Hong Kong-Zhuhai-Macao Bridge,153,7,12,172,158,26,7,191,Wednesday
2021-12-15,Lok Ma Chau,0,0,0,0,0,0,0,0,Wednesday
2021-12-15,Man Kam To,0,0,0,0,0,0,0,0,Wednesday
2021-12-15,Sha Tau Kok,0,0,0,0,0,0,0,0,Wednesday
2021-12-15,Shenzhen Bay,1067,193,30,1290,842,152,9,1003,Wednesday
2021-12-15,China Ferry Terminal,0,0,0,0,0,0,0,0,Wednesday
2021-12-15,Harbour Control,0,0,0,0,0,0,0,0,Wednesday
2021-12-15,Kai Tak Cruise Terminal,1755,0,0,1755,1409,0,0,1409,Wednesday
2021-12-15,Macau Ferry Terminal,0,0,0,0,0,0,0,0,Wednesday
2021-12-15,Tuen Mun Ferry Terminal,0,0,0,0,0,0,0,0,Wednesday
2021-12-15,Total,4468,225,64,4757,4205,210,99,4514,Wednesday
2021-12-17,Airport,943,3,37,983,1875,14,69,1958,Friday
2021-12-17,Express Rail Link West Kowloon,0,0,0,0,0,0,0,0,Friday
2021-12-17,Hung Hom,0,0,0,0,0,0,0,0,Friday
2021-12-17,Lo Wu,0,0,0,0,0,0,0,0,Friday
2021-12-17,Lok Ma Chau Spur Line,0,0,0,0,0,0,0,0,Friday
2021-12-17,Heung Yuen Wai,0,0,0,0,0,0,0,0,Friday
2021-12-17,Hong Kong-Zhuhai-Macao Bridge,284,18,22,324,203,22,9,234,Friday
2021-12-17,Lok Ma Chau,0,0,0,0,0,0,0,0,Friday
2021-12-17,Man Kam To,0,0,0,0,0,0,0,0,Friday
2021-12-17,Sha Tau Kok,0,0,0,0,0,0,0,0,Friday
2021-12-17,Shenzhen Bay,1132,165,14,1311,1050,154,3,1207,Friday
2021-12-17,China Ferry Terminal,0,0,0,0,0,0,0,0,Friday
2021-12-17,Harbour Control,0,0,0,0,0,0,0,0,Friday
2021-12-17,Kai Tak Cruise Terminal,1409,0,0,1409,1451,0,0,1451,Friday
2021-12-17,Macau Ferry Terminal,0,0,0,0,0,0,0,0,Friday
2021-12-17,Tuen Mun Ferry Terminal,0,0,0,0,0,0,0,0,Friday
2021-12-17,Total,3768,186,73,4027,4579,190,81,4850,Friday
2021-12-16,Airport,867,10,30,907,1693,15,43,1751,Thursday
2021-12-16,Express Rail Link West Kowloon,0,0,0,0,0,0,0,0,Thursday
2021-12-16,Hung Hom,0,0,0,0,0,0,0,0,Thursday
2021-12-16,Lo Wu,0,0,0,0,0,0,0,0,Thursday
2021-12-16,Lok Ma Chau Spur Line,0,0,0,0,0,0,0,0,Thursday
2021-12-16,Heung Yuen Wai,0,0,0,0,0,0,0,0,Thursday
2021-12-16,Hong Kong-Zhuhai-Macao Bridge,189,10,32,231,208,12,9,229,Thursday
2021-12-16,Lok Ma Chau,0,0,0,0,0,0,0,0,Thursday
2021-12-16,Man Kam To,0,0,0,0,0,0,0,0,Thursday
2021-12-16,Sha Tau Kok,0,0,0,0,0,0,0,0,Thursday
2021-12-16,Shenzhen Bay,1028,307,11,1346,897,109,2,1008,Thursday
2021-12-16,China Ferry Terminal,0,0,0,0,0,0,0,0,Thursday
2021-12-16,Harbour Control,0,0,0,0,0,0,0,0,Thursday
2021-12-16,Kai Tak Cruise Terminal,1879,0,0,1879,2048,0,0,2048,Thursday
2021-12-16,Macau Ferry Terminal,0,0,0,0,0,0,0,0,Thursday
2021-12-16,Tuen Mun Ferry Terminal,0,0,0,0,0,0,0,0,Thursday
2021-12-16,Total,3963,327,73,4363,4846,136,54,5036,Thursday
2021-12-18,Airport,919,22,28,969,1639,36,55,1730,Saturday
2021-12-18,Express Rail Link West Kowloon,0,0,0,0,0,0,0,0,Saturday
2021-12-18,Hung Hom,0,0,0,0,0,0,0,0,Saturday
2021-12-18,Lo Wu,0,0,0,0,0,0,0,0,Saturday
2021-12-18,Lok Ma Chau Spur Line,0,0,0,0,0,0,0,0,Saturday
2021-12-18,Heung Yuen Wai,0,0,0,0,0,0,0,0,Saturday
2021-12-18,Hong Kong-Zhuhai-Macao Bridge,185,22,33,240,194,16,8,218,Saturday
2021-12-18,Lok Ma Chau,0,0,0,0,0,0,0,0,Saturday
2021-12-18,Man Kam To,0,0,0,0,0,0,0,0,Saturday
2021-12-18,Sha Tau Kok,0,0,0,0,0,0,0,0,Saturday
2021-12-18,Shenzhen Bay,1027,210,8,1245,885,149,5,1039,Saturday
2021-12-18,China Ferry Terminal,0,0,0,0,0,0,0,0,Saturday
2021-12-18,Harbour Control,0,0,0,0,0,0,0,0,Saturday
2021-12-18,Kai Tak Cruise Terminal,2048,0,0,2048,1778,0,0,1778,Saturday
2021-12-18,Macau Ferry Terminal,0,0,0,0,0,0,0,0,Saturday
2021-12-18,Tuen Mun Ferry Terminal,0,0,0,0,0,0,0,0,Saturday
2021-12-18,Total,4179,254,69,4502,4496,201,68,4765,Saturday
2021-12-19,Airport,1313,30,25,1368,1944,15,65,2024,Sunday
2021-12-19,Express Rail Link West Kowloon,0,0,0,0,0,0,0,0,Sunday
2021-12-19,Lo Wu,5090,0,0,5090,5089,0,0,5089,Sunday
2021-12-19,Lok Ma Chau Spur Line,6978,0,0,6978,6977,0,0,6977,Sunday
2021-12-19,Heung Yuen Wai,5235,0,0,5235,5235,0,0,5235,Sunday
2021-12-19,Hong Kong-Zhuhai-Macao Bridge,148,14,17,179,168,19,25,212,Sunday
2021-12-19,Lok Ma Chau,0,0,0,0,0,0,0,0,Sunday
2021-12-19,Man Kam To,0,0,0,0,0,0,0,0,Sunday
2021-12-19,Sha Tau Kok,0,0,0,0,0,0,0,0,Sunday
2021-12-19,Shenzhen Bay,1007,225,12,1244,689,152,3,844,Sunday
2021-12-19,China Ferry Terminal,0,0,0,0,0,0,0,0,Sunday
2021-12-19,Harbour Control,0,0,0,0,0,0,0,0,Sunday
2021-12-19,Kai Tak Cruise Terminal,1451,0,0,1451,1473,0,0,1473,Sunday
2021-12-19,Macau Ferry Terminal,0,0,0,0,0,0,0,0,Sunday
2021-12-19,Tuen Mun Ferry Terminal,0,0,0,0,0,0,0,0,Sunday
2021-12-19,Total,21222,269,54,21545,21575,186,93,21854,Sunday
2021-12-20,Airport,657,15,20,692,1090,31,39,1160,Monday
2021-12-20,Express Rail Link West Kowloon,0,0,0,0,0,0,0,0,Monday
2021-12-20,Hung Hom,0,0,0,0,0,0,0,0,Monday
2021-12-20,Lo Wu,0,0,0,0,0,0,0,0,Monday
2021-12-20,Lok Ma Chau Spur Line,0,0,0,0,0,0,0,0,Monday
2021-12-20,Heung Yuen Wai,0,0,0,0,0,0,0,0,Monday
2021-12-20,Hong Kong-Zhuhai-Macao Bridge,143,7,10,160,180,19,6,205,Monday
2021-12-20,Lok Ma Chau,0,0,0,0,0,0,0,0,Monday
2021-12-20,Man Kam To,0,0,0,0,0,0,0,0,Monday
2021-12-20,Sha Tau Kok,0,0,0,0,0,0,0,0,Monday
2021-12-20,Shenzhen Bay,1058,192,12,1262,905,340,1,1246,Monday
2021-12-20,China Ferry Terminal,0,0,0,0,0,0,0,0,Monday
2021-12-20,Harbour Control,0,0,0,0,0,0,0,0,Monday
2021-12-20,Kai Tak Cruise Terminal,0,0,0,0,0,0,0,0,Monday
2021-12-20,Macau Ferry Terminal,0,0,0,0,0,0,0,0,Monday
2021-12-20,Tuen Mun Ferry Terminal,0,0,0,0,0,0,0,0,Monday
2021-12-20,Total,1858,214,42,2114,2175,390,46,2611,Monday
2021-12-21,Airport,518,7,20,545,1095,30,57,1182,Tuesday
2021-12-21,Express Rail Link West Kowloon,0,0,0,0,0,0,0,0,Tuesday
2021-12-21,Hung Hom,0,0,0,0,0,0,0,0,Tuesday
2021-12-21,Lo Wu,0,0,0,0,0,0,0,0,Tuesday
2021-12-21,Lok Ma Chau Spur Line,0,0,0,0,0,0,0,0,Tuesday
2021-12-21,Heung Yuen Wai,0,0,0,0,0,0,0,0,Tuesday
2021-12-21,Hong Kong-Zhuhai-Macao Bridge,75,27,15,117,196,22,4,222,Tuesday
2021-12-21,Lok Ma Chau,0,0,0,0,0,0,0,0,Tuesday
2021-12-21,Man Kam To,0,0,0,0,0,0,0,0,Tuesday
2021-12-21,Sha Tau Kok,0,0,0,0,0,0,0,0,Tuesday
2021-12-21,Shenzhen Bay,797,155,18,970,892,120,5,1017,Tuesday
2021-12-21,China Ferry Terminal,0,0,0,0,0,0,0,0,Tuesday
2021-12-21,Harbour Control,0,0,0,0,0,0,0,0,Tuesday
2021-12-21,Kai Tak Cruise Terminal,1778,0,0,1778,2043,0,0,2043,Tuesday
2021-12-21,Macau Ferry Terminal,0,0,0,0,0,0,0,0,Tuesday
2021-12-21,Tuen Mun Ferry Terminal,0,0,0,0,0,0,0,0,Tuesday
2021-12-21,Total,3168,189,53,3410,4226,172,66,4464,Tuesday
2021-12-22,Airport,782,18,28,828,1393,31,66,1490,Wednesday
2021-12-22,Express Rail Link West Kowloon,0,0,0,0,0,0,0,0,Wednesday
2021-12-22,Hung Hom,0,0,0,0,0,0,0,0,Wednesday
2021-12-22,Lo Wu,0,0,0,0,0,0,0,0,Wednesday
2021-12-22,Lok Ma Chau Spur Line,0,0,0,0,0,0,0,0,Wednesday
2021-12-22,Heung Yuen Wai,0,0,0,0,0,0,0,0,Wednesday
2021-12-22,Hong Kong-Zhuhai-Macao Bridge,98,9,18,125,202,34,9,245,Wednesday
2021-12-22,Lok Ma Chau,0,0,0,0,0,0,0,0,Wednesday
2021-12-22,Man Kam To,0,0,0,0,0,0,0,0,Wednesday
2021-12-22,Sha Tau Kok,0,0,0,0,0,0,0,0,Wednesday
2021-12-22,Shenzhen Bay,954,188,14,1156,807,121,0,928,Wednesday
2021-12-22,China Ferry Terminal,0,0,0,0,0,0,0,0,Wednesday
2021-12-22,Harbour Control,0,0,0,0,0,0,0,0,Wednesday
2021-12-22,Kai Tak Cruise Terminal,1473,0,0,1473,1925,0,0,1925,Wednesday
2021-12-22,Macau Ferry Terminal,0,0,0,0,0,0,0,0,Wednesday
2021-12-22,Tuen Mun Ferry Terminal,0,0,0,0,0,0,0,0,Wednesday
2021-12-22,Total,3307,215,60,3582,4327,186,75,4588,Wednesday
2021-12-23,Airport,502,9,19,530,989,16,43,1048,Thursday
2021-12-23,Express Rail Link West Kowloon,0,0,0,0,0,0,0,0,Thursday
2021-12-23,Hung Hom,0,0,0,0,0,0,0,0,Thursday
2021-12-23,Lo Wu,0,0,0,0,0,0,0,0,Thursday
2021-12-23,Lok Ma Chau Spur Line,0,0,0,0,0,0,0,0,Thursday
2021-12-23,Heung Yuen Wai,0,0,0,0,0,0,0,0,Thursday
2021-12-23,Hong Kong-Zhuhai-Macao Bridge,123,8,15,146,211,21,4,236,Thursday
2021-12-23,Lok Ma Chau,0,0,0,0,0,0,0,0,Thursday
2021-12-23,Man Kam To,0,0,0,0,0,0,0,0,Thursday
2021-12-23,Sha Tau Kok,0,0,0,0,0,0,0,0,Thursday
2021-12-23,Shenzhen Bay,914,193,17,1124,737,149,4,890,Thursday
2021-12-23,China Ferry Terminal,0,0,0,0,0,0,0,0,Thursday
2021-12-23,Harbour Control,0,0,0,0,0,0,0,0,Thursday
2021-12-23,Kai Tak Cruise Terminal,0,0,0,0,0,0,0,0,Thursday
2021-12-23,Macau Ferry Terminal,0,0,0,0,0,0,0,0,Thursday
2021-12-23,Tuen Mun Ferry Terminal,0,0,0,0,0,0,0,0,Thursday
2021-12-23,Total,1539,210,51,1800,1937,186,51,2174,Thursday
2021-12-25,Airport,606,14,10,630,775,26,36,837,Saturday
2021-12-25,Express Rail Link West Kowloon,0,0,0,0,0,0,0,0,Saturday
2021-12-25,Hung Hom,0,0,0,0,0,0,0,0,Saturday
2021-12-25,Lo Wu,0,0,0,0,0,0,0,0,Saturday
2021-12-25,Lok Ma Chau Spur Line,0,0,0,0,0,0,0,0,Saturday
2021-12-25,Heung Yuen Wai,0,0,0,0,0,0,0,0,Saturday
2021-12-25,Hong Kong-Zhuhai-Macao Bridge,78,6,11,95,182,32,0,214,Saturday
2021-12-25,Lok Ma Chau,0,0,0,0,0,0,0,0,Saturday
2021-12-25,Man Kam To,0,0,0,0,0,0,0,0,Saturday
2021-12-25,Sha Tau Kok,0,0,0,0,0,0,0,0,Saturday
2021-12-25,Shenzhen Bay,550,152,10,712,751,94,3,848,Saturday
2021-12-25,China Ferry Terminal,0,0,0,0,0,0,0,0,Saturday
2021-12-25,Harbour Control,0,0,0,0,0,0,0,0,Saturday
2021-12-25,Kai Tak Cruise Terminal,0,0,0,0,0,0,0,0,Saturday
2021-12-25,Macau Ferry Terminal,0,0,0,0,0,0,0,0,Saturday
2021-12-25,Tuen Mun Ferry Terminal,0,0,0,0,0,0,0,0,Saturday
2021-12-25,Total,1234,172,31,1437,1708,152,39,1899,Saturday
2021-12-24,Airport,750,9,39,798,859,22,43,924,Friday
2021-12-24,Express Rail Link West Kowloon,0,0,0,0,0,0,0,0,Friday
2021-12-24,Hung Hom,0,0,0,0,0,0,0,0,Friday
2021-12-24,Lo Wu,0,0,0,0,0,0,0,0,Friday
2021-12-24,Lok Ma Chau Spur Line,0,0,0,0,0,0,0,0,Friday
2021-12-24,Heung Yuen Wai,0,0,0,0,0,0,0,0,Friday
2021-12-24,Hong Kong-Zhuhai-Macao Bridge,95,11,13,119,215,11,7,233,Friday
2021-12-24,Lok Ma Chau,0,0,0,0,0,0,0,0,Friday
2021-12-24,Man Kam To,0,0,0,0,0,0,0,0,Friday
2021-12-24,Sha Tau Kok,0,0,0,0,0,0,0,0,Friday
2021-12-24,Shenzhen Bay,817,152,9,978,819,84,1,904,Friday
2021-12-24,China Ferry Terminal,0,0,0,0,0,0,0,0,Friday
2021-12-24,Harbour Control,0,0,0,0,0,0,0,0,Friday
2021-12-24,Kai Tak Cruise Terminal,3968,0,0,3968,4119,0,0,4119,Friday
2021-12-24,Macau Ferry Terminal,0,0,0,0,0,0,0,0,Friday
2021-12-24,Tuen Mun Ferry Terminal,0,0,0,0,0,0,0,0,Friday
2021-12-24,Total,5630,172,61,5863,6012,117,51,6180,Friday
2021-12-26,Airport,970,12,18,1000,1550,44,49,1643,Sunday
2021-12-26,Express Rail Link West Kowloon,0,0,0,0,0,0,0,0,Sunday
2021-12-26,Hung Hom,0,0,0,0,0,0,0,0,Sunday
2021-12-26,Lo Wu,0,0,0,0,0,0,0,0,Sunday
2021-12-26,Lok Ma Chau Spur Line,0,0,0,0,0,0,0,0,Sunday
2021-12-26,Heung Yuen Wai,0,0,0,0,0,0,0,0,Sunday
2021-12-26,Hong Kong-Zhuhai-Macao Bridge,63,8,14,85,220,18,3,241,Sunday
2021-12-26,Lok Ma Chau,0,0,0,0,0,0,0,0,Sunday
2021-12-26,Man Kam To,0,0,0,0,0,0,0,0,Sunday
2021-12-26,Sha Tau Kok,0,0,0,0,0,0,0,0,Sunday
2021-12-26,Shenzhen Bay,708,134,8,850,1605,211,1,1817,Sunday
2021-12-26,China Ferry Terminal,0,0,0,0,0,0,0,0,Sunday
2021-12-26,Harbour Control,0,0,0,0,0,0,0,0,Sunday
2021-12-26,Kai Tak Cruise Terminal,2448,0,0,2448,2082,0,0,2082,Sunday
2021-12-26,Macau Ferry Terminal,0,0,0,0,0,0,0,0,Sunday
2021-12-26,Tuen Mun Ferry Terminal,0,0,0,0,0,0,0,0,Sunday
2021-12-26,Total,4189,154,40,4383,5457,273,53,5783,Sunday
2021-12-27,Airport,660,12,19,691,1099,21,54,1174,Monday
2021-12-27,Express Rail Link West Kowloon,0,0,0,0,0,0,0,0,Monday
2021-12-27,Hung Hom,0,0,0,0,0,0,0,0,Monday
2021-12-27,Lo Wu,0,0,0,0,0,0,0,0,Monday
2021-12-27,Lok Ma Chau Spur Line,0,0,0,0,0,0,0,0,Monday
2021-12-27,Heung Yuen Wai,0,0,0,0,0,0,0,0,Monday
2021-12-27,Hong Kong-Zhuhai-Macao Bridge,100,12,21,133,219,23,2,244,Monday
2021-12-27,Lok Ma Chau,0,0,0,0,0,0,0,0,Monday
2021-12-27,Man Kam To,0,0,0,0,0,0,0,0,Monday
2021-12-27,Sha Tau Kok,0,0,0,0,0,0,0,0,Monday
2021-12-27,Shenzhen Bay,797,99,5,901,981,126,1,1108,Monday
2021-12-27,China Ferry Terminal,0,0,0,0,0,0,0,0,Monday
2021-12-27,Harbour Control,0,0,0,0,0,0,0,0,Monday
2021-12-27,Kai Tak Cruise Terminal,0,0,0,0,0,0,0,0,Monday
2021-12-27,Macau Ferry Terminal,0,0,0,0,0,0,0,0,Monday
2021-12-27,Tuen Mun Ferry Terminal,0,0,0,0,0,0,0,0,Monday
2021-12-27,Total,1557,123,45,1725,2299,170,57,2526,Monday
2021-12-28,Airport,415,2,5,422,1109,27,41,1177,Tuesday
2021-12-28,Express Rail Link West Kowloon,0,0,0,0,0,0,0,0,Tuesday
2021-12-28,Hung Hom,0,0,0,0,0,0,0,0,Tuesday
2021-12-28,Lo Wu,0,0,0,0,0,0,0,0,Tuesday
2021-12-28,Lok Ma Chau Spur Line,0,0,0,0,0,0,0,0,Tuesday
2021-12-28,Heung Yuen Wai,0,0,0,0,0,0,0,0,Tuesday
2021-12-28,Hong Kong-Zhuhai-Macao Bridge,98,14,18,130,215,23,3,241,Tuesday
2021-12-28,Lok Ma Chau,0,0,0,0,0,0,0,0,Tuesday
2021-12-28,Man Kam To,0,0,0,0,0,0,0,0,Tuesday
2021-12-28,Sha Tau Kok,0,0,0,0,0,0,0,0,Tuesday
2021-12-28,Shenzhen Bay,935,140,16,1091,675,125,2,802,Tuesday
2021-12-28,China Ferry Terminal,0,0,0,0,0,0,0,0,Tuesday
2021-12-28,Harbour Control,0,0,0,0,0,0,0,0,Tuesday
2021-12-28,Kai Tak Cruise Terminal,1671,0,0,1671,2232,0,0,2232,Tuesday
2021-12-28,Macau Ferry Terminal,0,0,0,0,0,0,0,0,Tuesday
2021-12-28,Tuen Mun Ferry Terminal,0,0,0,0,0,0,0,0,Tuesday
2021-12-28,Total,3119,156,39,3314,4231,175,46,4452,Tuesday
2021-12-29,Airport,786,23,24,833,1120,35,63,1218,Wednesday
2021-12-29,Express Rail Link West Kowloon,0,0,0,0,0,0,0,0,Wednesday
2021-12-29,Hung Hom,0,0,0,0,0,0,0,0,Wednesday
2021-12-29,Lo Wu,0,0,0,0,0,0,0,0,Wednesday
2021-12-29,Lok Ma Chau Spur Line,0,0,0,0,0,0,0,0,Wednesday
2021-12-29,Heung Yuen Wai,0,0,0,0,0,0,0,0,Wednesday
2021-12-29,Hong Kong-Zhuhai-Macao Bridge,108,11,10,129,184,36,4,224,Wednesday
2021-12-29,Lok Ma Chau,0,0,0,0,0,0,0,0,Wednesday
2021-12-29,Man Kam To,0,0,0,0,0,0,0,0,Wednesday
2021-12-29,Sha Tau Kok,0,0,0,0,0,0,0,0,Wednesday
2021-12-29,Shenzhen Bay,800,137,15,952,755,86,5,846,Wednesday
2021-12-29,China Ferry Terminal,0,0,0,0,0,0,0,0,Wednesday
2021-12-29,Harbour Control,0,0,0,0,0,0,0,0,Wednesday
2021-12-29,Kai Tak Cruise Terminal,2082,0,0,2082,2405,0,0,2405,Wednesday
2021-12-29,Macau Ferry Terminal,0,0,0,0,0,0,0,0,Wednesday
2021-12-29,Tuen Mun Ferry Terminal,0,0,0,0,0,0,0,0,Wednesday
2021-12-29,Total,3776,171,49,3996,4464,157,72,4693,Wednesday
2021-12-30,Airport,607,8,24,639,1019,19,40,1078,Thursday
2021-12-30,Express Rail Link West Kowloon,0,0,0,0,0,0,0,0,Thursday
2021-12-30,Hung Hom,0,0,0,0,0,0,0,0,Thursday
2021-12-30,Lo Wu,0,0,0,0,0,0,0,0,Thursday
2021-12-30,Lok Ma Chau Spur Line,0,0,0,0,0,0,0,0,Thursday
2021-12-30,Heung Yuen Wai,0,0,0,0,0,0,0,0,Thursday
2021-12-30,Hong Kong-Zhuhai-Macao Bridge,109,12,5,126,26,0,7,33,Thursday
2021-12-30,Lok Ma Chau,0,0,0,0,0,0,0,0,Thursday
2021-12-30,Man Kam To,0,0,0,0,0,0,0,0,Thursday
2021-12-30,Sha Tau Kok,0,0,0,0,0,0,0,0,Thursday
2021-12-30,Shenzhen Bay,791,142,17,950,795,139,3,937,Thursday
2021-12-30,China Ferry Terminal,0,0,0,0,0,0,0,0,Thursday
2021-12-30,Harbour Control,0,0,0,0,0,0,0,0,Thursday
2021-12-30,Kai Tak Cruise Terminal,2232,0,0,2232,2261,0,0,2261,Thursday
2021-12-30,Macau Ferry Terminal,0,0,0,0,0,0,0,0,Thursday
2021-12-30,Tuen Mun Ferry Terminal,0,0,0,0,0,0,0,0,Thursday
2021-12-30,Total,3739,162,46,3947,4101,158,50,4309,Thursday
2021-12-31,Airport,380,4,10,394,1241,32,56,1329,Friday
2021-12-31,Express Rail Link West Kowloon,0,0,0,0,0,0,0,0,Friday
2021-12-31,Hung Hom,0,0,0,0,0,0,0,0,Friday
2021-12-31,Lo Wu,0,0,0,0,0,0,0,0,Friday
2021-12-31,Lok Ma Chau Spur Line,0,0,0,0,0,0,0,0,Friday
2021-12-31,Heung Yuen Wai,0,0,0,0,0,0,0,0,Friday
2021-12-31,Hong Kong-Zhuhai-Macao Bridge,127,9,16,152,217,31,4,252,Friday
2021-12-31,Lok Ma Chau,0,0,0,0,0,0,0,0,Friday
2021-12-31,Man Kam To,0,0,0,0,0,0,0,0,Friday
2021-12-31,Sha Tau Kok,0,0,0,0,0,0,0,0,Friday
2021-12-31,Shenzhen Bay,1035,150,11,1196,855,120,13,988,Friday
2021-12-31,China Ferry Terminal,0,0,0,0,0,0,0,0,Friday
2021-12-31,Harbour Control,0,0,0,0,0,0,0,0,Friday
2021-12-31,Kai Tak Cruise Terminal,2405,0,0,2405,2362,0,0,2362,Friday
2021-12-31,Macau Ferry Terminal,0,0,0,0,0,0,0,0,Friday
2021-12-31,Tuen Mun Ferry Terminal,0,0,0,0,0,0,0,0,Friday
2021-12-31,Total,3947,163,37,4147,4675,183,73,4931,Friday
2022-01-01,Airport,609,3,16,628,720,14,44,778,Saturday
2022-01-01,Express Rail Link West Kowloon,0,0,0,0,0,0,0,0,Saturday
2022-01-01,Hung Hom,0,0,0,0,0,0,0,0,Saturday
2022-01-01,Lo Wu,0,0,0,0,0,0,0,0,Saturday
2022-01-01,Lok Ma Chau Spur Line,0,0,0,0,0,0,0,0,Saturday
2022-01-01,Heung Yuen Wai,0,0,0,0,0,0,0,0,Saturday
2022-01-01,Hong Kong-Zhuhai-Macao Bridge,67,4,7,78,219,13,2,234,Saturday
2022-01-01,Lok Ma Chau,0,0,0,0,0,0,0,0,Saturday
2022-01-01,Man Kam To,0,0,0,0,0,0,0,0,Saturday
2022-01-01,Sha Tau Kok,0,0,0,0,0,0,0,0,Saturday
2022-01-01,Shenzhen Bay,495,126,6,627,892,109,2,1003,Saturday
2022-01-01,China Ferry Terminal,0,0,0,0,0,0,0,0,Saturday
2022-01-01,Harbour Control,0,0,0,0,0,0,0,0,Saturday
2022-01-01,Kai Tak Cruise Terminal,0,0,0,0,0,0,0,0,Saturday
2022-01-01,Macau Ferry Terminal,0,0,0,0,0,0,0,0,Saturday
2022-01-01,Tuen Mun Ferry Terminal,0,0,0,0,0,0,0,0,Saturday
2022-01-01,Total,1171,133,29,1333,1831,136,48,2015,Saturday
2022-01-02,Airport,958,15,7,980,1543,62,94,1699,Sunday
2022-01-02,Express Rail Link West Kowloon,0,0,0,0,0,0,0,0,Sunday
2022-01-02,Hung Hom,0,0,0,0,0,0,0,0,Sunday
2022-01-02,Lo Wu,0,0,0,0,0,0,0,0,Sunday
2022-01-02,Lok Ma Chau Spur Line,0,0,0,0,0,0,0,0,Sunday
2022-01-02,Heung Yuen Wai,0,0,0,0,0,0,0,0,Sunday
2022-01-02,Hong Kong-Zhuhai-Macao Bridge,119,10,14,143,225,14,7,246,Sunday
2022-01-02,Lok Ma Chau,0,0,0,0,0,0,0,0,Sunday
2022-01-02,Man Kam To,0,0,0,0,0,0,0,0,Sunday
2022-01-02,Sha Tau Kok,0,0,0,0,0,0,0,0,Sunday
2022-01-02,Shenzhen Bay,785,133,15,933,960,137,2,1099,Sunday
2022-01-02,China Ferry Terminal,0,0,0,0,0,0,0,0,Sunday
2022-01-02,Harbour Control,0,0,0,0,0,0,0,0,Sunday
2022-01-02,Kai Tak Cruise Terminal,4623,0,0,4623,3610,0,0,3610,Sunday
2022-01-02,Macau Ferry Terminal,0,0,0,0,0,0,0,0,Sunday
2022-01-02,Tuen Mun Ferry Terminal,0,0,0,0,0,0,0,0,Sunday
2022-01-02,Total,6485,158,36,6679,6338,213,103,6654,Sunday
2022-01-04,Airport,554,15,25,594,1287,27,44,1358,Tuesday
2022-01-04,Express Rail Link West Kowloon,0,0,0,0,0,0,0,0,Tuesday
2022-01-04,Hung Hom,0,0,0,0,0,0,0,0,Tuesday
2022-01-04,Lo Wu,0,0,0,0,0,0,0,0,Tuesday
2022-01-04,Lok Ma Chau Spur Line,0,0,0,0,0,0,0,0,Tuesday
2022-01-04,Heung Yuen Wai,0,0,0,0,0,0,0,0,Tuesday
2022-01-04,Hong Kong-Zhuhai-Macao Bridge,70,8,11,89,238,24,7,269,Tuesday
2022-01-04,Lok Ma Chau,0,0,0,0,0,0,0,0,Tuesday
2022-01-04,Man Kam To,0,0,0,0,0,0,0,0,Tuesday
2022-01-04,Sha Tau Kok,0,0,0,0,0,0,0,0,Tuesday
2022-01-04,Shenzhen Bay,644,116,5,765,1096,136,7,1239,Tuesday
2022-01-04,China Ferry Terminal,0,0,0,0,0,0,0,0,Tuesday
2022-01-04,Harbour Control,0,0,0,0,0,0,0,0,Tuesday
2022-01-04,Kai Tak Cruise Terminal,0,0,0,0,0,0,0,0,Tuesday
2022-01-04,Macau Ferry Terminal,0,0,0,0,0,0,0,0,Tuesday
2022-01-04,Tuen Mun Ferry Terminal,0,0,0,0,0,0,0,0,Tuesday
2022-01-04,Total,1268,139,41,1448,2621,187,58,2866,Tuesday
2022-01-03,Airport,756,12,5,773,1024,26,38,1088,Monday
2022-01-03,Express Rail Link West Kowloon,0,0,0,0,0,0,0,0,Monday
2022-01-03,Hung Hom,0,0,0,0,0,0,0,0,Monday
2022-01-03,Lo Wu,0,0,0,0,0,0,0,0,Monday
2022-01-03,Lok Ma Chau Spur Line,0,0,0,0,0,0,0,0,Monday
2022-01-03,Heung Yuen Wai,0,0,0,0,0,0,0,0,Monday
2022-01-03,Hong Kong-Zhuhai-Macao Bridge,80,13,13,106,257,17,2,276,Monday
2022-01-03,Lok Ma Chau,0,0,0,0,0,0,0,0,Monday
2022-01-03,Man Kam To,0,0,0,0,0,0,0,0,Monday
2022-01-03,Sha Tau Kok,0,0,0,0,0,0,0,0,Monday
2022-01-03,Shenzhen Bay,724,95,12,831,1224,146,4,1374,Monday
2022-01-03,China Ferry Terminal,0,0,0,0,0,0,0,0,Monday
2022-01-03,Harbour Control,0,0,0,0,0,0,0,0,Monday
2022-01-03,Kai Tak Cruise Terminal,0,0,0,0,0,0,0,0,Monday
2022-01-03,Macau Ferry Terminal,0,0,0,0,0,0,0,0,Monday
2022-01-03,Tuen Mun Ferry Terminal,0,0,0,0,0,0,0,0,Monday
2022-01-03,Total,1560,120,30,1710,2505,189,44,2738,Monday
2022-01-05,Airport,729,15,16,760,1028,36,58,1122,Wednesday
2022-01-05,Express Rail Link West Kowloon,0,0,0,0,0,0,0,0,Wednesday
2022-01-05,Hung Hom,0,0,0,0,0,0,0,0,Wednesday
2022-01-05,Lo Wu,0,0,0,0,0,0,0,0,Wednesday
2022-01-05,Lok Ma Chau Spur Line,0,0,0,0,0,0,0,0,Wednesday
2022-01-05,Heung Yuen Wai,0,0,0,0,0,0,0,0,Wednesday
2022-01-05,Hong Kong-Zhuhai-Macao Bridge,90,9,11,110,228,12,5,245,Wednesday
2022-01-05,Lok Ma Chau,0,0,0,0,0,0,0,0,Wednesday
2022-01-05,Man Kam To,0,0,0,0,0,0,0,0,Wednesday
2022-01-05,Sha Tau Kok,0,0,0,0,0,0,0,0,Wednesday
2022-01-05,Shenzhen Bay,756,108,16,880,1078,151,6,1235,Wednesday
2022-01-05,China Ferry Terminal,0,0,0,0,0,0,0,0,Wednesday
2022-01-05,Harbour Control,0,0,0,0,0,0,0,0,Wednesday
2022-01-05,Kai Tak Cruise Terminal,3610,0,0,3610,0,0,0,0,Wednesday
2022-01-05,Macau Ferry Terminal,0,0,0,0,0,0,0,0,Wednesday
2022-01-05,Tuen Mun Ferry Terminal,0,0,0,0,0,0,0,0,Wednesday
2022-01-05,Total,5185,132,43,5360,2334,199,69,2602,Wednesday
2022-01-07,Airport,344,11,33,388,1963,62,78,2103,Friday
2022-01-07,Express Rail Link West Kowloon,0,0,0,0,0,0,0,0,Friday
2022-01-07,Hung Hom,0,0,0,0,0,0,0,0,Friday
2022-01-07,Lo Wu,0,0,0,0,0,0,0,0,Friday
2022-01-07,Lok Ma Chau Spur Line,0,0,0,0,0,0,0,0,Friday
2022-01-07,Heung Yuen Wai,0,0,0,0,0,0,0,0,Friday
2022-01-07,Hong Kong-Zhuhai-Macao Bridge,95,2,15,112,273,12,9,294,Friday
2022-01-07,Lok Ma Chau,0,0,0,0,0,0,0,0,Friday
2022-01-07,Man Kam To,0,0,0,0,0,0,0,0,Friday
2022-01-07,Sha Tau Kok,0,0,0,0,0,0,0,0,Friday
2022-01-07,Shenzhen Bay,879,155,19,1053,1134,152,6,1292,Friday
2022-01-07,China Ferry Terminal,0,0,0,0,0,0,0,0,Friday
2022-01-07,Harbour Control,0,0,0,0,0,0,0,0,Friday
2022-01-07,Kai Tak Cruise Terminal,0,0,0,0,0,0,0,0,Friday
2022-01-07,Macau Ferry Terminal,0,0,0,0,0,0,0,0,Friday
2022-01-07,Tuen Mun Ferry Terminal,0,0,0,0,0,0,0,0,Friday
2022-01-07,Total,1318,168,67,1553,3370,226,93,3689,Friday
2022-01-06,Airport,682,10,15,707,989,17,53,1059,Thursday
2022-01-06,Express Rail Link West Kowloon,0,0,0,0,0,0,0,0,Thursday
2022-01-06,Hung Hom,0,0,0,0,0,0,0,0,Thursday
2022-01-06,Lo Wu,0,0,0,0,0,0,0,0,Thursday
2022-01-06,Lok Ma Chau Spur Line,0,0,0,0,0,0,0,0,Thursday
2022-01-06,Heung Yuen Wai,0,0,0,0,0,0,0,0,Thursday
2022-01-06,Hong Kong-Zhuhai-Macao Bridge,77,5,11,93,227,16,4,247,Thursday
2022-01-06,Lok Ma Chau,0,0,0,0,0,0,0,0,Thursday
2022-01-06,Man Kam To,0,0,0,0,0,0,0,0,Thursday
2022-01-06,Sha Tau Kok,0,0,0,0,0,0,0,0,Thursday
2022-01-06,Shenzhen Bay,771,137,14,922,1080,157,1,1238,Thursday
2022-01-06,China Ferry Terminal,0,0,0,0,0,0,0,0,Thursday
2022-01-06,Harbour Control,0,0,0,0,0,0,0,0,Thursday
2022-01-06,Kai Tak Cruise Terminal,0,0,0,0,0,0,0,0,Thursday
2022-01-06,Macau Ferry Terminal,0,0,0,0,0,0,0,0,Thursday
2022-01-06,Tuen Mun Ferry Terminal,0,0,0,0,0,0,0,0,Thursday
2022-01-06,Total,1530,152,40,1722,2296,190,58,2544,Thursday
2022-01-08,Airport,782,10,12,804,1308,63,53,1424,Saturday
2022-01-08,Express Rail Link West Kowloon,0,0,0,0,0,0,0,0,Saturday
2022-01-08,Hung Hom,0,0,0,0,0,0,0,0,Saturday
2022-01-08,Lo Wu,0,0,0,0,0,0,0,0,Saturday
2022-01-08,Lok Ma Chau Spur Line,0,0,0,0,0,0,0,0,Saturday
2022-01-08,Heung Yuen Wai,0,0,0,0,0,0,0,0,Saturday
2022-01-08,Hong Kong-Zhuhai-Macao Bridge,124,13,4,141,297,9,20,326,Saturday
2022-01-08,Lok Ma Chau,0,0,0,0,0,0,0,0,Saturday
2022-01-08,Man Kam To,0,0,0,0,0,0,0,0,Saturday
2022-01-08,Sha Tau Kok,0,0,0,0,0,0,0,0,Saturday
2022-01-08,Shenzhen Bay,844,157,17,1018,1139,152,1,1292,Saturday
2022-01-08,China Ferry Terminal,0,0,0,0,0,0,0,0,Saturday
2022-01-08,Harbour Control,0,0,0,0,0,0,0,0,Saturday
2022-01-08,Kai Tak Cruise Terminal,0,0,0,0,0,0,0,0,Saturday
2022-01-08,Macau Ferry Terminal,0,0,0,0,0,0,0,0,Saturday
2022-01-08,Tuen Mun Ferry Terminal,0,0,0,0,0,0,0,0,Saturday
2022-01-08,Total,1750,180,33,1963,2744,224,74,3042,Saturday
2022-01-09,Airport,683,20,3,706,1798,48,97,1943,Sunday
2022-01-09,Express Rail Link West Kowloon,0,0,0,0,0,0,0,0,Sunday
2022-01-09,Hung Hom,0,0,0,0,0,0,0,0,Sunday
2022-01-09,Lo Wu,0,0,0,0,0,0,0,0,Sunday
2022-01-09,Lok Ma Chau Spur Line,0,0,0,0,0,0,0,0,Sunday
2022-01-09,Heung Yuen Wai,0,0,0,0,0,0,0,0,Sunday
2022-01-09,Hong Kong-Zhuhai-Macao Bridge,136,12,9,157,272,11,10,293,Sunday
2022-01-09,Lok Ma Chau,0,0,0,0,0,0,0,0,Sunday
2022-01-09,Man Kam To,0,0,0,0,0,0,0,0,Sunday
2022-01-09,Sha Tau Kok,0,0,0,0,0,0,0,0,Sunday
2022-01-09,Shenzhen Bay,934,201,12,1147,1000,97,3,1100,Sunday
2022-01-09,China Ferry Terminal,0,0,0,0,0,0,0,0,Sunday
2022-01-09,Harbour Control,0,0,0,0,0,0,0,0,Sunday
2022-01-09,Kai Tak Cruise Terminal,0,0,0,0,0,0,0,0,Sunday
2022-01-09,Macau Ferry Terminal,0,0,0,0,0,0,0,0,Sunday
2022-01-09,Tuen Mun Ferry Terminal,0,0,0,0,0,0,0,0,Sunday
2022-01-09,Total,1753,233,24,2010,3070,156,110,3336,Sunday
2022-01-10,Airport,174,14,7,195,1059,55,40,1154,Monday
2022-01-10,Express Rail Link West Kowloon,0,0,0,0,0,0,0,0,Monday
2022-01-10,Hung Hom,0,0,0,0,0,0,0,0,Monday
2022-01-10,Lo Wu,0,0,0,0,0,0,0,0,Monday
2022-01-10,Lok Ma Chau Spur Line,0,0,0,0,0,0,0,0,Monday
2022-01-10,Heung Yuen Wai,0,0,0,0,0,0,0,0,Monday
2022-01-10,Hong Kong-Zhuhai-Macao Bridge,115,11,14,140,257,13,8,278,Monday
2022-01-10,Lok Ma Chau,0,0,0,0,0,0,0,0,Monday
2022-01-10,Man Kam To,0,0,0,0,0,0,0,0,Monday
2022-01-10,Sha Tau Kok,0,0,0,0,0,0,0,0,Monday
2022-01-10,Shenzhen Bay,760,107,5,872,936,104,1,1041,Monday
2022-01-10,China Ferry Terminal,0,0,0,0,0,0,0,0,Monday
2022-01-10,Harbour Control,0,0,0,0,0,0,0,0,Monday
2022-01-10,Kai Tak Cruise Terminal,0,0,0,0,0,0,0,0,Monday
2022-01-10,Macau Ferry Terminal,0,0,0,0,0,0,0,0,Monday
2022-01-10,Tuen Mun Ferry Terminal,0,0,0,0,0,0,0,0,Monday
2022-01-10,Total,1049,132,26,1207,2252,172,49,2473,Monday
2022-01-11,Airport,150,12,3,165,1056,47,39,1142,Tuesday
2022-01-11,Express Rail Link West Kowloon,0,0,0,0,0,0,0,0,Tuesday
2022-01-11,Hung Hom,0,0,0,0,0,0,0,0,Tuesday
2022-01-11,Lo Wu,0,0,0,0,0,0,0,0,Tuesday
2022-01-11,Lok Ma Chau Spur Line,0,0,0,0,0,0,0,0,Tuesday
2022-01-11,Heung Yuen Wai,0,0,0,0,0,0,0,0,Tuesday
2022-01-11,Hong Kong-Zhuhai-Macao Bridge,102,14,20,136,214,12,12,238,Tuesday
2022-01-11,Lok Ma Chau,0,0,0,0,0,0,0,0,Tuesday
2022-01-11,Man Kam To,0,0,0,0,0,0,0,0,Tuesday
2022-01-11,Sha Tau Kok,0,0,0,0,0,0,0,0,Tuesday
2022-01-11,Shenzhen Bay,797,128,9,934,958,120,4,1082,Tuesday
2022-01-11,China Ferry Terminal,0,0,0,0,0,0,0,0,Tuesday
2022-01-11,Harbour Control,0,0,0,0,0,0,0,0,Tuesday
2022-01-11,Kai Tak Cruise Terminal,0,0,0,0,0,0,0,0,Tuesday
2022-01-11,Macau Ferry Terminal,0,0,0,0,0,0,0,0,Tuesday
2022-01-11,Tuen Mun Ferry Terminal,0,0,0,0,0,0,0,0,Tuesday
2022-01-11,Total,1049,154,32,1235,2228,179,55,2462,Tuesday
2022-01-12,Airport,620,14,13,647,1156,38,45,1239,Wednesday
2022-01-12,Express Rail Link West Kowloon,0,0,0,0,0,0,0,0,Wednesday
2022-01-12,Hung Hom,0,0,0,0,0,0,0,0,Wednesday
2022-01-12,Lo Wu,0,0,0,0,0,0,0,0,Wednesday
2022-01-12,Lok Ma Chau Spur Line,0,0,0,0,0,0,0,0,Wednesday
2022-01-12,Heung Yuen Wai,0,0,0,0,0,0,0,0,Wednesday
2022-01-12,Hong Kong-Zhuhai-Macao Bridge,170,26,4,200,240,18,3,261,Wednesday
2022-01-12,Lok Ma Chau,0,0,0,0,0,0,0,0,Wednesday
2022-01-12,Man Kam To,0,0,0,0,0,0,0,0,Wednesday
2022-01-12,Sha Tau Kok,0,0,0,0,0,0,0,0,Wednesday
2022-01-12,Shenzhen Bay,858,153,9,1020,1055,137,2,1194,Wednesday
2022-01-12,China Ferry Terminal,0,0,0,0,0,0,0,0,Wednesday
2022-01-12,Harbour Control,0,0,0,0,0,0,0,0,Wednesday
2022-01-12,Kai Tak Cruise Terminal,0,0,0,0,0,0,0,0,Wednesday
2022-01-12,Macau Ferry Terminal,0,0,0,0,0,0,0,0,Wednesday
2022-01-12,Tuen Mun Ferry Terminal,0,0,0,0,0,0,0,0,Wednesday
2022-01-12,Total,1648,193,26,1867,2451,193,50,2694,Wednesday
2022-01-13,Airport,175,28,10,213,716,17,29,762,Thursday
2022-01-13,Express Rail Link West Kowloon,0,0,0,0,0,0,0,0,Thursday
2022-01-13,Hung Hom,0,0,0,0,0,0,0,0,Thursday
2022-01-13,Lo Wu,0,0,0,0,0,0,0,0,Thursday
2022-01-13,Lok Ma Chau Spur Line,0,0,0,0,0,0,0,0,Thursday
2022-01-13,Heung Yuen Wai,0,0,0,0,0,0,0,0,Thursday
2022-01-13,Hong Kong-Zhuhai-Macao Bridge,175,17,5,197,241,17,3,261,Thursday
2022-01-13,Lok Ma Chau,0,0,0,0,0,0,0,0,Thursday
2022-01-13,Man Kam To,0,0,0,0,0,0,0,0,Thursday
2022-01-13,Sha Tau Kok,0,0,0,0,0,0,0,0,Thursday
2022-01-13,Shenzhen Bay,888,184,11,1083,1217,168,2,1387,Thursday
2022-01-13,China Ferry Terminal,0,0,0,0,0,0,0,0,Thursday
2022-01-13,Harbour Control,0,0,0,0,0,0,0,0,Thursday
2022-01-13,Kai Tak Cruise Terminal,0,0,0,0,0,0,0,0,Thursday
2022-01-13,Macau Ferry Terminal,0,0,0,0,0,0,0,0,Thursday
2022-01-13,Tuen Mun Ferry Terminal,0,0,0,0,0,0,0,0,Thursday
2022-01-13,Total,1238,229,26,1493,2174,202,34,2410,Thursday
2022-01-14,Airport,560,23,34,617,1512,35,51,1598,Friday
2022-01-14,Express Rail Link West Kowloon,0,0,0,0,0,0,0,0,Friday
2022-01-14,Hung Hom,0,0,0,0,0,0,0,0,Friday
2022-01-14,Lo Wu,0,0,0,0,0,0,0,0,Friday
2022-01-14,Lok Ma Chau Spur Line,0,0,0,0,0,0,0,0,Friday
2022-01-14,Heung Yuen Wai,0,0,0,0,0,0,0,0,Friday
2022-01-14,Hong Kong-Zhuhai-Macao Bridge,225,15,11,251,227,10,4,241,Friday
2022-01-14,Lok Ma Chau,0,0,0,0,0,0,0,0,Friday
2022-01-14,Man Kam To,0,0,0,0,0,0,0,0,Friday
2022-01-14,Sha Tau Kok,0,0,0,0,0,0,0,0,Friday
2022-01-14,Shenzhen Bay,980,156,14,1150,1133,224,9,1366,Friday
2022-01-14,China Ferry Terminal,0,0,0,0,0,0,0,0,Friday
2022-01-14,Harbour Control,0,0,0,0,0,0,0,0,Friday
2022-01-14,Kai Tak Cruise Terminal,0,0,0,0,0,0,0,0,Friday
2022-01-14,Macau Ferry Terminal,0,0,0,0,0,0,0,0,Friday
2022-01-14,Tuen Mun Ferry Terminal,0,0,0,0,0,0,0,0,Friday
2022-01-14,Total,1765,194,59,2018,2872,269,64,3205,Friday
2022-01-15,Airport,535,20,20,575,1125,32,57,1214,Saturday
2022-01-15,Express Rail Link West Kowloon,0,0,0,0,0,0,0,0,Saturday
2022-01-15,Hung Hom,0,0,0,0,0,0,0,0,Saturday
2022-01-15,Lo Wu,0,0,0,0,0,0,0,0,Saturday
2022-01-15,Lok Ma Chau Spur Line,0,0,0,0,0,0,0,0,Saturday
2022-01-15,Heung Yuen Wai,0,0,0,0,0,0,0,0,Saturday
2022-01-15,Hong Kong-Zhuhai-Macao Bridge,214,26,17,257,196,12,8,216,Saturday
2022-01-15,Lok Ma Chau,0,0,0,0,0,0,0,0,Saturday
2022-01-15,Man Kam To,0,0,0,0,0,0,0,0,Saturday
2022-01-15,Sha Tau Kok,0,0,0,0,0,0,0,0,Saturday
2022-01-15,Shenzhen Bay,1197,184,19,1400,1087,200,1,1288,Saturday
2022-01-15,China Ferry Terminal,0,0,0,0,0,0,0,0,Saturday
2022-01-15,Harbour Control,0,0,0,0,0,0,0,0,Saturday
2022-01-15,Kai Tak Cruise Terminal,0,0,0,0,0,0,0,0,Saturday
2022-01-15,Macau Ferry Terminal,0,0,0,0,0,0,0,0,Saturday
2022-01-15,Tuen Mun Ferry Terminal,0,0,0,0,0,0,0,0,Saturday
2022-01-15,Total,1946,230,56,2232,2408,244,66,2718,Saturday
2022-01-16,Airport,894,24,14,932,1379,35,72,1486,Sunday
2022-01-16,Express Rail Link West Kowloon,0,0,0,0,0,0,0,0,Sunday
2022-01-16,Hung Hom,0,0,0,0,0,0,0,0,Sunday
2022-01-16,Lo Wu,0,0,0,0,0,0,0,0,Sunday
2022-01-16,Lok Ma Chau Spur Line,0,0,0,0,0,0,0,0,Sunday
2022-01-16,Heung Yuen Wai,0,0,0,0,0,0,0,0,Sunday
2022-01-16,Hong Kong-Zhuhai-Macao Bridge,150,11,7,168,198,16,13,227,Sunday
2022-01-16,Lok Ma Chau,0,0,0,0,0,0,0,0,Sunday
2022-01-16,Man Kam To,0,0,0,0,0,0,0,0,Sunday
2022-01-16,Sha Tau Kok,0,0,0,0,0,0,0,0,Sunday
2022-01-16,Shenzhen Bay,1037,223,7,1267,981,162,2,1145,Sunday
2022-01-16,China Ferry Terminal,0,0,0,0,0,0,0,0,Sunday
2022-01-16,Harbour Control,0,0,0,0,0,0,0,0,Sunday
2022-01-16,Kai Tak Cruise Terminal,0,0,0,0,0,0,0,0,Sunday
2022-01-16,Macau Ferry Terminal,0,0,0,0,0,0,0,0,Sunday
2022-01-16,Tuen Mun Ferry Terminal,0,0,0,0,0,0,0,0,Sunday
2022-01-16,Total,2081,258,28,2367,2558,213,87,2858,Sunday
2022-01-17,Airport,268,10,9,287,873,21,51,945,Monday
2022-01-17,Express Rail Link West Kowloon,0,0,0,0,0,0,0,0,Monday
2022-01-17,Hung Hom,0,0,0,0,0,0,0,0,Monday
2022-01-17,Lo Wu,0,0,0,0,0,0,0,0,Monday
2022-01-17,Lok Ma Chau Spur Line,0,0,0,0,0,0,0,0,Monday
2022-01-17,Heung Yuen Wai,0,0,0,0,0,0,0,0,Monday
2022-01-17,Hong Kong-Zhuhai-Macao Bridge,150,12,14,176,217,13,4,234,Monday
2022-01-17,Lok Ma Chau,0,0,0,0,0,0,0,0,Monday
2022-01-17,Man Kam To,0,0,0,0,0,0,0,0,Monday
2022-01-17,Sha Tau Kok,0,0,0,0,0,0,0,0,Monday
2022-01-17,Shenzhen Bay,812,110,8,930,885,158,4,1047,Monday
2022-01-17,China Ferry Terminal,0,0,0,0,0,0,0,0,Monday
2022-01-17,Harbour Control,0,0,0,0,0,0,0,0,Monday
2022-01-17,Kai Tak Cruise Terminal,0,0,0,0,0,0,0,0,Monday
2022-01-17,Macau Ferry Terminal,0,0,0,0,0,0,0,0,Monday
2022-01-17,Tuen Mun Ferry Terminal,0,0,0,0,0,0,0,0,Monday
2022-01-17,Total,1230,132,31,1393,1975,192,59,2226,Monday
2022-01-18,Airport,139,8,17,164,955,27,37,1019,Tuesday
2022-01-18,Express Rail Link West Kowloon,0,0,0,0,0,0,0,0,Tuesday
2022-01-18,Hung Hom,0,0,0,0,0,0,0,0,Tuesday
2022-01-18,Lo Wu,0,0,0,0,0,0,0,0,Tuesday
2022-01-18,Lok Ma Chau Spur Line,0,0,0,0,0,0,0,0,Tuesday
2022-01-18,Heung Yuen Wai,0,0,0,0,0,0,0,0,Tuesday
2022-01-18,Hong Kong-Zhuhai-Macao Bridge,71,0,3,74,64,0,5,69,Tuesday
2022-01-18,Lok Ma Chau,0,0,0,0,0,0,0,0,Tuesday
2022-01-18,Man Kam To,0,0,0,0,0,0,0,0,Tuesday
2022-01-18,Sha Tau Kok,0,0,0,0,0,0,0,0,Tuesday
2022-01-18,Shenzhen Bay,985,163,5,1153,834,134,0,968,Tuesday
2022-01-18,China Ferry Terminal,0,0,0,0,0,0,0,0,Tuesday
2022-01-18,Harbour Control,0,0,0,0,0,0,0,0,Tuesday
2022-01-18,Kai Tak Cruise Terminal,0,0,0,0,0,0,0,0,Tuesday
2022-01-18,Macau Ferry Terminal,0,0,0,0,0,0,0,0,Tuesday
2022-01-18,Tuen Mun Ferry Terminal,0,0,0,0,0,0,0,0,Tuesday
2022-01-18,Total,1195,171,25,1391,1853,161,42,2056,Tuesday
2022-01-20,Airport,248,18,25,291,503,19,24,546,Thursday
2022-01-20,Express Rail Link West Kowloon,0,0,0,0,0,0,0,0,Thursday
2022-01-20,Hung Hom,0,0,0,0,0,0,0,0,Thursday
2022-01-20,Lo Wu,0,0,0,0,0,0,0,0,Thursday
2022-01-20,Lok Ma Chau Spur Line,0,0,0,0,0,0,0,0,Thursday
2022-01-20,Heung Yuen Wai,0,0,0,0,0,0,0,0,Thursday
2022-01-20,Hong Kong-Zhuhai-Macao Bridge,54,1,5,60,33,0,10,43,Thursday
2022-01-20,Lok Ma Chau,0,0,0,0,0,0,0,0,Thursday
2022-01-20,Man Kam To,0,0,0,0,0,0,0,0,Thursday
2022-01-20,Sha Tau Kok,0,0,0,0,0,0,0,0,Thursday
2022-01-20,Shenzhen Bay,1299,223,5,1527,698,98,2,798,Thursday
2022-01-20,China Ferry Terminal,0,0,0,0,0,0,0,0,Thursday
2022-01-20,Harbour Control,0,0,0,0,0,0,0,0,Thursday
2022-01-20,Kai Tak Cruise Terminal,0,0,0,0,0,0,0,0,Thursday
2022-01-20,Macau Ferry Terminal,0,0,0,0,0,0,0,0,Thursday
2022-01-20,Tuen Mun Ferry Terminal,0,0,0,0,0,0,0,0,Thursday
2022-01-20,Total,1601,242,35,1878,1234,117,36,1387,Thursday
2022-01-21,Airport,539,20,5,564,1278,24,44,1346,Friday
2022-01-21,Express Rail Link West Kowloon,0,0,0,0,0,0,0,0,Friday
2022-01-21,Hung Hom,0,0,0,0,0,0,0,0,Friday
2022-01-21,Lo Wu,0,0,0,0,0,0,0,0,Friday
2022-01-21,Lok Ma Chau Spur Line,0,0,0,0,0,0,0,0,Friday
2022-01-21,Heung Yuen Wai,0,0,0,0,0,0,0,0,Friday
2022-01-21,Hong Kong-Zhuhai-Macao Bridge,82,0,10,92,57,0,14,71,Friday
2022-01-21,Lok Ma Chau,0,0,0,0,0,0,0,0,Friday
2022-01-21,Man Kam To,0,0,0,0,0,0,0,0,Friday
2022-01-21,Sha Tau Kok,0,0,0,0,0,0,0,0,Friday
2022-01-21,Shenzhen Bay,1602,188,7,1797,977,182,5,1164,Friday
2022-01-21,China Ferry Terminal,0,0,0,0,0,0,0,0,Friday
2022-01-21,Harbour Control,0,0,0,0,0,0,0,0,Friday
2022-01-21,Kai Tak Cruise Terminal,0,0,0,0,0,0,0,0,Friday
2022-01-21,Macau Ferry Terminal,0,0,0,0,0,0,0,0,Friday
2022-01-21,Tuen Mun Ferry Terminal,0,0,0,0,0,0,0,0,Friday
2022-01-21,Total,2223,208,22,2453,2312,206,63,2581,Friday
2022-01-22,Airport,416,19,12,447,753,17,21,791,Saturday
2022-01-28,Sha Tau Kok,0,0,0,0,0,0,0,0,Friday
2022-01-22,Express Rail Link West Kowloon,0,0,0,0,0,0,0,0,Saturday
2022-01-22,Hung Hom,0,0,0,0,0,0,0,0,Saturday
2022-01-22,Lo Wu,0,0,0,0,0,0,0,0,Saturday
2022-01-22,Lok Ma Chau Spur Line,0,0,0,0,0,0,0,0,Saturday
2022-01-22,Heung Yuen Wai,0,0,0,0,0,0,0,0,Saturday
2022-01-22,Hong Kong-Zhuhai-Macao Bridge,46,0,5,51,52,0,6,58,Saturday
2022-01-22,Lok Ma Chau,0,0,0,0,0,0,0,0,Saturday
2022-01-22,Man Kam To,0,0,0,0,0,0,0,0,Saturday
2022-01-22,Sha Tau Kok,0,0,0,0,0,0,0,0,Saturday
2022-01-22,Shenzhen Bay,1619,242,12,1873,1037,172,7,1216,Saturday
2022-01-22,China Ferry Terminal,0,0,0,0,0,0,0,0,Saturday
2022-01-22,Harbour Control,0,0,0,0,0,0,0,0,Saturday
2022-01-22,Kai Tak Cruise Terminal,0,0,0,0,0,0,0,0,Saturday
2022-01-22,Macau Ferry Terminal,0,0,0,0,0,0,0,0,Saturday
2022-01-22,Tuen Mun Ferry Terminal,0,0,0,0,0,0,0,0,Saturday
2022-01-22,Total,2081,261,29,2371,1842,189,34,2065,Saturday
2022-01-23,Airport,618,24,25,667,1715,36,54,1805,Sunday
2022-01-23,Express Rail Link West Kowloon,0,0,0,0,0,0,0,0,Sunday
2022-01-23,Hung Hom,0,0,0,0,0,0,0,0,Sunday
2022-01-23,Lo Wu,0,0,0,0,0,0,0,0,Sunday
2022-01-23,Lok Ma Chau Spur Line,0,0,0,0,0,0,0,0,Sunday
2022-01-23,Heung Yuen Wai,0,0,0,0,0,0,0,0,Sunday
2022-01-23,Hong Kong-Zhuhai-Macao Bridge,40,0,4,44,53,0,8,61,Sunday
2022-01-23,Lok Ma Chau,0,0,0,0,0,0,0,0,Sunday
2022-01-23,Man Kam To,0,0,0,0,0,0,0,0,Sunday
2022-01-23,Sha Tau Kok,0,0,0,0,0,0,0,0,Sunday
2022-01-23,Shenzhen Bay,1246,206,7,1459,827,151,3,981,Sunday
2022-01-23,China Ferry Terminal,0,0,0,0,0,0,0,0,Sunday
2022-01-23,Harbour Control,0,0,0,0,0,0,0,0,Sunday
2022-01-23,Kai Tak Cruise Terminal,0,0,0,0,0,0,0,0,Sunday
2022-01-23,Macau Ferry Terminal,0,0,0,0,0,0,0,0,Sunday
2022-01-23,Tuen Mun Ferry Terminal,0,0,0,0,0,0,0,0,Sunday
2022-01-23,Total,1904,230,36,2170,2595,187,65,2847,Sunday
2022-01-24,Airport,349,16,12,377,783,24,40,847,Monday
2022-01-24,Express Rail Link West Kowloon,0,0,0,0,0,0,0,0,Monday
2022-01-24,Hung Hom,0,0,0,0,0,0,0,0,Monday
2022-01-24,Lo Wu,0,0,0,0,0,0,0,0,Monday
2022-01-24,Lok Ma Chau Spur Line,0,0,0,0,0,0,0,0,Monday
2022-01-24,Heung Yuen Wai,0,0,0,0,0,0,0,0,Monday
2022-01-24,Hong Kong-Zhuhai-Macao Bridge,37,0,7,44,45,0,5,50,Monday
2022-01-24,Lok Ma Chau,0,0,0,0,0,0,0,0,Monday
2022-01-24,Man Kam To,0,0,0,0,0,0,0,0,Monday
2022-01-24,Sha Tau Kok,0,0,0,0,0,0,0,0,Monday
2022-01-24,Shenzhen Bay,860,132,5,997,867,144,1,1012,Monday
2022-01-24,China Ferry Terminal,0,0,0,0,0,0,0,0,Monday
2022-01-24,Harbour Control,0,0,0,0,0,0,0,0,Monday
2022-01-24,Kai Tak Cruise Terminal,0,0,0,0,0,0,0,0,Monday
2022-01-24,Macau Ferry Terminal,0,0,0,0,0,0,0,0,Monday
2022-01-24,Tuen Mun Ferry Terminal,0,0,0,0,0,0,0,0,Monday
2022-01-24,Total,1246,148,24,1418,1695,168,46,1909,Monday
2022-01-25,Airport,206,3,13,222,868,12,26,906,Tuesday
2022-01-25,Express Rail Link West Kowloon,0,0,0,0,0,0,0,0,Tuesday
2022-01-25,Hung Hom,0,0,0,0,0,0,0,0,Tuesday
2022-01-25,Lo Wu,0,0,0,0,0,0,0,0,Tuesday
2022-01-25,Lok Ma Chau Spur Line,0,0,0,0,0,0,0,0,Tuesday
2022-01-25,Heung Yuen Wai,0,0,0,0,0,0,0,0,Tuesday
2022-01-25,Hong Kong-Zhuhai-Macao Bridge,40,0,10,50,64,0,11,75,Tuesday
2022-01-25,Lok Ma Chau,0,0,0,0,0,0,0,0,Tuesday
2022-01-25,Man Kam To,0,0,0,0,0,0,0,0,Tuesday
2022-01-25,Sha Tau Kok,0,0,0,0,0,0,0,0,Tuesday
2022-01-25,Shenzhen Bay,1339,148,12,1499,833,137,4,974,Tuesday
2022-01-25,China Ferry Terminal,0,0,0,0,0,0,0,0,Tuesday
2022-01-25,Harbour Control,0,0,0,0,0,0,0,0,Tuesday
2022-01-25,Kai Tak Cruise Terminal,0,0,0,0,0,0,0,0,Tuesday
2022-01-25,Macau Ferry Terminal,0,0,0,0,0,0,0,0,Tuesday
2022-01-25,Tuen Mun Ferry Terminal,0,0,0,0,0,0,0,0,Tuesday
2022-01-25,Total,1585,151,35,1771,1765,149,41,1955,Tuesday
2022-01-26,Airport,678,7,21,706,1119,20,34,1173,Wednesday
2022-01-26,Express Rail Link West Kowloon,0,0,0,0,0,0,0,0,Wednesday
2022-01-26,Hung Hom,0,0,0,0,0,0,0,0,Wednesday
2022-01-26,Lo Wu,0,0,0,0,0,0,0,0,Wednesday
2022-01-26,Lok Ma Chau Spur Line,0,0,0,0,0,0,0,0,Wednesday
2022-01-26,Heung Yuen Wai,0,0,0,0,0,0,0,0,Wednesday
2022-01-26,Hong Kong-Zhuhai-Macao Bridge,54,0,7,61,44,0,3,47,Wednesday
2022-01-26,Lok Ma Chau,0,0,0,0,0,0,0,0,Wednesday
2022-01-26,Man Kam To,0,0,0,0,0,0,0,0,Wednesday
2022-01-26,Sha Tau Kok,0,0,0,0,0,0,0,0,Wednesday
2022-01-26,Shenzhen Bay,1495,174,7,1676,714,132,5,851,Wednesday
2022-01-26,China Ferry Terminal,0,0,0,0,0,0,0,0,Wednesday
2022-01-26,Harbour Control,0,0,0,0,0,0,0,0,Wednesday
2022-01-26,Kai Tak Cruise Terminal,0,0,0,0,0,0,0,0,Wednesday
2022-01-26,Macau Ferry Terminal,0,0,0,0,0,0,0,0,Wednesday
2022-01-26,Tuen Mun Ferry Terminal,0,0,0,0,0,0,0,0,Wednesday
2022-01-26,Total,2227,181,35,2443,1877,152,42,2071,Wednesday
2022-01-28,Airport,508,12,13,533,1092,13,36,1141,Friday
2022-01-28,Express Rail Link West Kowloon,0,0,0,0,0,0,0,0,Friday
2022-01-28,Hung Hom,0,0,0,0,0,0,0,0,Friday
2022-01-28,Lo Wu,0,0,0,0,0,0,0,0,Friday
2022-01-28,Lok Ma Chau Spur Line,0,0,0,0,0,0,0,0,Friday
2022-01-28,Heung Yuen Wai,0,0,0,0,0,0,0,0,Friday
2022-01-28,Hong Kong-Zhuhai-Macao Bridge,139,0,14,153,34,0,7,41,Friday
2022-01-28,Lok Ma Chau,0,0,0,0,0,0,0,0,Friday
2022-01-28,Man Kam To,0,0,0,0,0,0,0,0,Friday
2022-01-28,Shenzhen Bay,1440,188,10,1638,664,120,5,789,Friday
2022-01-28,China Ferry Terminal,0,0,0,0,0,0,0,0,Friday
2022-01-28,Harbour Control,0,0,0,0,0,0,0,0,Friday
2022-01-28,Kai Tak Cruise Terminal,0,0,0,0,0,0,0,0,Friday
2022-01-28,Macau Ferry Terminal,0,0,0,0,0,0,0,0,Friday
2022-01-28,Tuen Mun Ferry Terminal,0,0,0,0,0,0,0,0,Friday
2022-01-28,Total,2087,200,37,2324,1790,133,48,1971,Friday
2022-01-27,Airport,389,9,13,411,514,11,32,557,Thursday
2022-01-27,Express Rail Link West Kowloon,0,0,0,0,0,0,0,0,Thursday
2022-01-27,Hung Hom,0,0,0,0,0,0,0,0,Thursday
2022-01-27,Lo Wu,0,0,0,0,0,0,0,0,Thursday
2022-01-27,Lok Ma Chau Spur Line,0,0,0,0,0,0,0,0,Thursday
2022-01-27,Heung Yuen Wai,0,0,0,0,0,0,0,0,Thursday
2022-01-27,Hong Kong-Zhuhai-Macao Bridge,69,0,12,81,36,0,6,42,Thursday
2022-01-27,Lok Ma Chau,0,0,0,0,0,0,0,0,Thursday
2022-01-27,Man Kam To,0,0,0,0,0,0,0,0,Thursday
2022-01-27,Sha Tau Kok,0,0,0,0,0,0,0,0,Thursday
2022-01-27,Shenzhen Bay,1397,191,4,1592,645,100,10,755,Thursday
2022-01-27,China Ferry Terminal,0,0,0,0,0,0,0,0,Thursday
2022-01-27,Harbour Control,0,0,0,0,0,0,0,0,Thursday
2022-01-27,Kai Tak Cruise Terminal,0,0,0,0,0,0,0,0,Thursday
2022-01-27,Macau Ferry Terminal,0,0,0,0,0,0,0,0,Thursday
2022-01-27,Tuen Mun Ferry Terminal,0,0,0,0,0,0,0,0,Thursday
2022-01-27,Total,1855,200,29,2084,1195,111,48,1354,Thursday
2022-01-29,Airport,426,13,12,451,610,12,29,651,Saturday
2022-01-29,Express Rail Link West Kowloon,0,0,0,0,0,0,0,0,Saturday
2022-01-29,Hung Hom,0,0,0,0,0,0,0,0,Saturday
2022-01-29,Lo Wu,0,0,0,0,0,0,0,0,Saturday
2022-01-29,Lok Ma Chau Spur Line,0,0,0,0,0,0,0,0,Saturday
2022-01-29,Heung Yuen Wai,0,0,0,0,0,0,0,0,Saturday
2022-01-29,Hong Kong-Zhuhai-Macao Bridge,93,0,15,108,25,0,3,28,Saturday
2022-01-29,Lok Ma Chau,0,0,0,0,0,0,0,0,Saturday
2022-01-29,Man Kam To,0,0,0,0,0,0,0,0,Saturday
2022-01-29,Sha Tau Kok,0,0,0,0,0,0,0,0,Saturday
2022-01-29,Shenzhen Bay,907,179,8,1094,824,103,3,930,Saturday
2022-01-29,China Ferry Terminal,0,0,0,0,0,0,0,0,Saturday
2022-01-29,Harbour Control,0,0,0,0,0,0,0,0,Saturday
2022-01-29,Kai Tak Cruise Terminal,0,0,0,0,0,0,0,0,Saturday
2022-01-29,Macau Ferry Terminal,0,0,0,0,0,0,0,0,Saturday
2022-01-29,Tuen Mun Ferry Terminal,0,0,0,0,0,0,0,0,Saturday
2022-01-29,Total,1426,192,35,1653,1459,115,35,1609,Saturday
2022-01-30,Airport,508,16,11,535,1442,15,50,1507,Sunday
2022-01-30,Express Rail Link West Kowloon,0,0,0,0,0,0,0,0,Sunday
2022-01-30,Hung Hom,0,0,0,0,0,0,0,0,Sunday
2022-01-30,Lo Wu,0,0,0,0,0,0,0,0,Sunday
2022-01-30,Lok Ma Chau Spur Line,0,0,0,0,0,0,0,0,Sunday
2022-01-30,Heung Yuen Wai,0,0,0,0,0,0,0,0,Sunday
2022-01-30,Hong Kong-Zhuhai-Macao Bridge,41,1,10,52,33,0,3,36,Sunday
2022-01-30,Lok Ma Chau,0,0,0,0,0,0,0,0,Sunday
2022-01-30,Man Kam To,0,0,0,0,0,0,0,0,Sunday
2022-01-30,Sha Tau Kok,0,0,0,0,0,0,0,0,Sunday
2022-01-30,Shenzhen Bay,723,134,6,863,804,125,2,931,Sunday
2022-01-30,China Ferry Terminal,0,0,0,0,0,0,0,0,Sunday
2022-01-30,Harbour Control,0,0,0,0,0,0,0,0,Sunday
2022-01-30,Kai Tak Cruise Terminal,0,0,0,0,0,0,0,0,Sunday
2022-01-30,Macau Ferry Terminal,0,0,0,0,0,0,0,0,Sunday
2022-01-30,Tuen Mun Ferry Terminal,0,0,0,0,0,0,0,0,Sunday
2022-01-30,Total,1272,151,27,1450,2279,140,55,2474,Sunday
2022-01-31,Airport,87,1,12,100,564,1,24,589,Monday
2022-01-31,Express Rail Link West Kowloon,0,0,0,0,0,0,0,0,Monday
2022-01-31,Hung Hom,0,0,0,0,0,0,0,0,Monday
2022-01-31,Lo Wu,0,0,0,0,0,0,0,0,Monday
2022-01-31,Lok Ma Chau Spur Line,0,0,0,0,0,0,0,0,Monday
2022-01-31,Heung Yuen Wai,0,0,0,0,0,0,0,0,Monday
2022-01-31,Hong Kong-Zhuhai-Macao Bridge,51,8,8,67,19,0,2,21,Monday
2022-01-31,Lok Ma Chau,0,0,0,0,0,0,0,0,Monday
2022-01-31,Man Kam To,0,0,0,0,0,0,0,0,Monday
2022-01-31,Sha Tau Kok,0,0,0,0,0,0,0,0,Monday
2022-01-31,Shenzhen Bay,237,49,12,298,782,96,3,881,Monday
2022-01-31,China Ferry Terminal,0,0,0,0,0,0,0,0,Monday
2022-01-31,Harbour Control,0,0,0,0,0,0,0,0,Monday
2022-01-31,Kai Tak Cruise Terminal,0,0,0,0,0,0,0,0,Monday
2022-01-31,Macau Ferry Terminal,0,0,0,0,0,0,0,0,Monday
2022-01-31,Tuen Mun Ferry Terminal,0,0,0,0,0,0,0,0,Monday
2022-01-31,Total,375,58,32,465,1365,97,29,1491,Monday
2022-02-01,Airport,152,2,7,161,580,22,14,616,Tuesday
2022-02-01,Express Rail Link West Kowloon,0,0,0,0,0,0,0,0,Tuesday
2022-02-01,Hung Hom,0,0,0,0,0,0,0,0,Tuesday
2022-02-01,Lo Wu,0,0,0,0,0,0,0,0,Tuesday
2022-02-01,Lok Ma Chau Spur Line,0,0,0,0,0,0,0,0,Tuesday
2022-02-01,Heung Yuen Wai,0,0,0,0,0,0,0,0,Tuesday
2022-02-01,Hong Kong-Zhuhai-Macao Bridge,18,7,10,35,32,0,7,39,Tuesday
2022-02-01,Lok Ma Chau,0,0,0,0,0,0,0,0,Tuesday
2022-02-01,Man Kam To,0,0,0,0,0,0,0,0,Tuesday
2022-02-01,Sha Tau Kok,0,0,0,0,0,0,0,0,Tuesday
2022-02-01,Shenzhen Bay,65,21,0,86,823,122,1,946,Tuesday
2022-02-01,China Ferry Terminal,0,0,0,0,0,0,0,0,Tuesday
2022-02-01,Harbour Control,0,0,0,0,0,0,0,0,Tuesday
2022-02-01,Kai Tak Cruise Terminal,0,0,0,0,0,0,0,0,Tuesday
2022-02-01,Macau Ferry Terminal,0,0,0,0,0,0,0,0,Tuesday
2022-02-01,Tuen Mun Ferry Terminal,0,0,0,0,0,0,0,0,Tuesday
2022-02-01,Total,235,30,17,282,1435,144,22,1601,Tuesday
2022-02-02,Airport,401,3,24,428,951,19,38,1008,Wednesday
2022-03-02,Total,728,18,24,770,4181,235,48,4464,Wednesday
2022-02-02,Express Rail Link West Kowloon,0,0,0,0,0,0,0,0,Wednesday
2022-02-02,Hung Hom,0,0,0,0,0,0,0,0,Wednesday
2022-02-02,Lo Wu,0,0,0,0,0,0,0,0,Wednesday
2022-02-02,Lok Ma Chau Spur Line,0,0,0,0,0,0,0,0,Wednesday
2022-02-02,Heung Yuen Wai,0,0,0,0,0,0,0,0,Wednesday
2022-02-02,Hong Kong-Zhuhai-Macao Bridge,30,2,5,37,33,0,1,34,Wednesday
2022-02-02,Lok Ma Chau,0,0,0,0,0,0,0,0,Wednesday
2022-02-02,Man Kam To,0,0,0,0,0,0,0,0,Wednesday
2022-02-02,Sha Tau Kok,0,0,0,0,0,0,0,0,Wednesday
2022-02-02,Shenzhen Bay,192,42,3,237,933,177,2,1112,Wednesday
2022-02-02,China Ferry Terminal,0,0,0,0,0,0,0,0,Wednesday
2022-02-02,Harbour Control,0,0,0,0,0,0,0,0,Wednesday
2022-02-02,Kai Tak Cruise Terminal,0,0,0,0,0,0,0,0,Wednesday
2022-02-02,Macau Ferry Terminal,0,0,0,0,0,0,0,0,Wednesday
2022-02-02,Tuen Mun Ferry Terminal,0,0,0,0,0,0,0,0,Wednesday
2022-02-02,Total,623,47,32,702,1917,196,41,2154,Wednesday
2022-02-03,Airport,170,2,9,181,874,16,31,921,Thursday
2022-02-03,Express Rail Link West Kowloon,0,0,0,0,0,0,0,0,Thursday
2022-02-03,Hung Hom,0,0,0,0,0,0,0,0,Thursday
2022-02-03,Lo Wu,0,0,0,0,0,0,0,0,Thursday
2022-02-03,Lok Ma Chau Spur Line,0,0,0,0,0,0,0,0,Thursday
2022-02-03,Heung Yuen Wai,0,0,0,0,0,0,0,0,Thursday
2022-02-03,Hong Kong-Zhuhai-Macao Bridge,39,5,7,51,32,0,2,34,Thursday
2022-02-03,Lok Ma Chau,0,0,0,0,0,0,0,0,Thursday
2022-02-03,Man Kam To,0,0,0,0,0,0,0,0,Thursday
2022-02-03,Sha Tau Kok,0,0,0,0,0,0,0,0,Thursday
2022-02-03,Shenzhen Bay,350,46,6,402,1039,185,2,1226,Thursday
2022-02-03,China Ferry Terminal,0,0,0,0,0,0,0,0,Thursday
2022-02-03,Harbour Control,0,0,0,0,0,0,0,0,Thursday
2022-02-03,Kai Tak Cruise Terminal,0,0,0,0,0,0,0,0,Thursday
2022-02-03,Macau Ferry Terminal,0,0,0,0,0,0,0,0,Thursday
2022-02-03,Tuen Mun Ferry Terminal,0,0,0,0,0,0,0,0,Thursday
2022-02-03,Total,559,53,22,634,1945,201,35,2181,Thursday
2022-02-04,Airport,126,8,6,140,1032,13,28,1073,Friday
2022-02-04,Express Rail Link West Kowloon,0,0,0,0,0,0,0,0,Friday
2022-02-04,Hung Hom,0,0,0,0,0,0,0,0,Friday
2022-02-04,Lo Wu,0,0,0,0,0,0,0,0,Friday
2022-02-04,Lok Ma Chau Spur Line,0,0,0,0,0,0,0,0,Friday
2022-02-04,Heung Yuen Wai,0,0,0,0,0,0,0,0,Friday
2022-02-04,Hong Kong-Zhuhai-Macao Bridge,35,2,10,47,60,0,8,68,Friday
2022-02-04,Lok Ma Chau,0,0,0,0,0,0,0,0,Friday
2022-02-04,Man Kam To,0,0,0,0,0,0,0,0,Friday
2022-02-04,Sha Tau Kok,0,0,0,0,0,0,0,0,Friday
2022-02-04,Shenzhen Bay,404,89,4,497,1164,239,6,1409,Friday
2022-02-04,China Ferry Terminal,0,0,0,0,0,0,0,0,Friday
2022-02-04,Harbour Control,0,0,0,0,0,0,0,0,Friday
2022-02-04,Kai Tak Cruise Terminal,0,0,0,0,0,0,0,0,Friday
2022-02-04,Macau Ferry Terminal,0,0,0,0,0,0,0,0,Friday
2022-02-04,Tuen Mun Ferry Terminal,0,0,0,0,0,0,0,0,Friday
2022-02-04,Total,565,99,20,684,2256,252,42,2550,Friday
2022-02-05,Airport,352,7,5,364,1316,29,24,1369,Saturday
2022-02-05,Express Rail Link West Kowloon,0,0,0,0,0,0,0,0,Saturday
2022-02-05,Hung Hom,0,0,0,0,0,0,0,0,Saturday
2022-02-05,Lo Wu,0,0,0,0,0,0,0,0,Saturday
2022-02-05,Lok Ma Chau Spur Line,0,0,0,0,0,0,0,0,Saturday
2022-02-05,Heung Yuen Wai,0,0,0,0,0,0,0,0,Saturday
2022-02-05,Hong Kong-Zhuhai-Macao Bridge,75,6,7,88,53,1,3,57,Saturday
2022-02-05,Lok Ma Chau,0,0,0,0,0,0,0,0,Saturday
2022-02-05,Man Kam To,0,0,0,0,0,0,0,0,Saturday
2022-02-05,Sha Tau Kok,0,0,0,0,0,0,0,0,Saturday
2022-02-05,Shenzhen Bay,446,80,3,529,1142,261,6,1409,Saturday
2022-02-05,China Ferry Terminal,0,0,0,0,0,0,0,0,Saturday
2022-02-05,Harbour Control,0,0,0,0,0,0,0,0,Saturday
2022-02-05,Kai Tak Cruise Terminal,0,0,0,0,0,0,0,0,Saturday
2022-02-05,Macau Ferry Terminal,0,0,0,0,0,0,0,0,Saturday
2022-02-05,Tuen Mun Ferry Terminal,0,0,0,0,0,0,0,0,Saturday
2022-02-05,Total,873,93,15,981,2511,291,33,2835,Saturday
2022-02-06,Airport,971,14,30,1015,1944,55,61,2060,Sunday
2022-02-06,Express Rail Link West Kowloon,0,0,0,0,0,0,0,0,Sunday
2022-02-06,Hung Hom,0,0,0,0,0,0,0,0,Sunday
2022-02-06,Lo Wu,0,0,0,0,0,0,0,0,Sunday
2022-02-06,Lok Ma Chau Spur Line,0,0,0,0,0,0,0,0,Sunday
2022-02-06,Heung Yuen Wai,0,0,0,0,0,0,0,0,Sunday
2022-02-06,Hong Kong-Zhuhai-Macao Bridge,90,10,13,113,49,0,3,52,Sunday
2022-02-06,Lok Ma Chau,0,0,0,0,0,0,0,0,Sunday
2022-02-06,Man Kam To,0,0,0,0,0,0,0,0,Sunday
2022-02-06,Sha Tau Kok,0,0,0,0,0,0,0,0,Sunday
2022-02-06,Shenzhen Bay,934,88,0,1022,1243,275,8,1526,Sunday
2022-02-06,China Ferry Terminal,0,0,0,0,0,0,0,0,Sunday
2022-02-06,Harbour Control,0,0,0,0,0,0,0,0,Sunday
2022-02-06,Kai Tak Cruise Terminal,0,0,0,0,0,0,0,0,Sunday
2022-02-06,Macau Ferry Terminal,0,0,0,0,0,0,0,0,Sunday
2022-02-06,Tuen Mun Ferry Terminal,0,0,0,0,0,0,0,0,Sunday
2022-02-06,Total,1995,112,43,2150,3236,330,72,3638,Sunday
2022-02-07,Airport,463,3,23,489,889,23,33,945,Monday
2022-02-07,Express Rail Link West Kowloon,0,0,0,0,0,0,0,0,Monday
2022-02-07,Hung Hom,0,0,0,0,0,0,0,0,Monday
2022-02-07,Lo Wu,0,0,0,0,0,0,0,0,Monday
2022-02-07,Lok Ma Chau Spur Line,0,0,0,0,0,0,0,0,Monday
2022-02-07,Heung Yuen Wai,0,0,0,0,0,0,0,0,Monday
2022-02-07,Hong Kong-Zhuhai-Macao Bridge,57,1,5,63,73,0,5,78,Monday
2022-02-07,Lok Ma Chau,0,0,0,0,0,0,0,0,Monday
2022-02-07,Man Kam To,0,0,0,0,0,0,0,0,Monday
2022-02-07,Sha Tau Kok,0,0,0,0,0,0,0,0,Monday
2022-02-07,Shenzhen Bay,509,65,2,576,1326,245,1,1572,Monday
2022-02-07,China Ferry Terminal,0,0,0,0,0,0,0,0,Monday
2022-02-07,Harbour Control,0,0,0,0,0,0,0,0,Monday
2022-02-07,Kai Tak Cruise Terminal,0,0,0,0,0,0,0,0,Monday
2022-02-07,Macau Ferry Terminal,0,0,0,0,0,0,0,0,Monday
2022-02-07,Tuen Mun Ferry Terminal,0,0,0,0,0,0,0,0,Monday
2022-02-07,Total,1029,69,30,1128,2288,268,39,2595,Monday
2022-02-08,Airport,155,8,6,169,1175,41,39,1255,Tuesday
2022-02-08,Express Rail Link West Kowloon,0,0,0,0,0,0,0,0,Tuesday
2022-02-08,Hung Hom,0,0,0,0,0,0,0,0,Tuesday
2022-02-08,Lo Wu,0,0,0,0,0,0,0,0,Tuesday
2022-02-08,Lok Ma Chau Spur Line,0,0,0,0,0,0,0,0,Tuesday
2022-02-08,Heung Yuen Wai,0,0,0,0,0,0,0,0,Tuesday
2022-02-08,Hong Kong-Zhuhai-Macao Bridge,62,4,10,76,45,0,4,49,Tuesday
2022-02-08,Lok Ma Chau,0,0,0,0,0,0,0,0,Tuesday
2022-02-08,Man Kam To,0,0,0,0,0,0,0,0,Tuesday
2022-02-08,Sha Tau Kok,0,0,0,0,0,0,0,0,Tuesday
2022-02-08,Shenzhen Bay,541,56,4,601,1790,376,4,2170,Tuesday
2022-02-08,China Ferry Terminal,0,0,0,0,0,0,0,0,Tuesday
2022-02-08,Harbour Control,0,0,0,0,0,0,0,0,Tuesday
2022-02-08,Kai Tak Cruise Terminal,0,0,0,0,0,0,0,0,Tuesday
2022-02-08,Macau Ferry Terminal,0,0,0,0,0,0,0,0,Tuesday
2022-02-08,Total,758,68,20,846,3010,417,47,3474,Tuesday
2022-02-09,Airport,689,2,16,707,1336,30,36,1402,Wednesday
2022-02-09,Express Rail Link West Kowloon,0,0,0,0,0,0,0,0,Wednesday
2022-02-09,Hung Hom,0,0,0,0,0,0,0,0,Wednesday
2022-02-09,Lo Wu,0,0,0,0,0,0,0,0,Wednesday
2022-02-09,Lok Ma Chau Spur Line,0,0,0,0,0,0,0,0,Wednesday
2022-02-09,Heung Yuen Wai,0,0,0,0,0,0,0,0,Wednesday
2022-02-09,Hong Kong-Zhuhai-Macao Bridge,71,2,6,79,41,0,5,46,Wednesday
2022-02-09,Lok Ma Chau,0,0,0,0,0,0,0,0,Wednesday
2022-02-09,Man Kam To,0,0,0,0,0,0,0,0,Wednesday
2022-02-09,Sha Tau Kok,0,0,0,0,0,0,0,0,Wednesday
2022-02-09,Shenzhen Bay,381,47,2,430,1790,349,2,2141,Wednesday
2022-02-09,China Ferry Terminal,0,0,0,0,0,0,0,0,Wednesday
2022-02-09,Harbour Control,0,0,0,0,0,0,0,0,Wednesday
2022-02-09,Kai Tak Cruise Terminal,0,0,0,0,0,0,0,0,Wednesday
2022-02-09,Macau Ferry Terminal,0,0,0,0,0,0,0,0,Wednesday
2022-02-09,Total,1141,51,24,1216,3167,379,43,3589,Wednesday
2022-02-10,Airport,494,3,28,525,1168,38,50,1256,Thursday
2022-02-10,Express Rail Link West Kowloon,0,0,0,0,0,0,0,0,Thursday
2022-02-10,Hung Hom,0,0,0,0,0,0,0,0,Thursday
2022-02-10,Lo Wu,0,0,0,0,0,0,0,0,Thursday
2022-02-10,Lok Ma Chau Spur Line,0,0,0,0,0,0,0,0,Thursday
2022-02-10,Heung Yuen Wai,0,0,0,0,0,0,0,0,Thursday
2022-02-10,Hong Kong-Zhuhai-Macao Bridge,67,3,8,78,35,0,3,38,Thursday
2022-02-10,Lok Ma Chau,0,0,0,0,0,0,0,0,Thursday
2022-02-10,Man Kam To,0,0,0,0,0,0,0,0,Thursday
2022-02-10,Sha Tau Kok,0,0,0,0,0,0,0,0,Thursday
2022-02-10,Shenzhen Bay,418,62,4,484,1276,195,2,1473,Thursday
2022-02-10,China Ferry Terminal,0,0,0,0,0,0,0,0,Thursday
2022-02-10,Harbour Control,0,0,0,0,0,0,0,0,Thursday
2022-02-10,Kai Tak Cruise Terminal,0,0,0,0,0,0,0,0,Thursday
2022-02-10,Macau Ferry Terminal,0,0,0,0,0,0,0,0,Thursday
2022-02-10,Total,979,68,40,1087,2479,233,55,2767,Thursday
2022-02-11,Airport,456,3,18,477,1457,51,39,1547,Friday
2022-02-11,Express Rail Link West Kowloon,0,0,0,0,0,0,0,0,Friday
2022-02-11,Hung Hom,0,0,0,0,0,0,0,0,Friday
2022-02-11,Lo Wu,0,0,0,0,0,0,0,0,Friday
2022-02-11,Lok Ma Chau Spur Line,0,0,0,0,0,0,0,0,Friday
2022-02-11,Heung Yuen Wai,0,0,0,0,0,0,0,0,Friday
2022-02-11,Hong Kong-Zhuhai-Macao Bridge,44,4,5,53,37,0,0,37,Friday
2022-02-11,Lok Ma Chau,0,0,0,0,0,0,0,0,Friday
2022-02-11,Man Kam To,0,0,0,0,0,0,0,0,Friday
2022-02-11,Sha Tau Kok,0,0,0,0,0,0,0,0,Friday
2022-02-11,Shenzhen Bay,295,28,0,323,1046,159,4,1209,Friday
2022-02-11,China Ferry Terminal,0,0,0,0,0,0,0,0,Friday
2022-02-11,Harbour Control,0,0,0,0,0,0,0,0,Friday
2022-02-11,Kai Tak Cruise Terminal,0,0,0,0,0,0,0,0,Friday
2022-02-11,Macau Ferry Terminal,0,0,0,0,0,0,0,0,Friday
2022-02-11,Total,795,35,23,853,2540,210,43,2793,Friday
2022-02-12,Airport,239,8,13,260,1869,35,41,1945,Saturday
2022-02-12,Express Rail Link West Kowloon,0,0,0,0,0,0,0,0,Saturday
2022-02-12,Hung Hom,0,0,0,0,0,0,0,0,Saturday
2022-02-12,Lo Wu,0,0,0,0,0,0,0,0,Saturday
2022-02-12,Lok Ma Chau Spur Line,0,0,0,0,0,0,0,0,Saturday
2022-02-12,Heung Yuen Wai,0,0,0,0,0,0,0,0,Saturday
2022-02-12,Hong Kong-Zhuhai-Macao Bridge,48,4,10,62,288,34,3,325,Saturday
2022-02-12,Lok Ma Chau,0,0,0,0,0,0,0,0,Saturday
2022-02-12,Man Kam To,0,0,0,0,0,0,0,0,Saturday
2022-02-12,Sha Tau Kok,0,0,0,0,0,0,0,0,Saturday
2022-02-12,Shenzhen Bay,360,49,4,413,956,91,3,1050,Saturday
2022-02-12,China Ferry Terminal,0,0,0,0,0,0,0,0,Saturday
2022-02-12,Harbour Control,0,0,0,0,0,0,0,0,Saturday
2022-02-12,Kai Tak Cruise Terminal,0,0,0,0,0,0,0,0,Saturday
2022-02-12,Macau Ferry Terminal,0,0,0,0,0,0,0,0,Saturday
2022-02-12,Total,647,61,27,735,3113,160,47,3320,Saturday
2022-02-13,Airport,533,3,15,551,2954,95,53,3102,Sunday
2022-02-13,Express Rail Link West Kowloon,0,0,0,0,0,0,0,0,Sunday
2022-02-13,Hung Hom,0,0,0,0,0,0,0,0,Sunday
2022-02-13,Lo Wu,0,0,0,0,0,0,0,0,Sunday
2022-02-13,Lok Ma Chau Spur Line,0,0,0,0,0,0,0,0,Sunday
2022-02-13,Heung Yuen Wai,0,0,0,0,0,0,0,0,Sunday
2022-02-13,Hong Kong-Zhuhai-Macao Bridge,86,3,5,94,345,24,3,372,Sunday
2022-02-13,Lok Ma Chau,0,0,0,0,0,0,0,0,Sunday
2022-02-13,Man Kam To,0,0,0,0,0,0,0,0,Sunday
2022-02-13,Sha Tau Kok,0,0,0,0,0,0,0,0,Sunday
2022-02-13,Shenzhen Bay,556,55,6,617,835,76,1,912,Sunday
2022-02-13,China Ferry Terminal,0,0,0,0,0,0,0,0,Sunday
2022-02-13,Harbour Control,0,0,0,0,0,0,0,0,Sunday
2022-02-13,Kai Tak Cruise Terminal,0,0,0,0,0,0,0,0,Sunday
2022-02-13,Macau Ferry Terminal,0,0,0,0,0,0,0,0,Sunday
2022-02-13,Total,1175,61,26,1262,4134,195,57,4386,Sunday
2022-02-14,Airport,299,3,15,317,1771,84,10,1865,Monday
2022-02-14,Express Rail Link West Kowloon,0,0,0,0,0,0,0,0,Monday
2022-02-14,Hung Hom,0,0,0,0,0,0,0,0,Monday
2022-02-14,Lo Wu,0,0,0,0,0,0,0,0,Monday
2022-02-14,Lok Ma Chau Spur Line,0,0,0,0,0,0,0,0,Monday
2022-02-14,Heung Yuen Wai,0,0,0,0,0,0,0,0,Monday
2022-02-14,Hong Kong-Zhuhai-Macao Bridge,39,1,3,43,389,28,4,421,Monday
2022-02-14,Lok Ma Chau,0,0,0,0,0,0,0,0,Monday
2022-02-14,Man Kam To,0,0,0,0,0,0,0,0,Monday
2022-02-14,Sha Tau Kok,0,0,0,0,0,0,0,0,Monday
2022-02-14,Shenzhen Bay,341,31,0,372,840,78,0,918,Monday
2022-02-14,China Ferry Terminal,0,0,0,0,0,0,0,0,Monday
2022-02-14,Harbour Control,0,0,0,0,0,0,0,0,Monday
2022-02-14,Kai Tak Cruise Terminal,0,0,0,0,0,0,0,0,Monday
2022-02-14,Macau Ferry Terminal,0,0,0,0,0,0,0,0,Monday
2022-02-14,Total,679,35,18,732,3000,190,14,3204,Monday
2022-02-15,Airport,291,1,8,300,2283,87,31,2401,Tuesday
2022-02-15,Express Rail Link West Kowloon,0,0,0,0,0,0,0,0,Tuesday
2022-02-15,Hung Hom,0,0,0,0,0,0,0,0,Tuesday
2022-02-15,Lo Wu,0,0,0,0,0,0,0,0,Tuesday
2022-02-15,Lok Ma Chau Spur Line,0,0,0,0,0,0,0,0,Tuesday
2022-02-15,Heung Yuen Wai,0,0,0,0,0,0,0,0,Tuesday
2022-02-15,Hong Kong-Zhuhai-Macao Bridge,34,3,3,40,407,40,4,451,Tuesday
2022-02-15,Lok Ma Chau,0,0,0,0,0,0,0,0,Tuesday
2022-02-15,Man Kam To,0,0,0,0,0,0,0,0,Tuesday
2022-02-15,Sha Tau Kok,0,0,0,0,0,0,0,0,Tuesday
2022-02-15,Shenzhen Bay,456,23,4,483,800,83,3,886,Tuesday
2022-02-15,China Ferry Terminal,0,0,0,0,0,0,0,0,Tuesday
2022-02-15,Harbour Control,0,0,0,0,0,0,0,0,Tuesday
2022-02-15,Kai Tak Cruise Terminal,0,0,0,0,0,0,0,0,Tuesday
2022-02-15,Macau Ferry Terminal,0,0,0,0,0,0,0,0,Tuesday
2022-02-15,Total,781,27,15,823,3490,210,38,3738,Tuesday
2022-02-17,Airport,227,8,11,246,2292,120,38,2450,Thursday
2022-02-17,Express Rail Link West Kowloon,0,0,0,0,0,0,0,0,Thursday
2022-02-17,Hung Hom,0,0,0,0,0,0,0,0,Thursday
2022-02-17,Lo Wu,0,0,0,0,0,0,0,0,Thursday
2022-02-17,Lok Ma Chau Spur Line,0,0,0,0,0,0,0,0,Thursday
2022-02-17,Heung Yuen Wai,0,0,0,0,0,0,0,0,Thursday
2022-02-17,Hong Kong-Zhuhai-Macao Bridge,39,1,3,43,405,31,1,437,Thursday
2022-02-17,Lok Ma Chau,0,0,0,0,0,0,0,0,Thursday
2022-02-17,Man Kam To,0,0,0,0,0,0,0,0,Thursday
2022-02-17,Sha Tau Kok,0,0,0,0,0,0,0,0,Thursday
2022-02-17,Shenzhen Bay,293,46,3,342,839,98,6,943,Thursday
2022-02-17,China Ferry Terminal,0,0,0,0,0,0,0,0,Thursday
2022-02-17,Harbour Control,0,0,0,0,0,0,0,0,Thursday
2022-02-17,Kai Tak Cruise Terminal,0,0,0,0,0,0,0,0,Thursday
2022-02-17,Macau Ferry Terminal,0,0,0,0,0,0,0,0,Thursday
2022-02-17,Total,559,55,17,631,3536,249,45,3830,Thursday
2022-02-16,Airport,513,3,20,536,2647,115,52,2814,Wednesday
2022-02-16,Express Rail Link West Kowloon,0,0,0,0,0,0,0,0,Wednesday
2022-02-16,Hung Hom,0,0,0,0,0,0,0,0,Wednesday
2022-02-16,Lo Wu,0,0,0,0,0,0,0,0,Wednesday
2022-02-16,Lok Ma Chau Spur Line,0,0,0,0,0,0,0,0,Wednesday
2022-02-16,Heung Yuen Wai,0,0,0,0,0,0,0,0,Wednesday
2022-02-16,Hong Kong-Zhuhai-Macao Bridge,68,3,18,89,391,39,1,431,Wednesday
2022-02-16,Lok Ma Chau,0,0,0,0,0,0,0,0,Wednesday
2022-02-16,Man Kam To,0,0,0,0,0,0,0,0,Wednesday
2022-02-16,Sha Tau Kok,0,0,0,0,0,0,0,0,Wednesday
2022-02-16,Shenzhen Bay,496,32,1,529,851,83,2,936,Wednesday
2022-02-16,China Ferry Terminal,0,0,0,0,0,0,0,0,Wednesday
2022-02-16,Harbour Control,0,0,0,0,0,0,0,0,Wednesday
2022-02-16,Kai Tak Cruise Terminal,0,0,0,0,0,0,0,0,Wednesday
2022-02-16,Macau Ferry Terminal,0,0,0,0,0,0,0,0,Wednesday
2022-02-16,Total,1077,38,39,1154,3889,237,55,4181,Wednesday
2022-02-18,Airport,318,4,11,333,2113,99,33,2245,Friday
2022-02-18,Express Rail Link West Kowloon,0,0,0,0,0,0,0,0,Friday
2022-02-18,Hung Hom,0,0,0,0,0,0,0,0,Friday
2022-02-18,Lo Wu,0,0,0,0,0,0,0,0,Friday
2022-02-18,Lok Ma Chau Spur Line,0,0,0,0,0,0,0,0,Friday
2022-02-18,Heung Yuen Wai,0,0,0,0,0,0,0,0,Friday
2022-02-18,Hong Kong-Zhuhai-Macao Bridge,46,4,16,66,363,29,8,400,Friday
2022-02-18,Lok Ma Chau,0,0,0,0,0,0,0,0,Friday
2022-02-18,Man Kam To,0,0,0,0,0,0,0,0,Friday
2022-02-18,Sha Tau Kok,0,0,0,0,0,0,0,0,Friday
2022-02-18,Shenzhen Bay,236,30,3,269,800,115,2,917,Friday
2022-02-18,China Ferry Terminal,0,0,0,0,0,0,0,0,Friday
2022-02-18,Harbour Control,0,0,0,0,0,0,0,0,Friday
2022-02-18,Kai Tak Cruise Terminal,0,0,0,0,0,0,0,0,Friday
2022-02-18,Macau Ferry Terminal,0,0,0,0,0,0,0,0,Friday
2022-02-18,Total,600,38,30,668,3276,243,43,3562,Friday
2022-02-19,Airport,384,4,5,393,2801,167,26,2994,Saturday
2022-02-19,Express Rail Link West Kowloon,0,0,0,0,0,0,0,0,Saturday
2022-02-19,Hung Hom,0,0,0,0,0,0,0,0,Saturday
2022-02-19,Lo Wu,0,0,0,0,0,0,0,0,Saturday
2022-02-19,Lok Ma Chau Spur Line,0,0,0,0,0,0,0,0,Saturday
2022-02-19,Heung Yuen Wai,0,0,0,0,0,0,0,0,Saturday
2022-02-19,Hong Kong-Zhuhai-Macao Bridge,28,2,8,38,371,26,3,400,Saturday
2022-02-19,Lok Ma Chau,0,0,0,0,0,0,0,0,Saturday
2022-02-19,Man Kam To,0,0,0,0,0,0,0,0,Saturday
2022-02-19,Sha Tau Kok,0,0,0,0,0,0,0,0,Saturday
2022-02-19,Shenzhen Bay,370,42,1,413,737,114,0,851,Saturday
2022-02-19,China Ferry Terminal,0,0,0,0,0,0,0,0,Saturday
2022-02-19,Harbour Control,0,0,0,0,0,0,0,0,Saturday
2022-02-19,Kai Tak Cruise Terminal,0,0,0,0,0,0,0,0,Saturday
2022-02-19,Macau Ferry Terminal,0,0,0,0,0,0,0,0,Saturday
2022-02-19,Total,782,48,14,844,3909,307,29,4245,Saturday
2022-02-20,Airport,303,3,10,316,3172,113,47,3332,Sunday
2022-02-20,Express Rail Link West Kowloon,0,0,0,0,0,0,0,0,Sunday
2022-02-20,Hung Hom,0,0,0,0,0,0,0,0,Sunday
2022-02-20,Lo Wu,0,0,0,0,0,0,0,0,Sunday
2022-02-20,Lok Ma Chau Spur Line,0,0,0,0,0,0,0,0,Sunday
2022-02-20,Heung Yuen Wai,0,0,0,0,0,0,0,0,Sunday
2022-02-20,Hong Kong-Zhuhai-Macao Bridge,43,4,8,55,365,29,4,398,Sunday
2022-02-20,Lok Ma Chau,0,0,0,0,0,0,0,0,Sunday
2022-02-20,Man Kam To,0,0,0,0,0,0,0,0,Sunday
2022-02-20,Sha Tau Kok,0,0,0,0,0,0,0,0,Sunday
2022-02-20,Shenzhen Bay,349,30,3,382,699,114,0,813,Sunday
2022-02-20,China Ferry Terminal,0,0,0,0,0,0,0,0,Sunday
2022-02-20,Harbour Control,0,0,0,0,0,0,0,0,Sunday
2022-02-20,Kai Tak Cruise Terminal,0,0,0,0,0,0,0,0,Sunday
2022-02-20,Macau Ferry Terminal,0,0,0,0,0,0,0,0,Sunday
2022-02-20,Total,695,37,21,753,4236,256,51,4543,Sunday
2022-02-21,Airport,165,2,8,175,2245,103,33,2381,Monday
2022-02-21,Express Rail Link West Kowloon,0,0,0,0,0,0,0,0,Monday
2022-02-21,Hung Hom,0,0,0,0,0,0,0,0,Monday
2022-02-21,Lo Wu,0,0,0,0,0,0,0,0,Monday
2022-02-21,Lok Ma Chau Spur Line,0,0,0,0,0,0,0,0,Monday
2022-02-21,Heung Yuen Wai,0,0,0,0,0,0,0,0,Monday
2022-02-21,Hong Kong-Zhuhai-Macao Bridge,15,1,10,26,346,30,1,377,Monday
2022-02-21,Lok Ma Chau,0,0,0,0,0,0,0,0,Monday
2022-02-21,Man Kam To,0,0,0,0,0,0,0,0,Monday
2022-02-21,Sha Tau Kok,0,0,0,0,0,0,0,0,Monday
2022-02-21,Shenzhen Bay,190,27,2,219,682,122,2,806,Monday
2022-02-21,China Ferry Terminal,0,0,0,0,0,0,0,0,Monday
2022-02-21,Harbour Control,0,0,0,0,0,0,0,0,Monday
2022-02-21,Kai Tak Cruise Terminal,0,0,0,0,0,0,0,0,Monday
2022-02-21,Macau Ferry Terminal,0,0,0,0,0,0,0,0,Monday
2022-02-21,Total,370,30,20,420,3273,255,36,3564,Monday
2022-02-22,Airport,229,3,2,234,2702,142,31,2875,Tuesday
2022-02-22,Express Rail Link West Kowloon,0,0,0,0,0,0,0,0,Tuesday
2022-02-22,Hung Hom,0,0,0,0,0,0,0,0,Tuesday
2022-02-22,Lo Wu,0,0,0,0,0,0,0,0,Tuesday
2022-02-22,Lok Ma Chau Spur Line,0,0,0,0,0,0,0,0,Tuesday
2022-02-22,Heung Yuen Wai,0,0,0,0,0,0,0,0,Tuesday
2022-02-22,Hong Kong-Zhuhai-Macao Bridge,34,1,5,40,371,36,7,414,Tuesday
2022-02-22,Lok Ma Chau,0,0,0,0,0,0,0,0,Tuesday
2022-02-22,Man Kam To,0,0,0,0,0,0,0,0,Tuesday
2022-02-22,Sha Tau Kok,0,0,0,0,0,0,0,0,Tuesday
2022-02-22,Shenzhen Bay,179,26,1,206,658,109,1,768,Tuesday
2022-02-22,China Ferry Terminal,0,0,0,0,0,0,0,0,Tuesday
2022-02-22,Harbour Control,0,0,0,0,0,0,0,0,Tuesday
2022-02-22,Kai Tak Cruise Terminal,0,0,0,0,0,0,0,0,Tuesday
2022-02-22,Macau Ferry Terminal,0,0,0,0,0,0,0,0,Tuesday
2022-02-22,Total,442,30,8,480,3731,287,39,4057,Tuesday
2022-02-23,Airport,589,3,18,610,2419,127,33,2579,Wednesday
2022-02-23,Express Rail Link West Kowloon,0,0,0,0,0,0,0,0,Wednesday
2022-02-23,Hung Hom,0,0,0,0,0,0,0,0,Wednesday
2022-02-23,Lo Wu,0,0,0,0,0,0,0,0,Wednesday
2022-02-23,Lok Ma Chau Spur Line,0,0,0,0,0,0,0,0,Wednesday
2022-02-23,Heung Yuen Wai,0,0,0,0,0,0,0,0,Wednesday
2022-02-23,Hong Kong-Zhuhai-Macao Bridge,31,2,6,39,369,41,2,412,Wednesday
2022-02-23,Lok Ma Chau,0,0,0,0,0,0,0,0,Wednesday
2022-02-23,Man Kam To,0,0,0,0,0,0,0,0,Wednesday
2022-02-23,Sha Tau Kok,0,0,0,0,0,0,0,0,Wednesday
2022-02-23,Shenzhen Bay,204,12,3,219,653,103,1,757,Wednesday
2022-02-23,China Ferry Terminal,0,0,0,0,0,0,0,0,Wednesday
2022-02-23,Harbour Control,0,0,0,0,0,0,0,0,Wednesday
2022-02-23,Kai Tak Cruise Terminal,0,0,0,0,0,0,0,0,Wednesday
2022-02-23,Macau Ferry Terminal,0,0,0,0,0,0,0,0,Wednesday
2022-02-23,Total,824,17,27,868,3441,271,36,3748,Wednesday
2022-02-24,Airport,171,0,12,183,1944,100,31,2075,Thursday
2022-02-24,Express Rail Link West Kowloon,0,0,0,0,0,0,0,0,Thursday
2022-02-24,Hung Hom,0,0,0,0,0,0,0,0,Thursday
2022-02-24,Lo Wu,0,0,0,0,0,0,0,0,Thursday
2022-02-24,Lok Ma Chau Spur Line,0,0,0,0,0,0,0,0,Thursday
2022-02-24,Heung Yuen Wai,0,0,0,0,0,0,0,0,Thursday
2022-02-24,Hong Kong-Zhuhai-Macao Bridge,24,0,8,32,348,34,6,388,Thursday
2022-02-24,Lok Ma Chau,0,0,0,0,0,0,0,0,Thursday
2022-02-24,Man Kam To,0,0,0,0,0,0,0,0,Thursday
2022-02-24,Sha Tau Kok,0,0,0,0,0,0,0,0,Thursday
2022-02-24,Shenzhen Bay,151,59,0,210,794,124,3,921,Thursday
2022-02-24,China Ferry Terminal,0,0,0,0,0,0,0,0,Thursday
2022-02-24,Harbour Control,0,0,0,0,0,0,0,0,Thursday
2022-02-24,Kai Tak Cruise Terminal,0,0,0,0,0,0,0,0,Thursday
2022-02-24,Macau Ferry Terminal,0,0,0,0,0,0,0,0,Thursday
2022-02-24,Total,346,59,20,425,3086,258,40,3384,Thursday
2022-02-25,Airport,143,3,9,155,2071,96,18,2185,Friday
2022-03-03,Airport,369,1,25,395,2249,70,50,2369,Thursday
2022-02-25,Express Rail Link West Kowloon,0,0,0,0,0,0,0,0,Friday
2022-02-25,Hung Hom,0,0,0,0,0,0,0,0,Friday
2022-02-25,Lo Wu,0,0,0,0,0,0,0,0,Friday
2022-02-25,Lok Ma Chau Spur Line,0,0,0,0,0,0,0,0,Friday
2022-02-25,Heung Yuen Wai,0,0,0,0,0,0,0,0,Friday
2022-02-25,Hong Kong-Zhuhai-Macao Bridge,23,6,0,29,292,46,0,338,Friday
2022-02-25,Lok Ma Chau,0,0,0,0,0,0,0,0,Friday
2022-02-25,Man Kam To,0,0,0,0,0,0,0,0,Friday
2022-02-25,Sha Tau Kok,0,0,0,0,0,0,0,0,Friday
2022-02-25,Shenzhen Bay,181,49,4,234,706,113,2,821,Friday
2022-02-25,China Ferry Terminal,0,0,0,0,0,0,0,0,Friday
2022-02-25,Harbour Control,0,0,0,0,0,0,0,0,Friday
2022-02-25,Kai Tak Cruise Terminal,0,0,0,0,0,0,0,0,Friday
2022-02-25,Macau Ferry Terminal,0,0,0,0,0,0,0,0,Friday
2022-02-25,Total,347,58,13,418,3069,255,20,3344,Friday
2022-02-26,Airport,451,2,3,456,2422,69,21,2512,Saturday
2022-02-26,Express Rail Link West Kowloon,0,0,0,0,0,0,0,0,Saturday
2022-02-26,Hung Hom,0,0,0,0,0,0,0,0,Saturday
2022-02-26,Lo Wu,0,0,0,0,0,0,0,0,Saturday
2022-02-26,Lok Ma Chau Spur Line,0,0,0,0,0,0,0,0,Saturday
2022-02-26,Heung Yuen Wai,0,0,0,0,0,0,0,0,Saturday
2022-02-26,Hong Kong-Zhuhai-Macao Bridge,24,3,2,29,345,35,0,380,Saturday
2022-02-26,Lok Ma Chau,0,0,0,0,0,0,0,0,Saturday
2022-02-26,Man Kam To,0,0,0,0,0,0,0,0,Saturday
2022-02-26,Sha Tau Kok,0,0,0,0,0,0,0,0,Saturday
2022-02-26,Shenzhen Bay,168,16,3,187,684,96,0,780,Saturday
2022-02-26,China Ferry Terminal,0,0,0,0,0,0,0,0,Saturday
2022-02-26,Harbour Control,0,0,0,0,0,0,0,0,Saturday
2022-02-26,Kai Tak Cruise Terminal,0,0,0,0,0,0,0,0,Saturday
2022-02-26,Macau Ferry Terminal,0,0,0,0,0,0,0,0,Saturday
2022-02-26,Total,643,21,8,672,3451,200,21,3672,Saturday
2022-02-27,Airport,413,1,8,422,2893,140,26,3059,Sunday
2022-02-27,Express Rail Link West Kowloon,0,0,0,0,0,0,0,0,Sunday
2022-02-27,Hung Hom,0,0,0,0,0,0,0,0,Sunday
2022-02-27,Lo Wu,0,0,0,0,0,0,0,0,Sunday
2022-02-27,Lok Ma Chau Spur Line,0,0,0,0,0,0,0,0,Sunday
2022-02-27,Heung Yuen Wai,0,0,0,0,0,0,0,0,Sunday
2022-02-27,Hong Kong-Zhuhai-Macao Bridge,32,2,2,36,313,29,1,343,Sunday
2022-02-27,Lok Ma Chau,0,0,0,0,0,0,0,0,Sunday
2022-02-27,Man Kam To,0,0,0,0,0,0,0,0,Sunday
2022-02-27,Sha Tau Kok,0,0,0,0,0,0,0,0,Sunday
2022-02-27,Shenzhen Bay,219,51,3,273,716,116,2,834,Sunday
2022-02-27,China Ferry Terminal,0,0,0,0,0,0,0,0,Sunday
2022-02-27,Harbour Control,0,0,0,0,0,0,0,0,Sunday
2022-02-27,Kai Tak Cruise Terminal,0,0,0,0,0,0,0,0,Sunday
2022-02-27,Macau Ferry Terminal,0,0,0,0,0,0,0,0,Sunday
2022-02-27,Total,664,54,13,731,3922,285,29,4236,Sunday
2022-02-28,Airport,175,1,0,176,1626,72,15,1713,Monday
2022-02-28,Express Rail Link West Kowloon,0,0,0,0,0,0,0,0,Monday
2022-02-28,Hung Hom,0,0,0,0,0,0,0,0,Monday
2022-02-28,Lo Wu,0,0,0,0,0,0,0,0,Monday
2022-02-28,Lok Ma Chau Spur Line,0,0,0,0,0,0,0,0,Monday
2022-02-28,Heung Yuen Wai,0,0,0,0,0,0,0,0,Monday
2022-02-28,Hong Kong-Zhuhai-Macao Bridge,36,1,4,41,275,37,0,312,Monday
2022-02-28,Lok Ma Chau,0,0,0,0,0,0,0,0,Monday
2022-02-28,Man Kam To,0,0,0,0,0,0,0,0,Monday
2022-02-28,Sha Tau Kok,0,0,0,0,0,0,0,0,Monday
2022-02-28,Shenzhen Bay,255,29,1,285,703,114,2,819,Monday
2022-02-28,China Ferry Terminal,0,0,0,0,0,0,0,0,Monday
2022-02-28,Harbour Control,0,0,0,0,0,0,0,0,Monday
2022-02-28,Kai Tak Cruise Terminal,0,0,0,0,0,0,0,0,Monday
2022-02-28,Macau Ferry Terminal,0,0,0,0,0,0,0,0,Monday
2022-02-28,Total,466,31,5,502,2604,223,17,2844,Monday
2022-03-01,Airport,207,0,2,209,2558,81,27,2666,Tuesday
2022-03-01,Express Rail Link West Kowloon,0,0,0,0,0,0,0,0,Tuesday
2022-03-01,Hung Hom,0,0,0,0,0,0,0,0,Tuesday
2022-03-01,Lo Wu,0,0,0,0,0,0,0,0,Tuesday
2022-03-01,Lok Ma Chau Spur Line,0,0,0,0,0,0,0,0,Tuesday
2022-03-01,Heung Yuen Wai,0,0,0,0,0,0,0,0,Tuesday
2022-03-01,Hong Kong-Zhuhai-Macao Bridge,14,4,5,23,277,23,2,302,Tuesday
2022-03-01,Lok Ma Chau,0,0,0,0,0,0,0,0,Tuesday
2022-03-01,Man Kam To,0,0,0,0,0,0,0,0,Tuesday
2022-03-01,Sha Tau Kok,0,0,0,0,0,0,0,0,Tuesday
2022-03-01,Shenzhen Bay,173,30,6,209,661,100,2,763,Tuesday
2022-03-01,China Ferry Terminal,0,0,0,0,0,0,0,0,Tuesday
2022-03-01,Harbour Control,0,0,0,0,0,0,0,0,Tuesday
2022-03-01,Kai Tak Cruise Terminal,0,0,0,0,0,0,0,0,Tuesday
2022-03-01,Macau Ferry Terminal,0,0,0,0,0,0,0,0,Tuesday
2022-03-01,Total,394,34,13,441,3496,204,31,3731,Tuesday
2022-03-02,Airport,532,3,21,556,3228,115,45,3388,Wednesday
2022-03-02,Express Rail Link West Kowloon,0,0,0,0,0,0,0,0,Wednesday
2022-03-02,Hung Hom,0,0,0,0,0,0,0,0,Wednesday
2022-03-02,Lo Wu,0,0,0,0,0,0,0,0,Wednesday
2022-03-02,Lok Ma Chau Spur Line,0,0,0,0,0,0,0,0,Wednesday
2022-03-02,Heung Yuen Wai,0,0,0,0,0,0,0,0,Wednesday
2022-03-02,Hong Kong-Zhuhai-Macao Bridge,15,3,3,21,297,32,3,332,Wednesday
2022-03-02,Lok Ma Chau,0,0,0,0,0,0,0,0,Wednesday
2022-03-02,Man Kam To,0,0,0,0,0,0,0,0,Wednesday
2022-03-02,Sha Tau Kok,0,0,0,0,0,0,0,0,Wednesday
2022-03-02,Shenzhen Bay,181,12,0,193,656,88,0,744,Wednesday
2022-03-02,China Ferry Terminal,0,0,0,0,0,0,0,0,Wednesday
2022-03-02,Harbour Control,0,0,0,0,0,0,0,0,Wednesday
2022-03-02,Kai Tak Cruise Terminal,0,0,0,0,0,0,0,0,Wednesday
2022-03-02,Macau Ferry Terminal,0,0,0,0,0,0,0,0,Wednesday
2022-03-03,Express Rail Link West Kowloon,0,0,0,0,0,0,0,0,Thursday
2022-03-03,Hung Hom,0,0,0,0,0,0,0,0,Thursday
2022-03-03,Lo Wu,0,0,0,0,0,0,0,0,Thursday
2022-03-03,Lok Ma Chau Spur Line,0,0,0,0,0,0,0,0,Thursday
2022-03-03,Heung Yuen Wai,0,0,0,0,0,0,0,0,Thursday
2022-03-03,Hong Kong-Zhuhai-Macao Bridge,14,2,2,18,262,27,1,290,Thursday
2022-03-03,Lok Ma Chau,0,0,0,0,0,0,0,0,Thursday
2022-03-03,Man Kam To,0,0,0,0,0,0,0,0,Thursday
2022-03-03,Sha Tau Kok,0,0,0,0,0,0,0,0,Thursday
2022-03-03,Shenzhen Bay,115,14,0,129,624,94,1,719,Thursday
2022-03-03,China Ferry Terminal,0,0,0,0,0,0,0,0,Thursday
2022-03-03,Harbour Control,0,0,0,0,0,0,0,0,Thursday
2022-03-03,Kai Tak Cruise Terminal,0,0,0,0,0,0,0,0,Thursday
2022-03-03,Macau Ferry Terminal,0,0,0,0,0,0,0,0,Thursday
2022-03-03,Total,498,17,27,542,3135,191,52,3378,Thursday
2022-03-04,Airport,165,4,2,171,2929,108,39,3076,Friday
2022-03-04,Express Rail Link West Kowloon,0,0,0,0,0,0,0,0,Friday
2022-03-04,Hung Hom,0,0,0,0,0,0,0,0,Friday
2022-03-04,Lo Wu,0,0,0,0,0,0,0,0,Friday
2022-03-04,Lok Ma Chau Spur Line,0,0,0,0,0,0,0,0,Friday
2022-03-04,Heung Yuen Wai,0,0,0,0,0,0,0,0,Friday
2022-03-04,Hong Kong-Zhuhai-Macao Bridge,12,3,1,16,242,40,0,282,Friday
2022-03-04,Lok Ma Chau,0,0,0,0,0,0,0,0,Friday
2022-03-04,Man Kam To,0,0,0,0,0,0,0,0,Friday
2022-03-04,Sha Tau Kok,0,0,0,0,0,0,0,0,Friday
2022-03-04,Shenzhen Bay,113,76,1,190,463,71,1,535,Friday
2022-03-04,China Ferry Terminal,0,0,0,0,0,0,0,0,Friday
2022-03-04,Harbour Control,0,0,0,0,0,0,0,0,Friday
2022-03-04,Kai Tak Cruise Terminal,0,0,0,0,0,0,0,0,Friday
2022-03-04,Macau Ferry Terminal,0,0,0,0,0,0,0,0,Friday
2022-03-04,Total,290,83,4,377,3634,219,40,3893,Friday
2022-03-05,Airport,229,6,11,246,2477,84,22,2583,Saturday
2022-03-05,Express Rail Link West Kowloon,0,0,0,0,0,0,0,0,Saturday
2022-03-05,Hung Hom,0,0,0,0,0,0,0,0,Saturday
2022-03-05,Lo Wu,0,0,0,0,0,0,0,0,Saturday
2022-03-05,Lok Ma Chau Spur Line,0,0,0,0,0,0,0,0,Saturday
2022-03-05,Heung Yuen Wai,0,0,0,0,0,0,0,0,Saturday
2022-03-05,Hong Kong-Zhuhai-Macao Bridge,26,0,3,29,231,30,0,261,Saturday
2022-03-05,Lok Ma Chau,0,0,0,0,0,0,0,0,Saturday
2022-03-05,Man Kam To,0,0,0,0,0,0,0,0,Saturday
2022-03-05,Sha Tau Kok,0,0,0,0,0,0,0,0,Saturday
2022-03-05,Shenzhen Bay,86,17,0,103,486,82,2,570,Saturday
2022-03-05,China Ferry Terminal,0,0,0,0,0,0,0,0,Saturday
2022-03-05,Harbour Control,0,0,0,0,0,0,0,0,Saturday
2022-03-05,Kai Tak Cruise Terminal,0,0,0,0,0,0,0,0,Saturday
2022-03-05,Macau Ferry Terminal,0,0,0,0,0,0,0,0,Saturday
2022-03-05,Total,341,23,14,378,3194,196,24,3414,Saturday
2022-03-06,Airport,615,4,11,630,4092,101,45,4238,Sunday
2022-03-06,Express Rail Link West Kowloon,0,0,0,0,0,0,0,0,Sunday
2022-03-06,Hung Hom,0,0,0,0,0,0,0,0,Sunday
2022-03-06,Lo Wu,0,0,0,0,0,0,0,0,Sunday
2022-03-06,Lok Ma Chau Spur Line,0,0,0,0,0,0,0,0,Sunday
2022-03-06,Heung Yuen Wai,0,0,0,0,0,0,0,0,Sunday
2022-03-06,Hong Kong-Zhuhai-Macao Bridge,31,3,5,39,254,34,0,288,Sunday
2022-03-06,Lok Ma Chau,0,0,0,0,0,0,0,0,Sunday
2022-03-06,Man Kam To,0,0,0,0,0,0,0,0,Sunday
2022-03-06,Sha Tau Kok,0,0,0,0,0,0,0,0,Sunday
2022-03-06,Shenzhen Bay,142,19,1,162,492,64,0,556,Sunday
2022-03-06,China Ferry Terminal,0,0,0,0,0,0,0,0,Sunday
2022-03-06,Harbour Control,0,0,0,0,0,0,0,0,Sunday
2022-03-06,Kai Tak Cruise Terminal,0,0,0,0,0,0,0,0,Sunday
2022-03-06,Macau Ferry Terminal,0,0,0,0,0,0,0,0,Sunday
2022-03-06,Total,788,26,17,831,4838,199,45,5082,Sunday
2022-03-07,Airport,204,1,10,215,1522,26,28,1576,Monday
2022-03-07,Express Rail Link West Kowloon,0,0,0,0,0,0,0,0,Monday
2022-03-07,Hung Hom,0,0,0,0,0,0,0,0,Monday
2022-03-07,Lo Wu,0,0,0,0,0,0,0,0,Monday
2022-03-07,Lok Ma Chau Spur Line,0,0,0,0,0,0,0,0,Monday
2022-03-07,Heung Yuen Wai,0,0,0,0,0,0,0,0,Monday
2022-03-07,Hong Kong-Zhuhai-Macao Bridge,18,1,3,22,194,22,1,217,Monday
2022-03-07,Lok Ma Chau,0,0,0,0,0,0,0,0,Monday
2022-03-07,Man Kam To,0,0,0,0,0,0,0,0,Monday
2022-03-07,Sha Tau Kok,0,0,0,0,0,0,0,0,Monday
2022-03-07,Shenzhen Bay,125,7,0,132,431,55,1,487,Monday
2022-03-07,China Ferry Terminal,0,0,0,0,0,0,0,0,Monday
2022-03-07,Harbour Control,0,0,0,0,0,0,0,0,Monday
2022-03-07,Kai Tak Cruise Terminal,0,0,0,0,0,0,0,0,Monday
2022-03-07,Macau Ferry Terminal,0,0,0,0,0,0,0,0,Monday
2022-03-07,Total,347,9,13,369,2147,103,30,2280,Monday
2022-03-08,Airport,109,0,5,114,1989,30,18,2037,Tuesday
2022-03-08,Express Rail Link West Kowloon,0,0,0,0,0,0,0,0,Tuesday
2022-03-08,Hung Hom,0,0,0,0,0,0,0,0,Tuesday
2022-03-08,Lo Wu,0,0,0,0,0,0,0,0,Tuesday
2022-03-08,Lok Ma Chau Spur Line,0,0,0,0,0,0,0,0,Tuesday
2022-03-08,Heung Yuen Wai,0,0,0,0,0,0,0,0,Tuesday
2022-03-08,Hong Kong-Zhuhai-Macao Bridge,15,5,5,25,183,18,5,206,Tuesday
2022-03-08,Lok Ma Chau,0,0,0,0,0,0,0,0,Tuesday
2022-03-08,Man Kam To,0,0,0,0,0,0,0,0,Tuesday
2022-03-08,Sha Tau Kok,0,0,0,0,0,0,0,0,Tuesday
2022-03-08,Shenzhen Bay,102,15,5,122,416,80,0,496,Tuesday
2022-03-08,China Ferry Terminal,0,0,0,0,0,0,0,0,Tuesday
2022-03-08,Harbour Control,0,0,0,0,0,0,0,0,Tuesday
2022-03-08,Kai Tak Cruise Terminal,0,0,0,0,0,0,0,0,Tuesday
2022-03-08,Macau Ferry Terminal,0,0,0,0,0,0,0,0,Tuesday
2022-03-08,Total,226,20,15,261,2588,128,23,2739,Tuesday
2022-03-09,Airport,401,4,15,420,3394,64,57,3515,Wednesday
2022-03-09,Express Rail Link West Kowloon,0,0,0,0,0,0,0,0,Wednesday
2022-03-09,Hung Hom,0,0,0,0,0,0,0,0,Wednesday
2022-03-09,Lo Wu,0,0,0,0,0,0,0,0,Wednesday
2022-03-09,Lok Ma Chau Spur Line,0,0,0,0,0,0,0,0,Wednesday
2022-03-09,Heung Yuen Wai,0,0,0,0,0,0,0,0,Wednesday
2022-03-09,Hong Kong-Zhuhai-Macao Bridge,25,0,7,32,187,17,0,204,Wednesday
2022-03-09,Lok Ma Chau,0,0,0,0,0,0,0,0,Wednesday
2022-03-09,Man Kam To,0,0,0,0,0,0,0,0,Wednesday
2022-03-09,Sha Tau Kok,0,0,0,0,0,0,0,0,Wednesday
2022-03-09,Shenzhen Bay,101,10,0,111,462,56,0,518,Wednesday
2022-03-09,China Ferry Terminal,0,0,0,0,0,0,0,0,Wednesday
2022-03-09,Harbour Control,0,0,0,0,0,0,0,0,Wednesday
2022-03-09,Kai Tak Cruise Terminal,0,0,0,0,0,0,0,0,Wednesday
2022-03-09,Macau Ferry Terminal,0,0,0,0,0,0,0,0,Wednesday
2022-03-09,Total,527,14,22,563,4043,137,57,4237,Wednesday
2022-03-10,Airport,274,0,14,288,2216,76,42,2334,Thursday
2022-03-10,Express Rail Link West Kowloon,0,0,0,0,0,0,0,0,Thursday
2022-03-10,Hung Hom,0,0,0,0,0,0,0,0,Thursday
2022-03-10,Lo Wu,0,0,0,0,0,0,0,0,Thursday
2022-03-10,Lok Ma Chau Spur Line,0,0,0,0,0,0,0,0,Thursday
2022-03-10,Heung Yuen Wai,0,0,0,0,0,0,0,0,Thursday
2022-03-10,Hong Kong-Zhuhai-Macao Bridge,17,0,1,18,176,23,0,199,Thursday
2022-03-10,Lok Ma Chau,0,0,0,0,0,0,0,0,Thursday
2022-03-10,Man Kam To,0,0,0,0,0,0,0,0,Thursday
2022-03-10,Sha Tau Kok,0,0,0,0,0,0,0,0,Thursday
2022-03-10,Shenzhen Bay,116,11,2,129,434,70,0,504,Thursday
2022-03-10,China Ferry Terminal,0,0,0,0,0,0,0,0,Thursday
2022-03-10,Harbour Control,0,0,0,0,0,0,0,0,Thursday
2022-03-10,Kai Tak Cruise Terminal,0,0,0,0,0,0,0,0,Thursday
2022-03-10,Macau Ferry Terminal,0,0,0,0,0,0,0,0,Thursday
2022-03-10,Total,407,11,17,435,2826,169,42,3037,Thursday
2022-03-11,Airport,276,2,14,292,2217,36,46,2299,Friday
2022-03-11,Express Rail Link West Kowloon,0,0,0,0,0,0,0,0,Friday
2022-03-11,Hung Hom,0,0,0,0,0,0,0,0,Friday
2022-03-11,Lo Wu,0,0,0,0,0,0,0,0,Friday
2022-03-11,Lok Ma Chau Spur Line,0,0,0,0,0,0,0,0,Friday
2022-03-11,Heung Yuen Wai,0,0,0,0,0,0,0,0,Friday
2022-03-11,Hong Kong-Zhuhai-Macao Bridge,17,2,4,23,179,19,1,199,Friday
2022-03-11,Lok Ma Chau,0,0,0,0,0,0,0,0,Friday
2022-03-11,Man Kam To,0,0,0,0,0,0,0,0,Friday
2022-03-11,Sha Tau Kok,0,0,0,0,0,0,0,0,Friday
2022-03-11,Shenzhen Bay,209,39,1,249,462,63,0,525,Friday
2022-03-11,China Ferry Terminal,0,0,0,0,0,0,0,0,Friday
2022-03-11,Harbour Control,0,0,0,0,0,0,0,0,Friday
2022-03-11,Kai Tak Cruise Terminal,0,0,0,0,0,0,0,0,Friday
2022-03-11,Macau Ferry Terminal,0,0,0,0,0,0,0,0,Friday
2022-03-11,Total,502,43,19,564,2858,118,47,3023,Friday
2022-03-12,Airport,168,4,2,174,1910,16,37,1963,Saturday
2022-03-12,Express Rail Link West Kowloon,0,0,0,0,0,0,0,0,Saturday
2022-03-12,Hung Hom,0,0,0,0,0,0,0,0,Saturday
2022-03-12,Lo Wu,0,0,0,0,0,0,0,0,Saturday
2022-03-12,Lok Ma Chau Spur Line,0,0,0,0,0,0,0,0,Saturday
2022-03-12,Heung Yuen Wai,0,0,0,0,0,0,0,0,Saturday
2022-03-12,Hong Kong-Zhuhai-Macao Bridge,22,1,6,29,170,20,3,193,Saturday
2022-03-12,Lok Ma Chau,0,0,0,0,0,0,0,0,Saturday
2022-03-12,Man Kam To,0,0,0,0,0,0,0,0,Saturday
2022-03-12,Sha Tau Kok,0,0,0,0,0,0,0,0,Saturday
2022-03-12,Shenzhen Bay,82,15,1,98,431,75,2,508,Saturday
2022-03-12,China Ferry Terminal,0,0,0,0,0,0,0,0,Saturday
2022-03-12,Harbour Control,0,0,0,0,0,0,0,0,Saturday
2022-03-12,Kai Tak Cruise Terminal,0,0,0,0,0,0,0,0,Saturday
2022-03-12,Macau Ferry Terminal,0,0,0,0,0,0,0,0,Saturday
2022-03-12,Total,272,20,9,301,2511,111,42,2664,Saturday
2022-03-13,Airport,181,0,9,190,2629,24,40,2693,Sunday
2022-03-13,Express Rail Link West Kowloon,0,0,0,0,0,0,0,0,Sunday
2022-03-13,Hung Hom,0,0,0,0,0,0,0,0,Sunday
2022-03-13,Lo Wu,0,0,0,0,0,0,0,0,Sunday
2022-03-13,Lok Ma Chau Spur Line,0,0,0,0,0,0,0,0,Sunday
2022-03-13,Heung Yuen Wai,0,0,0,0,0,0,0,0,Sunday
2022-03-13,Hong Kong-Zhuhai-Macao Bridge,34,3,1,38,192,23,3,218,Sunday
2022-03-13,Lok Ma Chau,0,0,0,0,0,0,0,0,Sunday
2022-03-13,Man Kam To,0,0,0,0,0,0,0,0,Sunday
2022-03-13,Sha Tau Kok,0,0,0,0,0,0,0,0,Sunday
2022-03-13,Shenzhen Bay,205,19,0,224,461,59,0,520,Sunday
2022-03-13,China Ferry Terminal,0,0,0,0,0,0,0,0,Sunday
2022-03-13,Harbour Control,0,0,0,0,0,0,0,0,Sunday
2022-03-13,Kai Tak Cruise Terminal,0,0,0,0,0,0,0,0,Sunday
2022-03-13,Macau Ferry Terminal,0,0,0,0,0,0,0,0,Sunday
2022-03-13,Total,420,22,10,452,3282,106,43,3431,Sunday
2022-03-14,Airport,97,2,9,108,1635,29,29,1693,Monday
2022-03-14,Express Rail Link West Kowloon,0,0,0,0,0,0,0,0,Monday
2022-03-14,Hung Hom,0,0,0,0,0,0,0,0,Monday
2022-03-14,Lo Wu,0,0,0,0,0,0,0,0,Monday
2022-03-14,Lok Ma Chau Spur Line,0,0,0,0,0,0,0,0,Monday
2022-03-14,Heung Yuen Wai,0,0,0,0,0,0,0,0,Monday
2022-03-14,Hong Kong-Zhuhai-Macao Bridge,19,0,3,22,186,15,3,204,Monday
2022-03-14,Lok Ma Chau,0,0,0,0,0,0,0,0,Monday
2022-03-14,Man Kam To,0,0,0,0,0,0,0,0,Monday
2022-03-14,Sha Tau Kok,0,0,0,0,0,0,0,0,Monday
2022-03-14,Shenzhen Bay,186,48,1,235,436,55,1,492,Monday
2022-03-14,China Ferry Terminal,0,0,0,0,0,0,0,0,Monday
2022-03-14,Harbour Control,0,0,0,0,0,0,0,0,Monday
2022-03-14,Kai Tak Cruise Terminal,0,0,0,0,0,0,0,0,Monday
2022-03-14,Macau Ferry Terminal,0,0,0,0,0,0,0,0,Monday
2022-03-14,Total,302,50,13,365,2257,99,33,2389,Monday
2022-03-15,Airport,397,1,5,403,1970,45,30,2045,Tuesday
2022-03-15,Express Rail Link West Kowloon,0,0,0,0,0,0,0,0,Tuesday
2022-03-15,Hung Hom,0,0,0,0,0,0,0,0,Tuesday
2022-03-15,Lo Wu,0,0,0,0,0,0,0,0,Tuesday
2022-03-15,Lok Ma Chau Spur Line,0,0,0,0,0,0,0,0,Tuesday
2022-03-15,Heung Yuen Wai,0,0,0,0,0,0,0,0,Tuesday
2022-03-15,Hong Kong-Zhuhai-Macao Bridge,42,5,7,54,185,21,0,206,Tuesday
2022-03-15,Lok Ma Chau,0,0,0,0,0,0,0,0,Tuesday
2022-03-15,Man Kam To,0,0,0,0,0,0,0,0,Tuesday
2022-03-15,Sha Tau Kok,0,0,0,0,0,0,0,0,Tuesday
2022-03-15,Shenzhen Bay,178,17,4,199,434,58,0,492,Tuesday
2022-03-15,China Ferry Terminal,0,0,0,0,0,0,0,0,Tuesday
2022-03-15,Harbour Control,0,0,0,0,0,0,0,0,Tuesday
2022-03-15,Kai Tak Cruise Terminal,0,0,0,0,0,0,0,0,Tuesday
2022-03-15,Macau Ferry Terminal,0,0,0,0,0,0,0,0,Tuesday
2022-03-15,Total,617,23,16,656,2589,124,30,2743,Tuesday
2022-03-16,Airport,468,5,9,482,2580,49,38,2667,Wednesday
2022-03-16,Express Rail Link West Kowloon,0,0,0,0,0,0,0,0,Wednesday
2022-03-16,Hung Hom,0,0,0,0,0,0,0,0,Wednesday
2022-03-16,Lo Wu,0,0,0,0,0,0,0,0,Wednesday
2022-03-16,Lok Ma Chau Spur Line,0,0,0,0,0,0,0,0,Wednesday
2022-03-16,Heung Yuen Wai,301,0,0,301,0,0,0,0,Wednesday
2022-03-16,Hong Kong-Zhuhai-Macao Bridge,32,4,1,37,188,21,1,210,Wednesday
2022-03-16,Lok Ma Chau,0,0,0,0,0,0,0,0,Wednesday
2022-03-16,Man Kam To,0,0,0,0,0,0,0,0,Wednesday
2022-03-16,Sha Tau Kok,0,0,0,0,0,0,0,0,Wednesday
2022-03-16,Shenzhen Bay,93,10,1,104,448,49,3,500,Wednesday
2022-03-16,China Ferry Terminal,0,0,0,0,0,0,0,0,Wednesday
2022-03-16,Harbour Control,0,0,0,0,0,0,0,0,Wednesday
2022-03-16,Kai Tak Cruise Terminal,0,0,0,0,0,0,0,0,Wednesday
2022-03-16,Macau Ferry Terminal,0,0,0,0,0,0,0,0,Wednesday
2022-03-16,Total,894,19,11,924,3216,119,42,3377,Wednesday
2022-03-17,Airport,148,2,5,155,1761,39,28,1828,Thursday
2022-03-17,Express Rail Link West Kowloon,0,0,0,0,0,0,0,0,Thursday
2022-03-17,Hung Hom,0,0,0,0,0,0,0,0,Thursday
2022-03-17,Lo Wu,0,0,0,0,0,0,0,0,Thursday
2022-03-17,Lok Ma Chau Spur Line,0,0,0,0,0,0,0,0,Thursday
2022-03-17,Heung Yuen Wai,0,0,0,0,0,0,0,0,Thursday
2022-03-17,Hong Kong-Zhuhai-Macao Bridge,36,3,0,39,162,13,0,175,Thursday
2022-03-17,Lok Ma Chau,0,0,0,0,0,0,0,0,Thursday
2022-03-17,Man Kam To,0,0,0,0,0,0,0,0,Thursday
2022-03-17,Sha Tau Kok,0,0,0,0,0,0,0,0,Thursday
2022-03-17,Shenzhen Bay,38,8,1,47,409,82,0,491,Thursday
2022-03-17,China Ferry Terminal,0,0,0,0,0,0,0,0,Thursday
2022-03-17,Harbour Control,0,0,0,0,0,0,0,0,Thursday
2022-03-17,Kai Tak Cruise Terminal,0,0,0,0,0,0,0,0,Thursday
2022-03-17,Macau Ferry Terminal,0,0,0,0,0,0,0,0,Thursday
2022-03-17,Total,222,13,6,241,2332,134,28,2494,Thursday
2022-03-18,Airport,439,1,17,457,1785,33,36,1854,Friday
2022-03-18,Express Rail Link West Kowloon,0,0,0,0,0,0,0,0,Friday
2022-03-18,Hung Hom,0,0,0,0,0,0,0,0,Friday
2022-03-18,Lo Wu,0,0,0,0,0,0,0,0,Friday
2022-03-18,Lok Ma Chau Spur Line,0,0,0,0,0,0,0,0,Friday
2022-03-18,Heung Yuen Wai,0,0,0,0,0,0,0,0,Friday
2022-03-18,Hong Kong-Zhuhai-Macao Bridge,36,5,5,46,159,23,0,182,Friday
2022-03-18,Lok Ma Chau,0,0,0,0,0,0,0,0,Friday
2022-03-18,Man Kam To,0,0,0,0,0,0,0,0,Friday
2022-03-18,Sha Tau Kok,0,0,0,0,0,0,0,0,Friday
2022-03-18,Shenzhen Bay,176,20,1,197,389,74,0,463,Friday
2022-03-18,China Ferry Terminal,0,0,0,0,0,0,0,0,Friday
2022-03-18,Harbour Control,0,0,0,0,0,0,0,0,Friday
2022-03-18,Kai Tak Cruise Terminal,0,0,0,0,0,0,0,0,Friday
2022-03-18,Macau Ferry Terminal,0,0,0,0,0,0,0,0,Friday
2022-03-18,Total,651,26,23,700,2333,130,36,2499,Friday
2022-03-19,Airport,526,2,19,547,1665,31,30,1726,Saturday
2022-03-19,Express Rail Link West Kowloon,0,0,0,0,0,0,0,0,Saturday
2022-03-19,Hung Hom,0,0,0,0,0,0,0,0,Saturday
2022-03-19,Lo Wu,0,0,0,0,0,0,0,0,Saturday
2022-03-19,Lok Ma Chau Spur Line,0,0,0,0,0,0,0,0,Saturday
2022-03-19,Heung Yuen Wai,0,0,0,0,0,0,0,0,Saturday
2022-03-19,Hong Kong-Zhuhai-Macao Bridge,46,12,5,63,184,17,3,204,Saturday
2022-03-19,Lok Ma Chau,0,0,0,0,0,0,0,0,Saturday
2022-03-19,Man Kam To,0,0,0,0,0,0,0,0,Saturday
2022-03-19,Sha Tau Kok,0,0,0,0,0,0,0,0,Saturday
2022-03-19,Shenzhen Bay,34,13,0,47,355,53,1,409,Saturday
2022-03-19,China Ferry Terminal,0,0,0,0,0,0,0,0,Saturday
2022-03-19,Harbour Control,0,0,0,0,0,0,0,0,Saturday
2022-03-19,Kai Tak Cruise Terminal,0,0,0,0,0,0,0,0,Saturday
2022-03-19,Macau Ferry Terminal,0,0,0,0,0,0,0,0,Saturday
2022-03-19,Total,606,27,24,657,2204,101,34,2339,Saturday
2022-03-20,Airport,275,2,5,282,2197,38,50,2285,Sunday
2022-03-20,Express Rail Link West Kowloon,0,0,0,0,0,0,0,0,Sunday
2022-03-20,Hung Hom,0,0,0,0,0,0,0,0,Sunday
2022-03-20,Lo Wu,0,0,0,0,0,0,0,0,Sunday
2022-03-20,Lok Ma Chau Spur Line,0,0,0,0,0,0,0,0,Sunday
2022-03-20,Heung Yuen Wai,0,0,0,0,0,0,0,0,Sunday
2022-03-20,Hong Kong-Zhuhai-Macao Bridge,64,14,3,81,170,9,2,181,Sunday
2022-03-20,Lok Ma Chau,0,0,0,0,0,0,0,0,Sunday
2022-03-20,Man Kam To,0,0,0,0,0,0,0,0,Sunday
2022-03-20,Sha Tau Kok,0,0,0,0,0,0,0,0,Sunday
2022-03-20,Shenzhen Bay,65,7,0,72,344,57,1,402,Sunday
2022-03-20,China Ferry Terminal,0,0,0,0,0,0,0,0,Sunday
2022-03-20,Harbour Control,0,0,0,0,0,0,0,0,Sunday
2022-03-20,Kai Tak Cruise Terminal,0,0,0,0,0,0,0,0,Sunday
2022-03-20,Macau Ferry Terminal,0,0,0,0,0,0,0,0,Sunday
2022-03-20,Total,404,23,8,435,2711,104,53,2868,Sunday
2022-03-21,Airport,171,1,5,177,927,37,25,989,Monday
2022-03-21,Express Rail Link West Kowloon,0,0,0,0,0,0,0,0,Monday
2022-03-21,Hung Hom,0,0,0,0,0,0,0,0,Monday
2022-03-21,Lo Wu,0,0,0,0,0,0,0,0,Monday
2022-03-21,Lok Ma Chau Spur Line,0,0,0,0,0,0,0,0,Monday
2022-03-21,Heung Yuen Wai,0,0,0,0,0,0,0,0,Monday
2022-03-21,Hong Kong-Zhuhai-Macao Bridge,32,2,2,36,146,14,2,162,Monday
2022-03-21,Lok Ma Chau,0,0,0,0,0,0,0,0,Monday
2022-03-21,Man Kam To,0,0,0,0,0,0,0,0,Monday
2022-03-21,Sha Tau Kok,0,0,0,0,0,0,0,0,Monday
2022-03-21,Shenzhen Bay,83,12,2,97,166,27,0,193,Monday
2022-03-21,China Ferry Terminal,0,0,0,0,0,0,0,0,Monday
2022-03-21,Harbour Control,0,0,0,0,0,0,0,0,Monday
2022-03-21,Kai Tak Cruise Terminal,0,0,0,0,0,0,0,0,Monday
2022-03-21,Macau Ferry Terminal,0,0,0,0,0,0,0,0,Monday
2022-03-21,Total,286,15,9,310,1239,78,27,1344,Monday
2022-03-22,Airport,93,0,2,95,1086,25,17,1128,Tuesday
2022-03-22,Express Rail Link West Kowloon,0,0,0,0,0,0,0,0,Tuesday
2022-03-22,Hung Hom,0,0,0,0,0,0,0,0,Tuesday
2022-03-22,Lo Wu,0,0,0,0,0,0,0,0,Tuesday
2022-03-22,Lok Ma Chau Spur Line,0,0,0,0,0,0,0,0,Tuesday
2022-03-22,Heung Yuen Wai,0,0,0,0,0,0,0,0,Tuesday
2022-03-22,Hong Kong-Zhuhai-Macao Bridge,46,3,4,53,169,17,0,186,Tuesday
2022-03-22,Lok Ma Chau,0,0,0,0,0,0,0,0,Tuesday
2022-03-22,Man Kam To,0,0,0,0,0,0,0,0,Tuesday
2022-03-22,Sha Tau Kok,0,0,0,0,0,0,0,0,Tuesday
2022-03-22,Shenzhen Bay,267,20,3,290,164,25,0,189,Tuesday
2022-03-22,China Ferry Terminal,0,0,0,0,0,0,0,0,Tuesday
2022-03-22,Harbour Control,0,0,0,0,0,0,0,0,Tuesday
2022-03-22,Kai Tak Cruise Terminal,0,0,0,0,0,0,0,0,Tuesday
2022-03-22,Macau Ferry Terminal,0,0,0,0,0,0,0,0,Tuesday
2022-03-22,Total,406,23,9,438,1419,67,17,1503,Tuesday
2022-03-23,Airport,332,3,6,341,1679,52,31,1762,Wednesday
2022-03-23,Express Rail Link West Kowloon,0,0,0,0,0,0,0,0,Wednesday
2022-03-23,Hung Hom,0,0,0,0,0,0,0,0,Wednesday
2022-03-23,Lo Wu,0,0,0,0,0,0,0,0,Wednesday
2022-03-23,Lok Ma Chau Spur Line,0,0,0,0,0,0,0,0,Wednesday
2022-03-23,Heung Yuen Wai,0,0,0,0,0,0,0,0,Wednesday
2022-03-23,Hong Kong-Zhuhai-Macao Bridge,52,2,0,54,160,17,2,179,Wednesday
2022-03-23,Lok Ma Chau,0,0,0,0,0,0,0,0,Wednesday
2022-03-23,Man Kam To,0,0,0,0,0,0,0,0,Wednesday
2022-03-23,Sha Tau Kok,0,0,0,0,0,0,0,0,Wednesday
2022-03-23,Shenzhen Bay,318,12,1,331,174,29,2,205,Wednesday
2022-03-23,China Ferry Terminal,0,0,0,0,0,0,0,0,Wednesday
2022-03-23,Harbour Control,0,0,0,0,0,0,0,0,Wednesday
2022-03-23,Kai Tak Cruise Terminal,0,0,0,0,0,0,0,0,Wednesday
2022-03-23,Macau Ferry Terminal,0,0,0,0,0,0,0,0,Wednesday
2022-03-23,Total,702,17,7,726,2013,98,35,2146,Wednesday
2022-03-24,Airport,136,1,10,147,1905,52,13,1970,Thursday
2022-03-24,Express Rail Link West Kowloon,0,0,0,0,0,0,0,0,Thursday
2022-03-24,Hung Hom,0,0,0,0,0,0,0,0,Thursday
2022-03-24,Lo Wu,0,0,0,0,0,0,0,0,Thursday
2022-03-24,Lok Ma Chau Spur Line,0,0,0,0,0,0,0,0,Thursday
2022-03-24,Heung Yuen Wai,0,0,0,0,0,0,0,0,Thursday
2022-03-24,Hong Kong-Zhuhai-Macao Bridge,29,1,1,31,143,19,5,167,Thursday
2022-03-24,Lok Ma Chau,0,0,0,0,0,0,0,0,Thursday
2022-03-24,Man Kam To,0,0,0,0,0,0,0,0,Thursday
2022-03-24,Sha Tau Kok,0,0,0,0,0,0,0,0,Thursday
2022-03-24,Shenzhen Bay,165,10,1,176,253,38,2,293,Thursday
2022-03-24,China Ferry Terminal,0,0,0,0,0,0,0,0,Thursday
2022-03-24,Harbour Control,0,0,0,0,0,0,0,0,Thursday
2022-03-24,Kai Tak Cruise Terminal,0,0,0,0,0,0,0,0,Thursday
2022-03-24,Macau Ferry Terminal,0,0,0,0,0,0,0,0,Thursday
2022-03-24,Total,330,12,12,354,2301,109,20,2430,Thursday
2022-03-25,Airport,166,1,8,175,2037,41,37,2115,Friday
2022-03-25,Express Rail Link West Kowloon,0,0,0,0,0,0,0,0,Friday
2022-03-25,Hung Hom,0,0,0,0,0,0,0,0,Friday
2022-03-25,Lo Wu,0,0,0,0,0,0,0,0,Friday
2022-03-25,Lok Ma Chau Spur Line,0,0,0,0,0,0,0,0,Friday
2022-03-25,Heung Yuen Wai,0,0,0,0,0,0,0,0,Friday
2022-03-25,Hong Kong-Zhuhai-Macao Bridge,42,2,9,53,159,24,2,185,Friday
2022-03-25,Lok Ma Chau,0,0,0,0,0,0,0,0,Friday
2022-03-25,Man Kam To,0,0,0,0,0,0,0,0,Friday
2022-03-25,Sha Tau Kok,0,0,0,0,0,0,0,0,Friday
2022-03-25,Shenzhen Bay,359,27,3,389,209,37,0,246,Friday
2022-03-25,China Ferry Terminal,0,0,0,0,0,0,0,0,Friday
2022-03-25,Harbour Control,0,0,0,0,0,0,0,0,Friday
2022-03-25,Kai Tak Cruise Terminal,0,0,0,0,0,0,0,0,Friday
2022-03-25,Macau Ferry Terminal,0,0,0,0,0,0,0,0,Friday
2022-03-25,Total,567,30,20,617,2405,102,39,2546,Friday
2022-03-27,Airport,662,4,5,671,2212,43,32,2287,Sunday
2022-03-27,Express Rail Link West Kowloon,0,0,0,0,0,0,0,0,Sunday
2022-03-27,Hung Hom,0,0,0,0,0,0,0,0,Sunday
2022-03-27,Lo Wu,0,0,0,0,0,0,0,0,Sunday
2022-03-27,Lok Ma Chau Spur Line,0,0,0,0,0,0,0,0,Sunday
2022-03-27,Heung Yuen Wai,0,0,0,0,0,0,0,0,Sunday
2022-03-27,Hong Kong-Zhuhai-Macao Bridge,58,11,2,71,147,17,5,169,Sunday
2022-03-27,Lok Ma Chau,0,0,0,0,0,0,0,0,Sunday
2022-03-27,Man Kam To,0,0,0,0,0,0,0,0,Sunday
2022-03-27,Sha Tau Kok,0,0,0,0,0,0,0,0,Sunday
2022-03-27,Shenzhen Bay,246,15,3,264,181,30,0,211,Sunday
2022-03-27,China Ferry Terminal,0,0,0,0,0,0,0,0,Sunday
2022-03-27,Harbour Control,0,0,0,0,0,0,0,0,Sunday
2022-03-27,Kai Tak Cruise Terminal,0,0,0,0,0,0,0,0,Sunday
2022-03-27,Macau Ferry Terminal,0,0,0,0,0,0,0,0,Sunday
2022-03-27,Total,966,30,10,1006,2540,90,37,2667,Sunday
2022-03-26,Airport,316,2,4,322,1675,27,21,1723,Saturday
2022-03-26,Express Rail Link West Kowloon,0,0,0,0,0,0,0,0,Saturday
2022-03-26,Hung Hom,0,0,0,0,0,0,0,0,Saturday
2022-03-26,Lo Wu,0,0,0,0,0,0,0,0,Saturday
2022-03-26,Lok Ma Chau Spur Line,0,0,0,0,0,0,0,0,Saturday
2022-03-26,Heung Yuen Wai,0,0,0,0,0,0,0,0,Saturday
2022-03-26,Hong Kong-Zhuhai-Macao Bridge,39,3,4,46,174,20,1,195,Saturday
2022-03-26,Lok Ma Chau,0,0,0,0,0,0,0,0,Saturday
2022-03-26,Man Kam To,0,0,0,0,0,0,0,0,Saturday
2022-03-26,Sha Tau Kok,0,0,0,0,0,0,0,0,Saturday
2022-03-26,Shenzhen Bay,166,63,0,229,192,71,0,263,Saturday
2022-03-26,China Ferry Terminal,0,0,0,0,0,0,0,0,Saturday
2022-03-26,Harbour Control,0,0,0,0,0,0,0,0,Saturday
2022-03-26,Kai Tak Cruise Terminal,0,0,0,0,0,0,0,0,Saturday
2022-03-26,Macau Ferry Terminal,0,0,0,0,0,0,0,0,Saturday
2022-03-26,Total,521,68,8,597,2041,118,22,2181,Saturday
2022-03-28,Airport,113,2,6,121,925,23,17,965,Monday
2022-03-28,Express Rail Link West Kowloon,0,0,0,0,0,0,0,0,Monday
2022-03-28,Hung Hom,0,0,0,0,0,0,0,0,Monday
2022-03-28,Lo Wu,0,0,0,0,0,0,0,0,Monday
2022-03-28,Lok Ma Chau Spur Line,0,0,0,0,0,0,0,0,Monday
2022-03-28,Heung Yuen Wai,0,0,0,0,0,0,0,0,Monday
2022-03-28,Hong Kong-Zhuhai-Macao Bridge,43,3,4,50,180,17,2,199,Monday
2022-03-28,Lok Ma Chau,0,0,0,0,0,0,0,0,Monday
2022-03-28,Man Kam To,0,0,0,0,0,0,0,0,Monday
2022-03-28,Sha Tau Kok,0,0,0,0,0,0,0,0,Monday
2022-03-28,Shenzhen Bay,252,50,0,302,217,55,0,272,Monday
2022-03-28,China Ferry Terminal,0,0,0,0,0,0,0,0,Monday
2022-03-28,Harbour Control,0,0,0,0,0,0,0,0,Monday
2022-03-28,Kai Tak Cruise Terminal,0,0,0,0,0,0,0,0,Monday
2022-03-28,Macau Ferry Terminal,0,0,0,0,0,0,0,0,Monday
2022-03-28,Total,408,55,10,473,1322,95,19,1436,Monday
2022-03-29,Airport,66,0,0,66,1795,20,22,1837,Tuesday
2022-03-29,Express Rail Link West Kowloon,0,0,0,0,0,0,0,0,Tuesday
2022-03-29,Hung Hom,0,0,0,0,0,0,0,0,Tuesday
2022-03-29,Lo Wu,0,0,0,0,0,0,0,0,Tuesday
2022-03-29,Lok Ma Chau Spur Line,0,0,0,0,0,0,0,0,Tuesday
2022-03-29,Heung Yuen Wai,0,0,0,0,0,0,0,0,Tuesday
2022-03-29,Hong Kong-Zhuhai-Macao Bridge,50,9,3,62,167,18,0,185,Tuesday
2022-03-29,Lok Ma Chau,0,0,0,0,0,0,0,0,Tuesday
2022-03-29,Man Kam To,0,0,0,0,0,0,0,0,Tuesday
2022-03-29,Sha Tau Kok,0,0,0,0,0,0,0,0,Tuesday
2022-03-29,Shenzhen Bay,296,32,1,329,170,23,0,193,Tuesday
2022-03-29,China Ferry Terminal,0,0,0,0,0,0,0,0,Tuesday
2022-03-29,Harbour Control,0,0,0,0,0,0,0,0,Tuesday
2022-03-29,Kai Tak Cruise Terminal,0,0,0,0,0,0,0,0,Tuesday
2022-03-29,Macau Ferry Terminal,0,0,0,0,0,0,0,0,Tuesday
2022-03-29,Total,412,41,4,457,2132,61,22,2215,Tuesday
2022-03-30,Airport,162,5,7,174,1886,37,22,1945,Wednesday
2022-03-30,Express Rail Link West Kowloon,0,0,0,0,0,0,0,0,Wednesday
2022-03-30,Hung Hom,0,0,0,0,0,0,0,0,Wednesday
2022-03-30,Lo Wu,0,0,0,0,0,0,0,0,Wednesday
2022-03-30,Lok Ma Chau Spur Line,0,0,0,0,0,0,0,0,Wednesday
2022-03-30,Heung Yuen Wai,0,0,0,0,0,0,0,0,Wednesday
2022-03-30,Hong Kong-Zhuhai-Macao Bridge,72,3,1,76,160,15,4,179,Wednesday
2022-03-30,Lok Ma Chau,0,0,0,0,0,0,0,0,Wednesday
2022-03-30,Man Kam To,0,0,0,0,0,0,0,0,Wednesday
2022-03-30,Sha Tau Kok,0,0,0,0,0,0,0,0,Wednesday
2022-03-30,Shenzhen Bay,319,16,1,336,158,29,1,188,Wednesday
2022-03-30,China Ferry Terminal,0,0,0,0,0,0,0,0,Wednesday
2022-03-30,Harbour Control,0,0,0,0,0,0,0,0,Wednesday
2022-03-30,Kai Tak Cruise Terminal,0,0,0,0,0,0,0,0,Wednesday
2022-03-30,Macau Ferry Terminal,0,0,0,0,0,0,0,0,Wednesday
2022-03-30,Total,553,24,9,586,2204,81,27,2312,Wednesday
2022-03-31,Airport,273,18,9,300,1384,42,85,1511,Thursday
2022-03-31,Express Rail Link West Kowloon,0,0,0,0,0,0,0,0,Thursday
2022-03-31,Hung Hom,0,0,0,0,0,0,0,0,Thursday
2022-03-31,Lo Wu,0,0,0,0,0,0,0,0,Thursday
2022-03-31,Lok Ma Chau Spur Line,0,0,0,0,0,0,0,0,Thursday
2022-03-31,Heung Yuen Wai,0,0,0,0,0,0,0,0,Thursday
2022-03-31,Hong Kong-Zhuhai-Macao Bridge,73,3,0,76,153,16,2,171,Thursday
2022-03-31,Lok Ma Chau,0,0,0,0,0,0,0,0,Thursday
2022-03-31,Man Kam To,0,0,0,0,0,0,0,0,Thursday
2022-03-31,Sha Tau Kok,0,0,0,0,0,0,0,0,Thursday
2022-03-31,Shenzhen Bay,453,20,1,474,192,27,0,219,Thursday
2022-03-31,China Ferry Terminal,0,0,0,0,0,0,0,0,Thursday
2022-03-31,Harbour Control,0,0,0,0,0,0,0,0,Thursday
2022-03-31,Kai Tak Cruise Terminal,0,0,0,0,0,0,0,0,Thursday
2022-03-31,Macau Ferry Terminal,0,0,0,0,0,0,0,0,Thursday
2022-03-31,Total,799,41,10,850,1729,85,87,1901,Thursday
2022-04-01,Airport,1928,7,27,1962,2777,44,32,2853,Friday
2022-04-01,Express Rail Link West Kowloon,0,0,0,0,0,0,0,0,Friday
2022-04-01,Hung Hom,0,0,0,0,0,0,0,0,Friday
2022-04-01,Lo Wu,0,0,0,0,0,0,0,0,Friday
2022-04-01,Lok Ma Chau Spur Line,0,0,0,0,0,0,0,0,Friday
2022-04-01,Heung Yuen Wai,0,0,0,0,0,0,0,0,Friday
2022-04-07,Lok Ma Chau Spur Line,0,0,0,0,0,0,0,0,Thursday
2022-04-01,Hong Kong-Zhuhai-Macao Bridge,32,6,14,52,134,20,0,154,Friday
2022-04-01,Lok Ma Chau,0,0,0,0,0,0,0,0,Friday
2022-04-01,Man Kam To,0,0,0,0,0,0,0,0,Friday
2022-04-01,Sha Tau Kok,0,0,0,0,0,0,0,0,Friday
2022-04-01,Shenzhen Bay,250,48,1,299,211,104,0,315,Friday
2022-04-01,China Ferry Terminal,0,0,0,0,0,0,0,0,Friday
2022-04-01,Harbour Control,0,0,0,0,0,0,0,0,Friday
2022-04-01,Kai Tak Cruise Terminal,0,0,0,0,0,0,0,0,Friday
2022-04-01,Macau Ferry Terminal,0,0,0,0,0,0,0,0,Friday
2022-04-01,Total,2210,61,42,2313,3122,168,32,3322,Friday
2022-04-02,Airport,1206,2,13,1221,2211,22,35,2268,Saturday
2022-04-02,Express Rail Link West Kowloon,0,0,0,0,0,0,0,0,Saturday
2022-04-02,Hung Hom,0,0,0,0,0,0,0,0,Saturday
2022-04-02,Lo Wu,0,0,0,0,0,0,0,0,Saturday
2022-04-02,Lok Ma Chau Spur Line,0,0,0,0,0,0,0,0,Saturday
2022-04-02,Heung Yuen Wai,0,0,0,0,0,0,0,0,Saturday
2022-04-02,Hong Kong-Zhuhai-Macao Bridge,50,7,7,64,163,14,3,180,Saturday
2022-04-02,Lok Ma Chau,0,0,0,0,0,0,0,0,Saturday
2022-04-02,Man Kam To,0,0,0,0,0,0,0,0,Saturday
2022-04-02,Sha Tau Kok,0,0,0,0,0,0,0,0,Saturday
2022-04-02,Shenzhen Bay,274,34,1,309,252,57,0,309,Saturday
2022-04-02,China Ferry Terminal,0,0,0,0,0,0,0,0,Saturday
2022-04-02,Harbour Control,0,0,0,0,0,0,0,0,Saturday
2022-04-02,Kai Tak Cruise Terminal,0,0,0,0,0,0,0,0,Saturday
2022-04-02,Macau Ferry Terminal,0,0,0,0,0,0,0,0,Saturday
2022-04-02,Total,1530,43,21,1594,2626,93,38,2757,Saturday
2022-04-03,Airport,942,11,12,965,2206,28,25,2259,Sunday
2022-04-03,Express Rail Link West Kowloon,0,0,0,0,0,0,0,0,Sunday
2022-04-03,Hung Hom,0,0,0,0,0,0,0,0,Sunday
2022-04-03,Lo Wu,0,0,0,0,0,0,0,0,Sunday
2022-04-03,Lok Ma Chau Spur Line,0,0,0,0,0,0,0,0,Sunday
2022-04-03,Heung Yuen Wai,0,0,0,0,0,0,0,0,Sunday
2022-04-03,Hong Kong-Zhuhai-Macao Bridge,81,19,0,100,168,14,2,184,Sunday
2022-04-03,Lok Ma Chau,0,0,0,0,0,0,0,0,Sunday
2022-04-03,Man Kam To,0,0,0,0,0,0,0,0,Sunday
2022-04-03,Sha Tau Kok,0,0,0,0,0,0,0,0,Sunday
2022-04-03,Shenzhen Bay,335,28,2,365,351,52,1,404,Sunday
2022-04-03,China Ferry Terminal,0,0,0,0,0,0,0,0,Sunday
2022-04-03,Harbour Control,0,0,0,0,0,0,0,0,Sunday
2022-04-03,Kai Tak Cruise Terminal,0,0,0,0,0,0,0,0,Sunday
2022-04-03,Macau Ferry Terminal,0,0,0,0,0,0,0,0,Sunday
2022-04-03,Total,1358,58,14,1430,2725,94,28,2847,Sunday
2022-04-04,Airport,819,14,14,847,1987,30,26,2043,Monday
2022-04-04,Express Rail Link West Kowloon,0,0,0,0,0,0,0,0,Monday
2022-04-04,Hung Hom,0,0,0,0,0,0,0,0,Monday
2022-04-04,Lo Wu,0,0,0,0,0,0,0,0,Monday
2022-04-04,Lok Ma Chau Spur Line,0,0,0,0,0,0,0,0,Monday
2022-04-04,Heung Yuen Wai,0,0,0,0,0,0,0,0,Monday
2022-04-04,Hong Kong-Zhuhai-Macao Bridge,31,5,5,41,175,18,0,193,Monday
2022-04-04,Lok Ma Chau,0,0,0,0,0,0,0,0,Monday
2022-04-04,Man Kam To,0,0,0,0,0,0,0,0,Monday
2022-04-04,Sha Tau Kok,0,0,0,0,0,0,0,0,Monday
2022-04-04,Shenzhen Bay,286,49,1,336,287,61,0,348,Monday
2022-04-04,China Ferry Terminal,0,0,0,0,0,0,0,0,Monday
2022-04-04,Harbour Control,0,0,0,0,0,0,0,0,Monday
2022-04-04,Kai Tak Cruise Terminal,0,0,0,0,0,0,0,0,Monday
2022-04-04,Macau Ferry Terminal,0,0,0,0,0,0,0,0,Monday
2022-04-04,Total,1136,68,20,1224,2449,109,26,2584,Monday
2022-04-05,Airport,1152,2,12,1166,1233,15,13,1261,Tuesday
2022-04-05,Express Rail Link West Kowloon,0,0,0,0,0,0,0,0,Tuesday
2022-04-05,Hung Hom,0,0,0,0,0,0,0,0,Tuesday
2022-04-05,Lo Wu,0,0,0,0,0,0,0,0,Tuesday
2022-04-05,Lok Ma Chau Spur Line,0,0,0,0,0,0,0,0,Tuesday
2022-04-05,Heung Yuen Wai,0,0,0,0,0,0,0,0,Tuesday
2022-04-05,Hong Kong-Zhuhai-Macao Bridge,54,5,4,63,182,24,0,206,Tuesday
2022-04-05,Lok Ma Chau,0,0,0,0,0,0,0,0,Tuesday
2022-04-05,Man Kam To,0,0,0,0,0,0,0,0,Tuesday
2022-04-05,Sha Tau Kok,0,0,0,0,0,0,0,0,Tuesday
2022-04-05,Shenzhen Bay,271,61,3,335,310,56,3,369,Tuesday
2022-04-05,China Ferry Terminal,0,0,0,0,0,0,0,0,Tuesday
2022-04-05,Harbour Control,0,0,0,0,0,0,0,0,Tuesday
2022-04-05,Kai Tak Cruise Terminal,0,0,0,0,0,0,0,0,Tuesday
2022-04-05,Macau Ferry Terminal,0,0,0,0,0,0,0,0,Tuesday
2022-04-05,Total,1477,68,19,1564,1725,95,16,1836,Tuesday
2022-04-06,Airport,815,5,16,836,1656,29,29,1714,Wednesday
2022-04-06,Express Rail Link West Kowloon,0,0,0,0,0,0,0,0,Wednesday
2022-04-06,Hung Hom,0,0,0,0,0,0,0,0,Wednesday
2022-04-06,Lo Wu,0,0,0,0,0,0,0,0,Wednesday
2022-04-06,Lok Ma Chau Spur Line,0,0,0,0,0,0,0,0,Wednesday
2022-04-06,Heung Yuen Wai,0,0,0,0,0,0,0,0,Wednesday
2022-04-06,Hong Kong-Zhuhai-Macao Bridge,74,4,4,82,176,28,0,204,Wednesday
2022-04-06,Lok Ma Chau,0,0,0,0,0,0,0,0,Wednesday
2022-04-06,Man Kam To,0,0,0,0,0,0,0,0,Wednesday
2022-04-06,Sha Tau Kok,0,0,0,0,0,0,0,0,Wednesday
2022-04-06,Shenzhen Bay,576,70,1,647,295,62,0,357,Wednesday
2022-04-06,China Ferry Terminal,0,0,0,0,0,0,0,0,Wednesday
2022-04-06,Harbour Control,0,0,0,0,0,0,0,0,Wednesday
2022-04-06,Kai Tak Cruise Terminal,0,0,0,0,0,0,0,0,Wednesday
2022-04-06,Macau Ferry Terminal,0,0,0,0,0,0,0,0,Wednesday
2022-04-06,Total,1465,79,21,1565,2127,119,29,2275,Wednesday
2022-04-07,Airport,624,31,13,668,1652,48,32,1732,Thursday
2022-04-07,Express Rail Link West Kowloon,0,0,0,0,0,0,0,0,Thursday
2022-04-07,Hung Hom,0,0,0,0,0,0,0,0,Thursday
2022-04-07,Lo Wu,0,0,0,0,0,0,0,0,Thursday
2022-04-07,Heung Yuen Wai,0,0,0,0,0,0,0,0,Thursday
2022-04-07,Hong Kong-Zhuhai-Macao Bridge,55,11,5,71,150,23,6,179,Thursday
2022-04-07,Lok Ma Chau,0,0,0,0,0,0,0,0,Thursday
2022-04-07,Man Kam To,0,0,0,0,0,0,0,0,Thursday
2022-04-07,Sha Tau Kok,0,0,0,0,0,0,0,0,Thursday
2022-04-07,Shenzhen Bay,637,60,4,701,247,51,2,300,Thursday
2022-04-07,China Ferry Terminal,0,0,0,0,0,0,0,0,Thursday
2022-04-07,Harbour Control,0,0,0,0,0,0,0,0,Thursday
2022-04-07,Kai Tak Cruise Terminal,0,0,0,0,0,0,0,0,Thursday
2022-04-07,Macau Ferry Terminal,0,0,0,0,0,0,0,0,Thursday
2022-04-07,Total,1316,102,22,1440,2049,122,40,2211,Thursday
2022-04-08,Airport,927,13,13,953,2419,23,46,2488,Friday
2022-04-08,Express Rail Link West Kowloon,0,0,0,0,0,0,0,0,Friday
2022-04-08,Hung Hom,0,0,0,0,0,0,0,0,Friday
2022-04-08,Lo Wu,0,0,0,0,0,0,0,0,Friday
2022-04-08,Lok Ma Chau Spur Line,0,0,0,0,0,0,0,0,Friday
2022-04-08,Heung Yuen Wai,0,0,0,0,0,0,0,0,Friday
2022-04-08,Hong Kong-Zhuhai-Macao Bridge,58,5,7,70,175,25,0,200,Friday
2022-04-08,Lok Ma Chau,0,0,0,0,0,0,0,0,Friday
2022-04-08,Man Kam To,0,0,0,0,0,0,0,0,Friday
2022-04-08,Sha Tau Kok,0,0,0,0,0,0,0,0,Friday
2022-04-08,Shenzhen Bay,634,71,5,710,289,68,0,357,Friday
2022-04-08,China Ferry Terminal,0,0,0,0,0,0,0,0,Friday
2022-04-08,Harbour Control,0,0,0,0,0,0,0,0,Friday
2022-04-08,Kai Tak Cruise Terminal,0,0,0,0,0,0,0,0,Friday
2022-04-08,Macau Ferry Terminal,0,0,0,0,0,0,0,0,Friday
2022-04-08,Total,1619,89,25,1733,2883,116,46,3045,Friday
2022-04-09,Airport,1346,3,13,1362,1827,19,39,1885,Saturday
2022-04-09,Express Rail Link West Kowloon,0,0,0,0,0,0,0,0,Saturday
2022-04-09,Hung Hom,0,0,0,0,0,0,0,0,Saturday
2022-04-09,Lo Wu,0,0,0,0,0,0,0,0,Saturday
2022-04-09,Lok Ma Chau Spur Line,0,0,0,0,0,0,0,0,Saturday
2022-04-09,Heung Yuen Wai,0,0,0,0,0,0,0,0,Saturday
2022-04-09,Hong Kong-Zhuhai-Macao Bridge,58,7,8,73,164,21,0,185,Saturday
2022-04-09,Lok Ma Chau,0,0,0,0,0,0,0,0,Saturday
2022-04-09,Man Kam To,0,0,0,0,0,0,0,0,Saturday
2022-04-09,Sha Tau Kok,0,0,0,0,0,0,0,0,Saturday
2022-04-09,Shenzhen Bay,506,51,4,561,333,47,1,381,Saturday
2022-04-09,China Ferry Terminal,0,0,0,0,0,0,0,0,Saturday
2022-04-09,Harbour Control,0,0,0,0,0,0,0,0,Saturday
2022-04-09,Kai Tak Cruise Terminal,0,0,0,0,0,0,0,0,Saturday
2022-04-09,Macau Ferry Terminal,0,0,0,0,0,0,0,0,Saturday
2022-04-09,Total,1910,61,25,1996,2324,87,40,2451,Saturday
2022-04-10,Airport,1264,6,18,1288,1640,20,29,1689,Sunday
2022-04-10,Express Rail Link West Kowloon,0,0,0,0,0,0,0,0,Sunday
2022-04-10,Hung Hom,0,0,0,0,0,0,0,0,Sunday
2022-04-10,Lo Wu,0,0,0,0,0,0,0,0,Sunday
2022-04-10,Lok Ma Chau Spur Line,0,0,0,0,0,0,0,0,Sunday
2022-04-10,Heung Yuen Wai,0,0,0,0,0,0,0,0,Sunday
2022-04-10,Hong Kong-Zhuhai-Macao Bridge,96,6,3,105,156,17,0,173,Sunday
2022-04-10,Lok Ma Chau,0,0,0,0,0,0,0,0,Sunday
2022-04-10,Man Kam To,0,0,0,0,0,0,0,0,Sunday
2022-04-10,Sha Tau Kok,0,0,0,0,0,0,0,0,Sunday
2022-04-10,Shenzhen Bay,906,60,2,968,272,36,1,309,Sunday
2022-04-10,China Ferry Terminal,0,0,0,0,0,0,0,0,Sunday
2022-04-10,Harbour Control,0,0,0,0,0,0,0,0,Sunday
2022-04-10,Kai Tak Cruise Terminal,0,0,0,0,0,0,0,0,Sunday
2022-04-10,Macau Ferry Terminal,0,0,0,0,0,0,0,0,Sunday
2022-04-10,Total,2266,72,23,2361,2068,73,30,2171,Sunday
2022-04-11,Airport,1199,3,17,1219,1438,17,18,1473,Monday
2022-04-11,Express Rail Link West Kowloon,0,0,0,0,0,0,0,0,Monday
2022-04-11,Hung Hom,0,0,0,0,0,0,0,0,Monday
2022-04-11,Lo Wu,0,0,0,0,0,0,0,0,Monday
2022-04-11,Lok Ma Chau Spur Line,0,0,0,0,0,0,0,0,Monday
2022-04-11,Heung Yuen Wai,0,0,0,0,0,0,0,0,Monday
2022-04-11,Hong Kong-Zhuhai-Macao Bridge,72,2,3,77,120,8,1,129,Monday
2022-04-11,Lok Ma Chau,0,0,0,0,0,0,0,0,Monday
2022-04-11,Man Kam To,0,0,0,0,0,0,0,0,Monday
2022-04-11,Sha Tau Kok,0,0,0,0,0,0,0,0,Monday
2022-04-11,Shenzhen Bay,559,62,8,629,308,59,1,368,Monday
2022-04-11,China Ferry Terminal,0,0,0,0,0,0,0,0,Monday
2022-04-11,Harbour Control,0,0,0,0,0,0,0,0,Monday
2022-04-11,Kai Tak Cruise Terminal,0,0,0,0,0,0,0,0,Monday
2022-04-11,Macau Ferry Terminal,0,0,0,0,0,0,0,0,Monday
2022-04-11,Total,1830,67,28,1925,1866,84,20,1970,Monday
2022-04-13,Airport,1946,5,26,1977,1476,50,21,1547,Wednesday
2022-04-13,Express Rail Link West Kowloon,0,0,0,0,0,0,0,0,Wednesday
2022-04-13,Hung Hom,0,0,0,0,0,0,0,0,Wednesday
2022-04-13,Lo Wu,0,0,0,0,0,0,0,0,Wednesday
2022-04-13,Lok Ma Chau Spur Line,0,0,0,0,0,0,0,0,Wednesday
2022-04-13,Heung Yuen Wai,0,0,0,0,0,0,0,0,Wednesday
2022-04-13,Hong Kong-Zhuhai-Macao Bridge,68,3,1,72,159,16,3,178,Wednesday
2022-04-13,Lok Ma Chau,0,0,0,0,0,0,0,0,Wednesday
2022-04-13,Man Kam To,0,0,0,0,0,0,0,0,Wednesday
2022-04-13,Sha Tau Kok,0,0,0,0,0,0,0,0,Wednesday
2022-04-13,Shenzhen Bay,532,46,4,582,300,74,1,375,Wednesday
2022-04-13,China Ferry Terminal,0,0,0,0,0,0,0,0,Wednesday
2022-04-13,Harbour Control,0,0,0,0,0,0,0,0,Wednesday
2022-04-13,Kai Tak Cruise Terminal,0,0,0,0,0,0,0,0,Wednesday
2022-04-13,Macau Ferry Terminal,0,0,0,0,0,0,0,0,Wednesday
2022-04-13,Total,2546,54,31,2631,1935,140,25,2100,Wednesday
2022-04-12,Airport,1100,4,7,1111,1539,20,24,1583,Tuesday
2022-04-12,Express Rail Link West Kowloon,0,0,0,0,0,0,0,0,Tuesday
2022-04-12,Hung Hom,0,0,0,0,0,0,0,0,Tuesday
2022-04-12,Lo Wu,0,0,0,0,0,0,0,0,Tuesday
2022-04-12,Lok Ma Chau Spur Line,0,0,0,0,0,0,0,0,Tuesday
2022-04-12,Heung Yuen Wai,0,0,0,0,0,0,0,0,Tuesday
2022-04-12,Hong Kong-Zhuhai-Macao Bridge,51,11,12,74,137,15,2,154,Tuesday
2022-04-12,Lok Ma Chau,0,0,0,0,0,0,0,0,Tuesday
2022-04-12,Man Kam To,0,0,0,0,0,0,0,0,Tuesday
2022-04-12,Sha Tau Kok,0,0,0,0,0,0,0,0,Tuesday
2022-04-12,Shenzhen Bay,508,43,2,553,320,73,0,393,Tuesday
2022-04-12,China Ferry Terminal,0,0,0,0,0,0,0,0,Tuesday
2022-04-12,Harbour Control,0,0,0,0,0,0,0,0,Tuesday
2022-04-12,Kai Tak Cruise Terminal,0,0,0,0,0,0,0,0,Tuesday
2022-04-12,Macau Ferry Terminal,0,0,0,0,0,0,0,0,Tuesday
2022-04-12,Total,1659,58,21,1738,1996,108,26,2130,Tuesday
2022-04-14,Airport,1002,5,16,1023,1699,24,25,1748,Thursday
2022-04-14,Express Rail Link West Kowloon,0,0,0,0,0,0,0,0,Thursday
2022-04-14,Hung Hom,0,0,0,0,0,0,0,0,Thursday
2022-04-14,Lo Wu,0,0,0,0,0,0,0,0,Thursday
2022-04-14,Lok Ma Chau Spur Line,0,0,0,0,0,0,0,0,Thursday
2022-04-14,Heung Yuen Wai,0,0,0,0,0,0,0,0,Thursday
2022-04-14,Hong Kong-Zhuhai-Macao Bridge,47,5,4,56,130,12,3,145,Thursday
2022-04-14,Lok Ma Chau,0,0,0,0,0,0,0,0,Thursday
2022-04-14,Man Kam To,0,0,0,0,0,0,0,0,Thursday
2022-04-14,Sha Tau Kok,0,0,0,0,0,0,0,0,Thursday
2022-04-14,Shenzhen Bay,530,42,5,577,320,61,1,382,Thursday
2022-04-14,China Ferry Terminal,0,0,0,0,0,0,0,0,Thursday
2022-04-14,Harbour Control,0,0,0,0,0,0,0,0,Thursday
2022-04-14,Kai Tak Cruise Terminal,0,0,0,0,0,0,0,0,Thursday
2022-04-14,Macau Ferry Terminal,0,0,0,0,0,0,0,0,Thursday
2022-04-14,Total,1579,52,25,1656,2149,97,29,2275,Thursday
2022-04-15,Airport,1167,8,10,1185,2140,33,24,2197,Friday
2022-04-15,Express Rail Link West Kowloon,0,0,0,0,0,0,0,0,Friday
2022-04-15,Hung Hom,0,0,0,0,0,0,0,0,Friday
2022-04-15,Lo Wu,0,0,0,0,0,0,0,0,Friday
2022-04-15,Lok Ma Chau Spur Line,0,0,0,0,0,0,0,0,Friday
2022-04-15,Heung Yuen Wai,0,0,0,0,0,0,0,0,Friday
2022-04-15,Hong Kong-Zhuhai-Macao Bridge,81,10,4,95,128,26,0,154,Friday
2022-04-15,Lok Ma Chau,0,0,0,0,0,0,0,0,Friday
2022-04-15,Man Kam To,0,0,0,0,0,0,0,0,Friday
2022-04-15,Sha Tau Kok,0,0,0,0,0,0,0,0,Friday
2022-04-15,Shenzhen Bay,653,58,3,714,324,70,2,396,Friday
2022-04-15,China Ferry Terminal,0,0,0,0,0,0,0,0,Friday
2022-04-15,Harbour Control,0,0,0,0,0,0,0,0,Friday
2022-04-15,Kai Tak Cruise Terminal,0,0,0,0,0,0,0,0,Friday
2022-04-15,Macau Ferry Terminal,0,0,0,0,0,0,0,0,Friday
2022-04-15,Total,1901,76,17,1994,2592,129,26,2747,Friday
2022-04-17,Airport,1071,3,24,1098,1391,31,32,1454,Sunday
2022-04-17,Express Rail Link West Kowloon,0,0,0,0,0,0,0,0,Sunday
2022-04-17,Hung Hom,0,0,0,0,0,0,0,0,Sunday
2022-04-17,Lo Wu,0,0,0,0,0,0,0,0,Sunday
2022-04-17,Lok Ma Chau Spur Line,0,0,0,0,0,0,0,0,Sunday
2022-04-17,Heung Yuen Wai,0,0,0,0,0,0,0,0,Sunday
2022-04-17,Hong Kong-Zhuhai-Macao Bridge,119,2,5,126,142,16,2,160,Sunday
2022-04-17,Lok Ma Chau,0,0,0,0,0,0,0,0,Sunday
2022-04-17,Man Kam To,0,0,0,0,0,0,0,0,Sunday
2022-04-17,Sha Tau Kok,0,0,0,0,0,0,0,0,Sunday
2022-04-17,Shenzhen Bay,963,62,1,1026,319,64,0,383,Sunday
2022-04-17,China Ferry Terminal,0,0,0,0,0,0,0,0,Sunday
2022-04-17,Harbour Control,0,0,0,0,0,0,0,0,Sunday
2022-04-17,Kai Tak Cruise Terminal,0,0,0,0,0,0,0,0,Sunday
2022-04-17,Macau Ferry Terminal,0,0,0,0,0,0,0,0,Sunday
2022-04-17,Total,2153,67,30,2250,1852,111,34,1997,Sunday
2022-04-16,Airport,1497,4,5,1506,1315,29,20,1364,Saturday
2022-04-16,Express Rail Link West Kowloon,0,0,0,0,0,0,0,0,Saturday
2022-04-16,Hung Hom,0,0,0,0,0,0,0,0,Saturday
2022-04-16,Lo Wu,0,0,0,0,0,0,0,0,Saturday
2022-04-16,Lok Ma Chau Spur Line,0,0,0,0,0,0,0,0,Saturday
2022-04-16,Heung Yuen Wai,0,0,0,0,0,0,0,0,Saturday
2022-04-16,Hong Kong-Zhuhai-Macao Bridge,57,5,4,66,144,11,2,157,Saturday
2022-04-16,Lok Ma Chau,0,0,0,0,0,0,0,0,Saturday
2022-04-16,Man Kam To,0,0,0,0,0,0,0,0,Saturday
2022-04-16,Sha Tau Kok,0,0,0,0,0,0,0,0,Saturday
2022-04-16,Shenzhen Bay,574,61,2,637,328,72,1,401,Saturday
2022-04-16,China Ferry Terminal,0,0,0,0,0,0,0,0,Saturday
2022-04-16,Harbour Control,0,0,0,0,0,0,0,0,Saturday
2022-04-16,Kai Tak Cruise Terminal,0,0,0,0,0,0,0,0,Saturday
2022-04-16,Macau Ferry Terminal,0,0,0,0,0,0,0,0,Saturday
2022-04-16,Total,2128,70,11,2209,1787,112,23,1922,Saturday
2022-04-18,Airport,969,8,11,988,1611,26,18,1655,Monday
2022-04-18,Express Rail Link West Kowloon,0,0,0,0,0,0,0,0,Monday
2022-04-18,Hung Hom,0,0,0,0,0,0,0,0,Monday
2022-04-18,Lo Wu,0,0,0,0,0,0,0,0,Monday
2022-04-18,Lok Ma Chau Spur Line,0,0,0,0,0,0,0,0,Monday
2022-04-18,Heung Yuen Wai,0,0,0,0,0,0,0,0,Monday
2022-04-18,Hong Kong-Zhuhai-Macao Bridge,138,10,4,152,173,32,0,205,Monday
2022-04-18,Lok Ma Chau,0,0,0,0,0,0,0,0,Monday
2022-04-18,Man Kam To,0,0,0,0,0,0,0,0,Monday
2022-04-18,Sha Tau Kok,0,0,0,0,0,0,0,0,Monday
2022-04-18,Shenzhen Bay,1087,75,3,1165,368,60,1,429,Monday
2022-04-18,China Ferry Terminal,0,0,0,0,0,0,0,0,Monday
2022-04-18,Harbour Control,0,0,0,0,0,0,0,0,Monday
2022-04-18,Kai Tak Cruise Terminal,0,0,0,0,0,0,0,0,Monday
2022-04-18,Macau Ferry Terminal,0,0,0,0,0,0,0,0,Monday
2022-04-18,Total,2194,93,18,2305,2152,118,19,2289,Monday
2022-04-19,Airport,1251,0,8,1259,978,16,21,1015,Tuesday
2022-04-24,Macau Ferry Terminal,0,0,0,0,0,0,0,0,Sunday
2022-04-19,Express Rail Link West Kowloon,0,0,0,0,0,0,0,0,Tuesday
2022-04-19,Hung Hom,0,0,0,0,0,0,0,0,Tuesday
2022-04-19,Lo Wu,0,0,0,0,0,0,0,0,Tuesday
2022-04-19,Lok Ma Chau Spur Line,0,0,0,0,0,0,0,0,Tuesday
2022-04-19,Heung Yuen Wai,0,0,0,0,0,0,0,0,Tuesday
2022-04-19,Hong Kong-Zhuhai-Macao Bridge,109,5,3,117,153,29,2,184,Tuesday
2022-04-19,Lok Ma Chau,0,0,0,0,0,0,0,0,Tuesday
2022-04-19,Man Kam To,0,0,0,0,0,0,0,0,Tuesday
2022-04-19,Sha Tau Kok,0,0,0,0,0,0,0,0,Tuesday
2022-04-19,Shenzhen Bay,1011,76,0,1087,331,64,3,398,Tuesday
2022-04-19,China Ferry Terminal,0,0,0,0,0,0,0,0,Tuesday
2022-04-19,Harbour Control,0,0,0,0,0,0,0,0,Tuesday
2022-04-19,Kai Tak Cruise Terminal,0,0,0,0,0,0,0,0,Tuesday
2022-04-19,Macau Ferry Terminal,0,0,0,0,0,0,0,0,Tuesday
2022-04-19,Total,2371,81,11,2463,1462,109,26,1597,Tuesday
2022-04-20,Airport,1587,6,16,1609,1698,46,42,1786,Wednesday
2022-04-20,Express Rail Link West Kowloon,0,0,0,0,0,0,0,0,Wednesday
2022-04-20,Hung Hom,0,0,0,0,0,0,0,0,Wednesday
2022-04-20,Lo Wu,0,0,0,0,0,0,0,0,Wednesday
2022-04-20,Lok Ma Chau Spur Line,0,0,0,0,0,0,0,0,Wednesday
2022-04-20,Heung Yuen Wai,0,0,0,0,0,0,0,0,Wednesday
2022-04-20,Hong Kong-Zhuhai-Macao Bridge,101,6,6,113,164,19,2,185,Wednesday
2022-04-20,Lok Ma Chau,0,0,0,0,0,0,0,0,Wednesday
2022-04-20,Man Kam To,0,0,0,0,0,0,0,0,Wednesday
2022-04-20,Sha Tau Kok,0,0,0,0,0,0,0,0,Wednesday
2022-04-20,Shenzhen Bay,1101,70,7,1178,291,59,0,350,Wednesday
2022-04-20,China Ferry Terminal,0,0,0,0,0,0,0,0,Wednesday
2022-04-20,Harbour Control,0,0,0,0,0,0,0,0,Wednesday
2022-04-20,Kai Tak Cruise Terminal,0,0,0,0,0,0,0,0,Wednesday
2022-04-20,Macau Ferry Terminal,0,0,0,0,0,0,0,0,Wednesday
2022-04-20,Total,2789,82,29,2900,2153,124,44,2321,Wednesday
2022-04-21,Airport,1903,13,12,1928,1408,49,23,1480,Thursday
2022-04-21,Express Rail Link West Kowloon,0,0,0,0,0,0,0,0,Thursday
2022-04-21,Hung Hom,0,0,0,0,0,0,0,0,Thursday
2022-04-21,Lo Wu,0,0,0,0,0,0,0,0,Thursday
2022-04-21,Lok Ma Chau Spur Line,0,0,0,0,0,0,0,0,Thursday
2022-04-21,Heung Yuen Wai,0,0,0,0,0,0,0,0,Thursday
2022-04-21,Hong Kong-Zhuhai-Macao Bridge,57,1,10,68,167,10,1,178,Thursday
2022-04-21,Lok Ma Chau,0,0,0,0,0,0,0,0,Thursday
2022-04-21,Man Kam To,0,0,0,0,0,0,0,0,Thursday
2022-04-21,Sha Tau Kok,0,0,0,0,0,0,0,0,Thursday
2022-04-21,Shenzhen Bay,606,69,3,678,291,67,2,360,Thursday
2022-04-21,China Ferry Terminal,0,0,0,0,0,0,0,0,Thursday
2022-04-21,Harbour Control,0,0,0,0,0,0,0,0,Thursday
2022-04-21,Kai Tak Cruise Terminal,0,0,0,0,0,0,0,0,Thursday
2022-04-21,Macau Ferry Terminal,0,0,0,0,0,0,0,0,Thursday
2022-04-21,Total,2566,83,25,2674,1866,126,26,2018,Thursday
2022-04-22,Airport,1819,17,18,1854,1679,27,28,1734,Friday
2022-04-22,Express Rail Link West Kowloon,0,0,0,0,0,0,0,0,Friday
2022-04-22,Hung Hom,0,0,0,0,0,0,0,0,Friday
2022-04-22,Lo Wu,0,0,0,0,0,0,0,0,Friday
2022-04-22,Lok Ma Chau Spur Line,0,0,0,0,0,0,0,0,Friday
2022-04-22,Heung Yuen Wai,0,0,0,0,0,0,0,0,Friday
2022-04-22,Hong Kong-Zhuhai-Macao Bridge,94,9,6,109,168,24,0,192,Friday
2022-04-22,Lok Ma Chau,0,0,0,0,0,0,0,0,Friday
2022-04-22,Man Kam To,0,0,0,0,0,0,0,0,Friday
2022-04-22,Sha Tau Kok,0,0,0,0,0,0,0,0,Friday
2022-04-22,Shenzhen Bay,736,74,2,812,306,54,0,360,Friday
2022-04-22,China Ferry Terminal,0,0,0,0,0,0,0,0,Friday
2022-04-22,Harbour Control,0,0,0,0,0,0,0,0,Friday
2022-04-22,Kai Tak Cruise Terminal,0,0,0,0,0,0,0,0,Friday
2022-04-22,Macau Ferry Terminal,0,0,0,0,0,0,0,0,Friday
2022-04-22,Total,2649,100,26,2775,2153,105,28,2286,Friday
2022-04-23,Airport,1969,11,24,2004,1334,10,20,1364,Saturday
2022-04-23,Express Rail Link West Kowloon,0,0,0,0,0,0,0,0,Saturday
2022-04-23,Hung Hom,0,0,0,0,0,0,0,0,Saturday
2022-04-23,Lo Wu,0,0,0,0,0,0,0,0,Saturday
2022-04-23,Lok Ma Chau Spur Line,0,0,0,0,0,0,0,0,Saturday
2022-04-23,Heung Yuen Wai,0,0,0,0,0,0,0,0,Saturday
2022-04-23,Hong Kong-Zhuhai-Macao Bridge,129,7,14,150,148,23,0,171,Saturday
2022-04-23,Lok Ma Chau,0,0,0,0,0,0,0,0,Saturday
2022-04-23,Man Kam To,0,0,0,0,0,0,0,0,Saturday
2022-04-23,Sha Tau Kok,0,0,0,0,0,0,0,0,Saturday
2022-04-23,Shenzhen Bay,1131,113,4,1248,301,113,1,415,Saturday
2022-04-23,China Ferry Terminal,0,0,0,0,0,0,0,0,Saturday
2022-04-23,Harbour Control,0,0,0,0,0,0,0,0,Saturday
2022-04-23,Kai Tak Cruise Terminal,0,0,0,0,0,0,0,0,Saturday
2022-04-23,Macau Ferry Terminal,0,0,0,0,0,0,0,0,Saturday
2022-04-23,Total,3229,131,42,3402,1783,146,21,1950,Saturday
2022-04-24,Airport,1529,10,11,1550,1749,11,51,1811,Sunday
2022-04-24,Express Rail Link West Kowloon,0,0,0,0,0,0,0,0,Sunday
2022-04-24,Hung Hom,0,0,0,0,0,0,0,0,Sunday
2022-04-24,Lo Wu,0,0,0,0,0,0,0,0,Sunday
2022-04-24,Lok Ma Chau Spur Line,0,0,0,0,0,0,0,0,Sunday
2022-04-24,Heung Yuen Wai,0,0,0,0,0,0,0,0,Sunday
2022-04-24,Hong Kong-Zhuhai-Macao Bridge,148,6,7,161,160,13,2,175,Sunday
2022-04-24,Lok Ma Chau,0,0,0,0,0,0,0,0,Sunday
2022-04-24,Man Kam To,0,0,0,0,0,0,0,0,Sunday
2022-04-24,Sha Tau Kok,0,0,0,0,0,0,0,0,Sunday
2022-04-24,Shenzhen Bay,1560,119,5,1684,327,69,1,397,Sunday
2022-04-24,China Ferry Terminal,0,0,0,0,0,0,0,0,Sunday
2022-04-24,Harbour Control,0,0,0,0,0,0,0,0,Sunday
2022-04-24,Kai Tak Cruise Terminal,0,0,0,0,0,0,0,0,Sunday
2022-04-24,Total,3237,135,23,3395,2236,93,54,2383,Sunday
2022-04-25,Airport,910,19,9,938,1321,19,29,1369,Monday
2022-04-25,Express Rail Link West Kowloon,0,0,0,0,0,0,0,0,Monday
2022-04-25,Hung Hom,0,0,0,0,0,0,0,0,Monday
2022-04-25,Lo Wu,0,0,0,0,0,0,0,0,Monday
2022-04-25,Lok Ma Chau Spur Line,0,0,0,0,0,0,0,0,Monday
2022-04-25,Heung Yuen Wai,0,0,0,0,0,0,0,0,Monday
2022-04-25,Hong Kong-Zhuhai-Macao Bridge,90,7,7,104,155,14,3,172,Monday
2022-04-25,Lok Ma Chau,0,0,0,0,0,0,0,0,Monday
2022-04-25,Man Kam To,0,0,0,0,0,0,0,0,Monday
2022-04-25,Sha Tau Kok,0,0,0,0,0,0,0,0,Monday
2022-04-25,Shenzhen Bay,823,119,3,945,388,66,0,454,Monday
2022-04-25,China Ferry Terminal,0,0,0,0,0,0,0,0,Monday
2022-04-25,Harbour Control,0,0,0,0,0,0,0,0,Monday
2022-04-25,Kai Tak Cruise Terminal,0,0,0,0,0,0,0,0,Monday
2022-04-25,Macau Ferry Terminal,0,0,0,0,0,0,0,0,Monday
2022-04-25,Total,1823,145,19,1987,1864,99,32,1995,Monday
2022-04-26,Airport,1123,8,4,1135,1389,14,37,1440,Tuesday
2022-04-26,Express Rail Link West Kowloon,0,0,0,0,0,0,0,0,Tuesday
2022-04-26,Hung Hom,0,0,0,0,0,0,0,0,Tuesday
2022-04-26,Lo Wu,0,0,0,0,0,0,0,0,Tuesday
2022-04-26,Lok Ma Chau Spur Line,0,0,0,0,0,0,0,0,Tuesday
2022-04-26,Heung Yuen Wai,0,0,0,0,0,0,0,0,Tuesday
2022-04-26,Hong Kong-Zhuhai-Macao Bridge,91,6,5,102,172,15,0,187,Tuesday
2022-04-26,Lok Ma Chau,0,0,0,0,0,0,0,0,Tuesday
2022-04-26,Man Kam To,0,0,0,0,0,0,0,0,Tuesday
2022-04-26,Sha Tau Kok,0,0,0,0,0,0,0,0,Tuesday
2022-04-26,Shenzhen Bay,810,91,7,908,305,46,1,352,Tuesday
2022-04-26,China Ferry Terminal,0,0,0,0,0,0,0,0,Tuesday
2022-04-26,Harbour Control,0,0,0,0,0,0,0,0,Tuesday
2022-04-26,Kai Tak Cruise Terminal,0,0,0,0,0,0,0,0,Tuesday
2022-04-26,Macau Ferry Terminal,0,0,0,0,0,0,0,0,Tuesday
2022-04-26,Total,2024,105,16,2145,1866,75,38,1979,Tuesday
2022-04-27,Airport,1652,19,14,1685,2368,45,49,2462,Wednesday
2022-04-27,Express Rail Link West Kowloon,0,0,0,0,0,0,0,0,Wednesday
2022-04-27,Hung Hom,0,0,0,0,0,0,0,0,Wednesday
2022-04-27,Lo Wu,0,0,0,0,0,0,0,0,Wednesday
2022-04-27,Lok Ma Chau Spur Line,0,0,0,0,0,0,0,0,Wednesday
2022-04-27,Heung Yuen Wai,0,0,0,0,0,0,0,0,Wednesday
2022-04-27,Hong Kong-Zhuhai-Macao Bridge,102,3,5,110,154,17,0,171,Wednesday
2022-04-27,Lok Ma Chau,0,0,0,0,0,0,0,0,Wednesday
2022-04-27,Man Kam To,0,0,0,0,0,0,0,0,Wednesday
2022-04-27,Sha Tau Kok,0,0,0,0,0,0,0,0,Wednesday
2022-04-27,Shenzhen Bay,788,93,10,891,364,61,2,427,Wednesday
2022-04-27,China Ferry Terminal,0,0,0,0,0,0,0,0,Wednesday
2022-04-27,Harbour Control,0,0,0,0,0,0,0,0,Wednesday
2022-04-27,Kai Tak Cruise Terminal,0,0,0,0,0,0,0,0,Wednesday
2022-04-27,Macau Ferry Terminal,0,0,0,0,0,0,0,0,Wednesday
2022-04-27,Total,2542,115,29,2686,2886,123,51,3060,Wednesday
2022-04-28,Airport,2176,14,16,2206,1433,32,29,1494,Thursday
2022-04-28,Express Rail Link West Kowloon,0,0,0,0,0,0,0,0,Thursday
2022-04-28,Hung Hom,0,0,0,0,0,0,0,0,Thursday
2022-04-28,Lo Wu,0,0,0,0,0,0,0,0,Thursday
2022-04-28,Lok Ma Chau Spur Line,0,0,0,0,0,0,0,0,Thursday
2022-04-28,Heung Yuen Wai,0,0,0,0,0,0,0,0,Thursday
2022-04-28,Hong Kong-Zhuhai-Macao Bridge,69,9,3,81,141,22,0,163,Thursday
2022-04-28,Lok Ma Chau,0,0,0,0,0,0,0,0,Thursday
2022-04-28,Man Kam To,0,0,0,0,0,0,0,0,Thursday
2022-04-28,Sha Tau Kok,0,0,0,0,0,0,0,0,Thursday
2022-04-28,Shenzhen Bay,913,99,4,1016,622,69,4,695,Thursday
2022-04-28,China Ferry Terminal,0,0,0,0,0,0,0,0,Thursday
2022-04-28,Harbour Control,0,0,0,0,0,0,0,0,Thursday
2022-04-28,Kai Tak Cruise Terminal,0,0,0,0,0,0,0,0,Thursday
2022-04-28,Macau Ferry Terminal,0,0,0,0,0,0,0,0,Thursday
2022-04-28,Total,3158,122,23,3303,2196,123,33,2352,Thursday
2022-04-29,Airport,2122,12,32,2166,1948,28,44,2020,Friday
2022-04-29,Express Rail Link West Kowloon,0,0,0,0,0,0,0,0,Friday
2022-04-29,Hung Hom,0,0,0,0,0,0,0,0,Friday
2022-04-29,Lo Wu,0,0,0,0,0,0,0,0,Friday
2022-04-29,Lok Ma Chau Spur Line,0,0,0,0,0,0,0,0,Friday
2022-04-29,Heung Yuen Wai,0,0,0,0,0,0,0,0,Friday
2022-04-29,Hong Kong-Zhuhai-Macao Bridge,109,6,7,122,147,14,2,163,Friday
2022-04-29,Lok Ma Chau,0,0,0,0,0,0,0,0,Friday
2022-04-29,Man Kam To,0,0,0,0,0,0,0,0,Friday
2022-04-29,Sha Tau Kok,0,0,0,0,0,0,0,0,Friday
2022-04-29,Shenzhen Bay,1045,105,2,1152,444,86,2,532,Friday
2022-04-29,China Ferry Terminal,0,0,0,0,0,0,0,0,Friday
2022-04-29,Harbour Control,0,0,0,0,0,0,0,0,Friday
2022-04-29,Kai Tak Cruise Terminal,0,0,0,0,0,0,0,0,Friday
2022-04-29,Macau Ferry Terminal,0,0,0,0,0,0,0,0,Friday
2022-04-29,Total,3276,123,41,3440,2539,128,48,2715,Friday
2022-04-30,Airport,2876,13,32,2921,2325,18,42,2385,Saturday
2022-04-30,Express Rail Link West Kowloon,0,0,0,0,0,0,0,0,Saturday
2022-04-30,Hung Hom,0,0,0,0,0,0,0,0,Saturday
2022-04-30,Lo Wu,0,0,0,0,0,0,0,0,Saturday
2022-04-30,Lok Ma Chau Spur Line,0,0,0,0,0,0,0,0,Saturday
2022-04-30,Heung Yuen Wai,0,0,0,0,0,0,0,0,Saturday
2022-04-30,Hong Kong-Zhuhai-Macao Bridge,126,11,8,145,115,14,1,130,Saturday
2022-04-30,Lok Ma Chau,0,0,0,0,0,0,0,0,Saturday
2022-04-30,Man Kam To,0,0,0,0,0,0,0,0,Saturday
2022-04-30,Sha Tau Kok,0,0,0,0,0,0,0,0,Saturday
2022-04-30,Shenzhen Bay,1558,154,6,1718,485,76,2,563,Saturday
2022-04-30,China Ferry Terminal,0,0,0,0,0,0,0,0,Saturday
2022-04-30,Harbour Control,0,0,0,0,0,0,0,0,Saturday
2022-04-30,Kai Tak Cruise Terminal,0,0,0,0,0,0,0,0,Saturday
2022-04-30,Macau Ferry Terminal,0,0,0,0,0,0,0,0,Saturday
2022-04-30,Total,4560,178,46,4784,2925,108,45,3078,Saturday
2022-05-01,Airport,1845,9,52,1906,2437,15,45,2497,Sunday
2022-05-01,Express Rail Link West Kowloon,0,0,0,0,0,0,0,0,Sunday
2022-05-01,Hung Hom,0,0,0,0,0,0,0,0,Sunday
2022-05-01,Lo Wu,0,0,0,0,0,0,0,0,Sunday
2022-05-01,Lok Ma Chau Spur Line,0,0,0,0,0,0,0,0,Sunday
2022-05-01,Heung Yuen Wai,0,0,0,0,0,0,0,0,Sunday
2022-05-01,Hong Kong-Zhuhai-Macao Bridge,194,12,7,213,152,11,1,164,Sunday
2022-05-01,Lok Ma Chau,0,0,0,0,0,0,0,0,Sunday
2022-05-01,Man Kam To,0,0,0,0,0,0,0,0,Sunday
2022-05-01,Sha Tau Kok,0,0,0,0,0,0,0,0,Sunday
2022-05-01,Shenzhen Bay,2515,310,7,2832,411,72,1,484,Sunday
2022-05-01,China Ferry Terminal,0,0,0,0,0,0,0,0,Sunday
2022-05-01,Harbour Control,0,0,0,0,0,0,0,0,Sunday
2022-05-01,Kai Tak Cruise Terminal,0,0,0,0,0,0,0,0,Sunday
2022-05-01,Macau Ferry Terminal,0,0,0,0,0,0,0,0,Sunday
2022-05-01,Total,4554,331,66,4951,3000,98,47,3145,Sunday
2022-05-02,Airport,1416,13,47,1476,1386,26,14,1426,Monday
2022-05-02,Express Rail Link West Kowloon,0,0,0,0,0,0,0,0,Monday
2022-05-02,Hung Hom,0,0,0,0,0,0,0,0,Monday
2022-05-02,Lo Wu,0,0,0,0,0,0,0,0,Monday
2022-05-02,Lok Ma Chau Spur Line,0,0,0,0,0,0,0,0,Monday
2022-05-02,Heung Yuen Wai,0,0,0,0,0,0,0,0,Monday
2022-05-02,Hong Kong-Zhuhai-Macao Bridge,236,19,1,256,117,11,1,129,Monday
2022-05-02,Lok Ma Chau,0,0,0,0,0,0,0,0,Monday
2022-05-02,Man Kam To,0,0,0,0,0,0,0,0,Monday
2022-05-02,Sha Tau Kok,0,0,0,0,0,0,0,0,Monday
2022-05-02,Shenzhen Bay,2443,280,6,2729,449,81,3,533,Monday
2022-05-02,China Ferry Terminal,0,0,0,0,0,0,0,0,Monday
2022-05-02,Harbour Control,0,0,0,0,0,0,0,0,Monday
2022-05-02,Kai Tak Cruise Terminal,0,0,0,0,0,0,0,0,Monday
2022-05-02,Macau Ferry Terminal,0,0,0,0,0,0,0,0,Monday
2022-05-02,Total,4095,312,54,4461,1952,118,18,2088,Monday
2022-05-03,Airport,1306,14,65,1385,1373,27,19,1419,Tuesday
2022-05-03,Express Rail Link West Kowloon,0,0,0,0,0,0,0,0,Tuesday
2022-05-03,Hung Hom,0,0,0,0,0,0,0,0,Tuesday
2022-05-03,Lo Wu,0,0,0,0,0,0,0,0,Tuesday
2022-05-03,Lok Ma Chau Spur Line,0,0,0,0,0,0,0,0,Tuesday
2022-05-03,Heung Yuen Wai,0,0,0,0,0,0,0,0,Tuesday
2022-05-03,Hong Kong-Zhuhai-Macao Bridge,82,8,13,103,126,25,2,153,Tuesday
2022-05-03,Lok Ma Chau,0,0,0,0,0,0,0,0,Tuesday
2022-05-03,Man Kam To,0,0,0,0,0,0,0,0,Tuesday
2022-05-03,Sha Tau Kok,0,0,0,0,0,0,0,0,Tuesday
2022-05-03,Shenzhen Bay,911,110,6,1027,383,77,3,463,Tuesday
2022-05-03,China Ferry Terminal,0,0,0,0,0,0,0,0,Tuesday
2022-05-03,Harbour Control,0,0,0,0,0,0,0,0,Tuesday
2022-05-03,Kai Tak Cruise Terminal,0,0,0,0,0,0,0,0,Tuesday
2022-05-03,Macau Ferry Terminal,0,0,0,0,0,0,0,0,Tuesday
2022-05-03,Total,2299,132,84,2515,1882,129,24,2035,Tuesday
2022-05-04,Airport,1490,19,84,1593,1583,24,20,1627,Wednesday
2022-05-04,Express Rail Link West Kowloon,0,0,0,0,0,0,0,0,Wednesday
2022-05-04,Hung Hom,0,0,0,0,0,0,0,0,Wednesday
2022-05-04,Lo Wu,0,0,0,0,0,0,0,0,Wednesday
2022-05-04,Lok Ma Chau Spur Line,0,0,0,0,0,0,0,0,Wednesday
2022-05-04,Heung Yuen Wai,0,0,0,0,0,0,0,0,Wednesday
2022-05-04,Hong Kong-Zhuhai-Macao Bridge,74,5,7,86,139,14,2,155,Wednesday
2022-05-04,Lok Ma Chau,0,0,0,0,0,0,0,0,Wednesday
2022-05-04,Man Kam To,0,0,0,0,0,0,0,0,Wednesday
2022-05-04,Sha Tau Kok,0,0,0,0,0,0,0,0,Wednesday
2022-05-04,Shenzhen Bay,804,82,7,893,424,91,0,515,Wednesday
2022-05-04,China Ferry Terminal,0,0,0,0,0,0,0,0,Wednesday
2022-05-04,Harbour Control,0,0,0,0,0,0,0,0,Wednesday
2022-05-04,Kai Tak Cruise Terminal,0,0,0,0,0,0,0,0,Wednesday
2022-05-04,Macau Ferry Terminal,0,0,0,0,0,0,0,0,Wednesday
2022-05-04,Total,2368,106,98,2572,2146,129,22,2297,Wednesday
2022-05-06,Airport,1735,19,112,1866,2075,46,22,2143,Friday
2022-05-06,Express Rail Link West Kowloon,0,0,0,0,0,0,0,0,Friday
2022-05-06,Hung Hom,0,0,0,0,0,0,0,0,Friday
2022-05-06,Lo Wu,0,0,0,0,0,0,0,0,Friday
2022-05-06,Lok Ma Chau Spur Line,0,0,0,0,0,0,0,0,Friday
2022-05-06,Heung Yuen Wai,0,0,0,0,0,0,0,0,Friday
2022-05-06,Hong Kong-Zhuhai-Macao Bridge,111,12,13,136,126,22,0,148,Friday
2022-05-06,Lok Ma Chau,0,0,0,0,0,0,0,0,Friday
2022-05-06,Man Kam To,0,0,0,0,0,0,0,0,Friday
2022-05-06,Sha Tau Kok,0,0,0,0,0,0,0,0,Friday
2022-05-06,Shenzhen Bay,895,112,4,1011,532,94,1,627,Friday
2022-05-06,China Ferry Terminal,0,0,0,0,0,0,0,0,Friday
2022-05-06,Harbour Control,0,0,0,0,0,0,0,0,Friday
2022-05-06,Kai Tak Cruise Terminal,0,0,0,0,0,0,0,0,Friday
2022-05-06,Macau Ferry Terminal,0,0,0,0,0,0,0,0,Friday
2022-05-06,Total,2741,143,129,3013,2733,162,23,2918,Friday
2022-05-05,Airport,1521,21,52,1594,1986,68,36,2090,Thursday
2022-05-05,Express Rail Link West Kowloon,0,0,0,0,0,0,0,0,Thursday
2022-05-05,Hung Hom,0,0,0,0,0,0,0,0,Thursday
2022-05-05,Lo Wu,0,0,0,0,0,0,0,0,Thursday
2022-05-05,Lok Ma Chau Spur Line,0,0,0,0,0,0,0,0,Thursday
2022-05-05,Heung Yuen Wai,0,0,0,0,0,0,0,0,Thursday
2022-05-05,Hong Kong-Zhuhai-Macao Bridge,74,17,11,102,135,19,2,156,Thursday
2022-05-05,Lok Ma Chau,0,0,0,0,0,0,0,0,Thursday
2022-05-05,Man Kam To,0,0,0,0,0,0,0,0,Thursday
2022-05-05,Sha Tau Kok,0,0,0,0,0,0,0,0,Thursday
2022-05-05,Shenzhen Bay,899,99,5,1003,720,94,2,816,Thursday
2022-05-05,China Ferry Terminal,0,0,0,0,0,0,0,0,Thursday
2022-05-05,Harbour Control,0,0,0,0,0,0,0,0,Thursday
2022-05-05,Kai Tak Cruise Terminal,0,0,0,0,0,0,0,0,Thursday
2022-05-05,Macau Ferry Terminal,0,0,0,0,0,0,0,0,Thursday
2022-05-05,Total,2494,137,68,2699,2841,181,40,3062,Thursday
2022-05-07,Airport,2419,10,100,2529,2237,23,33,2293,Saturday
2022-05-07,Express Rail Link West Kowloon,0,0,0,0,0,0,0,0,Saturday
2022-05-07,Hung Hom,0,0,0,0,0,0,0,0,Saturday
2022-05-07,Lo Wu,0,0,0,0,0,0,0,0,Saturday
2022-05-07,Lok Ma Chau Spur Line,0,0,0,0,0,0,0,0,Saturday
2022-05-07,Heung Yuen Wai,0,0,0,0,0,0,0,0,Saturday
2022-05-07,Hong Kong-Zhuhai-Macao Bridge,105,10,13,128,122,20,2,144,Saturday
2022-05-07,Lok Ma Chau,0,0,0,0,0,0,0,0,Saturday
2022-05-07,Man Kam To,0,0,0,0,0,0,0,0,Saturday
2022-05-07,Sha Tau Kok,0,0,0,0,0,0,0,0,Saturday
2022-05-07,Shenzhen Bay,1188,166,7,1361,568,128,1,697,Saturday
2022-05-07,China Ferry Terminal,0,0,0,0,0,0,0,0,Saturday
2022-05-07,Harbour Control,0,0,0,0,0,0,0,0,Saturday
2022-05-07,Kai Tak Cruise Terminal,0,0,0,0,0,0,0,0,Saturday
2022-05-07,Macau Ferry Terminal,0,0,0,0,0,0,0,0,Saturday
2022-05-07,Total,3712,186,120,4018,2927,171,36,3134,Saturday
2022-05-08,Airport,3034,31,98,3163,2262,58,40,2360,Sunday
2022-05-08,Express Rail Link West Kowloon,0,0,0,0,0,0,0,0,Sunday
2022-05-08,Hung Hom,0,0,0,0,0,0,0,0,Sunday
2022-05-08,Lo Wu,0,0,0,0,0,0,0,0,Sunday
2022-05-08,Lok Ma Chau Spur Line,0,0,0,0,0,0,0,0,Sunday
2022-05-08,Heung Yuen Wai,0,0,0,0,0,0,0,0,Sunday
2022-05-08,Hong Kong-Zhuhai-Macao Bridge,163,15,7,185,143,10,4,157,Sunday
2022-05-08,Lok Ma Chau,0,0,0,0,0,0,0,0,Sunday
2022-05-08,Man Kam To,0,0,0,0,0,0,0,0,Sunday
2022-05-08,Sha Tau Kok,0,0,0,0,0,0,0,0,Sunday
2022-05-08,Shenzhen Bay,2031,270,1,2302,505,105,2,612,Sunday
2022-05-08,China Ferry Terminal,0,0,0,0,0,0,0,0,Sunday
2022-05-08,Harbour Control,0,0,0,0,0,0,0,0,Sunday
2022-05-08,Kai Tak Cruise Terminal,0,0,0,0,0,0,0,0,Sunday
2022-05-08,Macau Ferry Terminal,0,0,0,0,0,0,0,0,Sunday
2022-05-08,Total,5228,316,106,5650,2910,173,46,3129,Sunday
2022-05-09,Airport,1651,27,77,1755,1440,16,28,1484,Monday
2022-05-09,Express Rail Link West Kowloon,0,0,0,0,0,0,0,0,Monday
2022-05-09,Hung Hom,0,0,0,0,0,0,0,0,Monday
2022-05-09,Lo Wu,0,0,0,0,0,0,0,0,Monday
2022-05-09,Lok Ma Chau Spur Line,0,0,0,0,0,0,0,0,Monday
2022-05-09,Heung Yuen Wai,0,0,0,0,0,0,0,0,Monday
2022-05-09,Hong Kong-Zhuhai-Macao Bridge,157,11,7,175,139,22,0,161,Monday
2022-05-09,Lok Ma Chau,0,0,0,0,0,0,0,0,Monday
2022-05-09,Man Kam To,0,0,0,0,0,0,0,0,Monday
2022-05-09,Sha Tau Kok,0,0,0,0,0,0,0,0,Monday
2022-05-09,Shenzhen Bay,1984,227,2,2213,533,127,1,661,Monday
2022-05-09,China Ferry Terminal,0,0,0,0,0,0,0,0,Monday
2022-05-09,Harbour Control,0,0,0,0,0,0,0,0,Monday
2022-05-09,Kai Tak Cruise Terminal,0,0,0,0,0,0,0,0,Monday
2022-05-09,Macau Ferry Terminal,0,0,0,0,0,0,0,0,Monday
2022-05-09,Total,3792,265,86,4143,2112,165,29,2306,Monday
2022-05-10,Airport,1702,25,51,1778,1772,57,44,1873,Tuesday
2022-05-10,Express Rail Link West Kowloon,0,0,0,0,0,0,0,0,Tuesday
2022-05-10,Hung Hom,0,0,0,0,0,0,0,0,Tuesday
2022-05-10,Lo Wu,0,0,0,0,0,0,0,0,Tuesday
2022-05-10,Lok Ma Chau Spur Line,0,0,0,0,0,0,0,0,Tuesday
2022-05-10,Heung Yuen Wai,0,0,0,0,0,0,0,0,Tuesday
2022-05-10,Hong Kong-Zhuhai-Macao Bridge,100,13,15,128,158,16,2,176,Tuesday
2022-05-10,Lok Ma Chau,0,0,0,0,0,0,0,0,Tuesday
2022-05-10,Man Kam To,0,0,0,0,0,0,0,0,Tuesday
2022-05-10,Sha Tau Kok,0,0,0,0,0,0,0,0,Tuesday
2022-05-10,Shenzhen Bay,1174,169,7,1350,604,86,1,691,Tuesday
2022-05-10,China Ferry Terminal,0,0,0,0,0,0,0,0,Tuesday
2022-05-10,Harbour Control,0,0,0,0,0,0,0,0,Tuesday
2022-05-10,Kai Tak Cruise Terminal,0,0,0,0,0,0,0,0,Tuesday
2022-05-10,Macau Ferry Terminal,0,0,0,0,0,0,0,0,Tuesday
2022-05-10,Total,2976,207,73,3256,2534,159,47,2740,Tuesday
2022-05-11,Airport,1653,36,102,1791,1391,107,42,1540,Wednesday
2022-05-11,Express Rail Link West Kowloon,0,0,0,0,0,0,0,0,Wednesday
2022-05-11,Hung Hom,0,0,0,0,0,0,0,0,Wednesday
2022-05-11,Lo Wu,0,0,0,0,0,0,0,0,Wednesday
2022-05-11,Lok Ma Chau Spur Line,0,0,0,0,0,0,0,0,Wednesday
2022-05-11,Heung Yuen Wai,0,0,0,0,0,0,0,0,Wednesday
2022-05-11,Hong Kong-Zhuhai-Macao Bridge,67,18,14,99,73,1,3,77,Wednesday
2022-05-11,Lok Ma Chau,0,0,0,0,0,0,0,0,Wednesday
2022-05-11,Man Kam To,0,0,0,0,0,0,0,0,Wednesday
2022-05-11,Sha Tau Kok,0,0,0,0,0,0,0,0,Wednesday
2022-05-11,Shenzhen Bay,771,149,32,952,538,102,5,645,Wednesday
2022-05-11,China Ferry Terminal,0,0,0,0,0,0,0,0,Wednesday
2022-05-11,Harbour Control,0,0,0,0,0,0,0,0,Wednesday
2022-05-11,Kai Tak Cruise Terminal,0,0,0,0,0,0,0,0,Wednesday
2022-05-11,Macau Ferry Terminal,0,0,0,0,0,0,0,0,Wednesday
2022-05-11,Total,2491,203,148,2842,2002,210,50,2262,Wednesday
2022-05-12,Airport,1575,45,90,1710,2001,140,68,2209,Thursday
2022-05-12,Express Rail Link West Kowloon,0,0,0,0,0,0,0,0,Thursday
2022-05-12,Hung Hom,0,0,0,0,0,0,0,0,Thursday
2022-05-12,Lo Wu,0,0,0,0,0,0,0,0,Thursday
2022-05-12,Lok Ma Chau Spur Line,0,0,0,0,0,0,0,0,Thursday
2022-05-12,Heung Yuen Wai,0,0,0,0,0,0,0,0,Thursday
2022-05-12,Hong Kong-Zhuhai-Macao Bridge,63,8,15,86,24,0,8,32,Thursday
2022-05-12,Lok Ma Chau,0,0,0,0,0,0,0,0,Thursday
2022-05-12,Man Kam To,0,0,0,0,0,0,0,0,Thursday
2022-05-12,Sha Tau Kok,0,0,0,0,0,0,0,0,Thursday
2022-05-12,Shenzhen Bay,744,188,39,971,570,108,0,678,Thursday
2022-05-12,China Ferry Terminal,0,0,0,0,0,0,0,0,Thursday
2022-05-12,Harbour Control,0,0,0,0,0,0,0,0,Thursday
2022-05-12,Kai Tak Cruise Terminal,0,0,0,0,0,0,0,0,Thursday
2022-05-12,Macau Ferry Terminal,0,0,0,0,0,0,0,0,Thursday
2022-05-12,Total,2382,241,144,2767,2595,248,76,2919,Thursday
2022-05-13,Airport,1829,86,135,2050,1949,61,53,2063,Friday
2022-05-13,Express Rail Link West Kowloon,0,0,0,0,0,0,0,0,Friday
2022-05-13,Hung Hom,0,0,0,0,0,0,0,0,Friday
2022-05-13,Lo Wu,0,0,0,0,0,0,0,0,Friday
2022-05-13,Lok Ma Chau Spur Line,0,0,0,0,0,0,0,0,Friday
2022-05-13,Heung Yuen Wai,0,0,0,0,0,0,0,0,Friday
2022-05-13,Hong Kong-Zhuhai-Macao Bridge,56,5,15,76,30,0,2,32,Friday
2022-05-13,Lok Ma Chau,0,0,0,0,0,0,0,0,Friday
2022-05-13,Man Kam To,0,0,0,0,0,0,0,0,Friday
2022-05-13,Sha Tau Kok,0,0,0,0,0,0,0,0,Friday
2022-05-13,Shenzhen Bay,712,120,23,855,578,150,2,730,Friday
2022-05-13,China Ferry Terminal,0,0,0,0,0,0,0,0,Friday
2022-05-13,Harbour Control,0,0,0,0,0,0,0,0,Friday
2022-05-13,Kai Tak Cruise Terminal,0,0,0,0,0,0,0,0,Friday
2022-05-13,Macau Ferry Terminal,0,0,0,0,0,0,0,0,Friday
2022-05-13,Total,2597,211,173,2981,2557,211,57,2825,Friday
2022-05-14,Airport,1769,91,113,1973,2023,22,53,2098,Saturday
2022-05-14,Express Rail Link West Kowloon,0,0,0,0,0,0,0,0,Saturday
2022-05-14,Hung Hom,0,0,0,0,0,0,0,0,Saturday
2022-05-14,Lo Wu,0,0,0,0,0,0,0,0,Saturday
2022-05-14,Lok Ma Chau Spur Line,0,0,0,0,0,0,0,0,Saturday
2022-05-14,Heung Yuen Wai,0,0,0,0,0,0,0,0,Saturday
2022-05-14,Hong Kong-Zhuhai-Macao Bridge,101,11,18,130,150,23,6,179,Saturday
2022-05-14,Lok Ma Chau,0,0,0,0,0,0,0,0,Saturday
2022-05-14,Man Kam To,0,0,0,0,0,0,0,0,Saturday
2022-05-14,Sha Tau Kok,0,0,0,0,0,0,0,0,Saturday
2022-05-14,Shenzhen Bay,1261,189,4,1454,548,85,9,642,Saturday
2022-05-14,China Ferry Terminal,0,0,0,0,0,0,0,0,Saturday
2022-05-14,Harbour Control,0,0,0,0,0,0,0,0,Saturday
2022-05-14,Kai Tak Cruise Terminal,0,0,0,0,0,0,0,0,Saturday
2022-05-14,Macau Ferry Terminal,0,0,0,0,0,0,0,0,Saturday
2022-05-14,Total,3131,291,135,3557,2721,130,68,2919,Saturday
2022-05-15,Airport,3263,193,149,3605,2449,69,54,2572,Sunday
2022-05-15,Express Rail Link West Kowloon,0,0,0,0,0,0,0,0,Sunday
2022-05-15,Hung Hom,0,0,0,0,0,0,0,0,Sunday
2022-05-15,Lo Wu,0,0,0,0,0,0,0,0,Sunday
2022-05-15,Lok Ma Chau Spur Line,0,0,0,0,0,0,0,0,Sunday
2022-05-15,Heung Yuen Wai,0,0,0,0,0,0,0,0,Sunday
2022-05-15,Hong Kong-Zhuhai-Macao Bridge,140,13,9,162,144,21,2,167,Sunday
2022-05-15,Lok Ma Chau,0,0,0,0,0,0,0,0,Sunday
2022-05-15,Man Kam To,0,0,0,0,0,0,0,0,Sunday
2022-05-15,Sha Tau Kok,0,0,0,0,0,0,0,0,Sunday
2022-05-15,Shenzhen Bay,1648,217,5,1870,543,114,1,658,Sunday
2022-05-15,China Ferry Terminal,0,0,0,0,0,0,0,0,Sunday
2022-05-15,Harbour Control,0,0,0,0,0,0,0,0,Sunday
2022-05-15,Kai Tak Cruise Terminal,0,0,0,0,0,0,0,0,Sunday
2022-05-15,Macau Ferry Terminal,0,0,0,0,0,0,0,0,Sunday
2022-05-15,Total,5051,423,163,5637,3136,204,57,3397,Sunday
2022-05-16,Airport,1993,185,123,2301,2325,34,48,2407,Monday
2022-05-16,Express Rail Link West Kowloon,0,0,0,0,0,0,0,0,Monday
2022-05-16,Hung Hom,0,0,0,0,0,0,0,0,Monday
2022-05-16,Lo Wu,0,0,0,0,0,0,0,0,Monday
2022-05-16,Lok Ma Chau Spur Line,0,0,0,0,0,0,0,0,Monday
2022-05-16,Heung Yuen Wai,0,0,0,0,0,0,0,0,Monday
2022-05-16,Hong Kong-Zhuhai-Macao Bridge,70,13,10,93,148,18,2,168,Monday
2022-05-16,Lok Ma Chau,0,0,0,0,0,0,0,0,Monday
2022-05-16,Man Kam To,0,0,0,0,0,0,0,0,Monday
2022-05-16,Sha Tau Kok,0,0,0,0,0,0,0,0,Monday
2022-05-16,Shenzhen Bay,873,111,8,992,584,112,4,700,Monday
2022-05-16,China Ferry Terminal,0,0,0,0,0,0,0,0,Monday
2022-05-16,Harbour Control,0,0,0,0,0,0,0,0,Monday
2022-05-16,Kai Tak Cruise Terminal,0,0,0,0,0,0,0,0,Monday
2022-05-16,Macau Ferry Terminal,0,0,0,0,0,0,0,0,Monday
2022-05-16,Total,2936,309,141,3386,3057,164,54,3275,Monday
2022-05-17,Airport,1555,212,75,1842,1201,39,32,1272,Tuesday
2022-05-17,Express Rail Link West Kowloon,0,0,0,0,0,0,0,0,Tuesday
2022-05-17,Hung Hom,0,0,0,0,0,0,0,0,Tuesday
2022-05-17,Lo Wu,0,0,0,0,0,0,0,0,Tuesday
2022-05-17,Lok Ma Chau Spur Line,0,0,0,0,0,0,0,0,Tuesday
2022-05-17,Heung Yuen Wai,0,0,0,0,0,0,0,0,Tuesday
2022-05-17,Hong Kong-Zhuhai-Macao Bridge,76,10,13,99,147,13,6,166,Tuesday
2022-05-17,Lok Ma Chau,0,0,0,0,0,0,0,0,Tuesday
2022-05-17,Man Kam To,0,0,0,0,0,0,0,0,Tuesday
2022-05-17,Sha Tau Kok,0,0,0,0,0,0,0,0,Tuesday
2022-05-17,Shenzhen Bay,1029,154,6,1189,598,96,6,700,Tuesday
2022-05-17,China Ferry Terminal,0,0,0,0,0,0,0,0,Tuesday
2022-05-17,Harbour Control,0,0,0,0,0,0,0,0,Tuesday
2022-05-17,Kai Tak Cruise Terminal,0,0,0,0,0,0,0,0,Tuesday
2022-05-17,Macau Ferry Terminal,0,0,0,0,0,0,0,0,Tuesday
2022-05-17,Total,2660,376,94,3130,1946,148,44,2138,Tuesday
2022-05-18,Airport,1663,354,104,2121,1723,38,66,1827,Wednesday
2022-05-18,Express Rail Link West Kowloon,0,0,0,0,0,0,0,0,Wednesday
2022-05-18,Hung Hom,0,0,0,0,0,0,0,0,Wednesday
2022-05-18,Lo Wu,0,0,0,0,0,0,0,0,Wednesday
2022-05-18,Lok Ma Chau Spur Line,0,0,0,0,0,0,0,0,Wednesday
2022-05-18,Heung Yuen Wai,0,0,0,0,0,0,0,0,Wednesday
2022-05-18,Hong Kong-Zhuhai-Macao Bridge,84,14,11,109,159,14,2,175,Wednesday
2022-05-18,Lok Ma Chau,0,0,0,0,0,0,0,0,Wednesday
2022-05-18,Man Kam To,0,0,0,0,0,0,0,0,Wednesday
2022-05-18,Sha Tau Kok,0,0,0,0,0,0,0,0,Wednesday
2022-05-18,Shenzhen Bay,911,131,3,1045,600,91,6,697,Wednesday
2022-05-18,China Ferry Terminal,0,0,0,0,0,0,0,0,Wednesday
2022-05-18,Harbour Control,0,0,0,0,0,0,0,0,Wednesday
2022-05-18,Kai Tak Cruise Terminal,0,0,0,0,0,0,0,0,Wednesday
2022-05-18,Macau Ferry Terminal,0,0,0,0,0,0,0,0,Wednesday
2022-05-18,Total,2658,499,118,3275,2482,143,74,2699,Wednesday
2022-05-19,Airport,2154,623,141,2918,1784,60,57,1901,Thursday
2022-05-19,Express Rail Link West Kowloon,0,0,0,0,0,0,0,0,Thursday
2022-05-19,Hung Hom,0,0,0,0,0,0,0,0,Thursday
2022-05-19,Lo Wu,0,0,0,0,0,0,0,0,Thursday
2022-05-19,Lok Ma Chau Spur Line,0,0,0,0,0,0,0,0,Thursday
2022-05-19,Heung Yuen Wai,0,0,0,0,0,0,0,0,Thursday
2022-05-19,Hong Kong-Zhuhai-Macao Bridge,83,1,16,100,160,28,2,190,Thursday
2022-05-19,Lok Ma Chau,0,0,0,0,0,0,0,0,Thursday
2022-05-19,Man Kam To,0,0,0,0,0,0,0,0,Thursday
2022-05-19,Sha Tau Kok,0,0,0,0,0,0,0,0,Thursday
2022-05-19,Shenzhen Bay,747,107,5,859,563,92,5,660,Thursday
2022-05-19,China Ferry Terminal,0,0,0,0,0,0,0,0,Thursday
2022-05-19,Harbour Control,0,0,0,0,0,0,0,0,Thursday
2022-05-19,Kai Tak Cruise Terminal,0,0,0,0,0,0,0,0,Thursday
2022-05-19,Macau Ferry Terminal,0,0,0,0,0,0,0,0,Thursday
2022-05-19,Total,2984,731,162,3877,2507,180,64,2751,Thursday
2022-05-20,Airport,1767,430,126,2323,2160,126,52,2338,Friday
2022-05-20,Express Rail Link West Kowloon,0,0,0,0,0,0,0,0,Friday
2022-05-20,Hung Hom,0,0,0,0,0,0,0,0,Friday
2022-05-20,Lo Wu,0,0,0,0,0,0,0,0,Friday
2022-05-20,Lok Ma Chau Spur Line,0,0,0,0,0,0,0,0,Friday
2022-05-20,Heung Yuen Wai,0,0,0,0,0,0,0,0,Friday
2022-05-20,Hong Kong-Zhuhai-Macao Bridge,94,10,11,115,173,17,4,194,Friday
2022-05-20,Lok Ma Chau,0,0,0,0,0,0,0,0,Friday
2022-05-20,Man Kam To,0,0,0,0,0,0,0,0,Friday
2022-05-20,Sha Tau Kok,0,0,0,0,0,0,0,0,Friday
2022-05-20,Shenzhen Bay,967,169,10,1146,591,113,6,710,Friday
2022-05-20,China Ferry Terminal,0,0,0,0,0,0,0,0,Friday
2022-05-20,Harbour Control,0,0,0,0,0,0,0,0,Friday
2022-05-20,Kai Tak Cruise Terminal,0,0,0,0,0,0,0,0,Friday
2022-05-20,Macau Ferry Terminal,0,0,0,0,0,0,0,0,Friday
2022-05-20,Total,2828,609,147,3584,2924,256,62,3242,Friday
2022-05-21,Airport,1784,368,103,2255,2018,12,46,2076,Saturday
2022-05-21,Express Rail Link West Kowloon,0,0,0,0,0,0,0,0,Saturday
2022-05-21,Hung Hom,0,0,0,0,0,0,0,0,Saturday
2022-05-21,Lo Wu,0,0,0,0,0,0,0,0,Saturday
2022-05-21,Lok Ma Chau Spur Line,0,0,0,0,0,0,0,0,Saturday
2022-05-21,Heung Yuen Wai,0,0,0,0,0,0,0,0,Saturday
2022-05-21,Hong Kong-Zhuhai-Macao Bridge,73,3,13,89,141,28,4,173,Saturday
2022-05-21,Lok Ma Chau,0,0,0,0,0,0,0,0,Saturday
2022-05-21,Man Kam To,0,0,0,0,0,0,0,0,Saturday
2022-05-21,Sha Tau Kok,0,0,0,0,0,0,0,0,Saturday
2022-05-21,Shenzhen Bay,1055,163,12,1230,618,140,9,767,Saturday
2022-05-21,China Ferry Terminal,0,0,0,0,0,0,0,0,Saturday
2022-05-21,Harbour Control,0,0,0,0,0,0,0,0,Saturday
2022-05-21,Kai Tak Cruise Terminal,0,0,0,0,0,0,0,0,Saturday
2022-05-21,Macau Ferry Terminal,0,0,0,0,0,0,0,0,Saturday
2022-05-21,Total,2912,534,128,3574,2777,180,59,3016,Saturday
2022-05-22,Airport,2652,476,130,3258,2587,104,76,2767,Sunday
2022-05-22,Express Rail Link West Kowloon,0,0,0,0,0,0,0,0,Sunday
2022-05-22,Hung Hom,0,0,0,0,0,0,0,0,Sunday
2022-05-22,Lo Wu,0,0,0,0,0,0,0,0,Sunday
2022-05-22,Lok Ma Chau Spur Line,0,0,0,0,0,0,0,0,Sunday
2022-05-22,Heung Yuen Wai,0,0,0,0,0,0,0,0,Sunday
2022-05-22,Hong Kong-Zhuhai-Macao Bridge,100,8,13,121,139,22,0,161,Sunday
2022-05-22,Lok Ma Chau,0,0,0,0,0,0,0,0,Sunday
2022-05-22,Man Kam To,0,0,0,0,0,0,0,0,Sunday
2022-05-22,Sha Tau Kok,0,0,0,0,0,0,0,0,Sunday
2022-05-22,Shenzhen Bay,1192,162,6,1360,481,162,7,650,Sunday
2022-05-22,China Ferry Terminal,0,0,0,0,0,0,0,0,Sunday
2022-05-22,Harbour Control,0,0,0,0,0,0,0,0,Sunday
2022-05-22,Kai Tak Cruise Terminal,0,0,0,0,0,0,0,0,Sunday
2022-05-22,Macau Ferry Terminal,0,0,0,0,0,0,0,0,Sunday
2022-05-22,Total,3944,646,149,4739,3207,288,83,3578,Sunday
2022-05-23,Airport,1866,495,150,2511,1712,138,46,1896,Monday
2022-05-23,Express Rail Link West Kowloon,0,0,0,0,0,0,0,0,Monday
2022-05-23,Hung Hom,0,0,0,0,0,0,0,0,Monday
2022-05-23,Lo Wu,0,0,0,0,0,0,0,0,Monday
2022-05-23,Lok Ma Chau Spur Line,0,0,0,0,0,0,0,0,Monday
2022-05-23,Heung Yuen Wai,0,0,0,0,0,0,0,0,Monday
2022-05-23,Hong Kong-Zhuhai-Macao Bridge,87,6,13,106,134,21,2,157,Monday
2022-05-23,Lok Ma Chau,0,0,0,0,0,0,0,0,Monday
2022-05-23,Man Kam To,0,0,0,0,0,0,0,0,Monday
2022-05-23,Sha Tau Kok,0,0,0,0,0,0,0,0,Monday
2022-05-23,Shenzhen Bay,833,99,6,938,539,115,7,661,Monday
2022-05-23,China Ferry Terminal,0,0,0,0,0,0,0,0,Monday
2022-05-23,Harbour Control,0,0,0,0,0,0,0,0,Monday
2022-05-23,Kai Tak Cruise Terminal,0,0,0,0,0,0,0,0,Monday
2022-05-23,Macau Ferry Terminal,0,0,0,0,0,0,0,0,Monday
2022-05-23,Total,2786,600,169,3555,2385,274,55,2714,Monday
2022-05-24,Airport,1488,364,63,1915,1631,138,45,1814,Tuesday
2022-05-24,Express Rail Link West Kowloon,0,0,0,0,0,0,0,0,Tuesday
2022-05-24,Hung Hom,0,0,0,0,0,0,0,0,Tuesday
2022-05-24,Lo Wu,0,0,0,0,0,0,0,0,Tuesday
2022-05-24,Lok Ma Chau Spur Line,0,0,0,0,0,0,0,0,Tuesday
2022-05-24,Heung Yuen Wai,0,0,0,0,0,0,0,0,Tuesday
2022-06-10,Total,3493,1371,207,5071,3409,1014,114,4537,Friday
2022-05-24,Hong Kong-Zhuhai-Macao Bridge,72,5,9,86,137,26,4,167,Tuesday
2022-05-24,Lok Ma Chau,0,0,0,0,0,0,0,0,Tuesday
2022-05-24,Man Kam To,0,0,0,0,0,0,0,0,Tuesday
2022-05-24,Sha Tau Kok,0,0,0,0,0,0,0,0,Tuesday
2022-05-24,Shenzhen Bay,706,95,6,807,547,143,7,697,Tuesday
2022-05-24,China Ferry Terminal,0,0,0,0,0,0,0,0,Tuesday
2022-05-24,Harbour Control,0,0,0,0,0,0,0,0,Tuesday
2022-05-24,Kai Tak Cruise Terminal,0,0,0,0,0,0,0,0,Tuesday
2022-05-24,Macau Ferry Terminal,0,0,0,0,0,0,0,0,Tuesday
2022-05-24,Total,2266,464,78,2808,2315,307,56,2678,Tuesday
2022-05-25,Airport,1817,971,131,2919,1566,198,62,1826,Wednesday
2022-05-25,Express Rail Link West Kowloon,0,0,0,0,0,0,0,0,Wednesday
2022-05-25,Hung Hom,0,0,0,0,0,0,0,0,Wednesday
2022-05-25,Lo Wu,0,0,0,0,0,0,0,0,Wednesday
2022-05-25,Lok Ma Chau Spur Line,0,0,0,0,0,0,0,0,Wednesday
2022-05-25,Heung Yuen Wai,0,0,0,0,0,0,0,0,Wednesday
2022-05-25,Hong Kong-Zhuhai-Macao Bridge,82,3,7,92,141,17,3,161,Wednesday
2022-05-25,Lok Ma Chau,0,0,0,0,0,0,0,0,Wednesday
2022-05-25,Man Kam To,0,0,0,0,0,0,0,0,Wednesday
2022-05-25,Sha Tau Kok,0,0,0,0,0,0,0,0,Wednesday
2022-05-25,Shenzhen Bay,806,100,5,911,538,233,8,779,Wednesday
2022-05-25,China Ferry Terminal,0,0,0,0,0,0,0,0,Wednesday
2022-05-25,Harbour Control,0,0,0,0,0,0,0,0,Wednesday
2022-05-25,Kai Tak Cruise Terminal,0,0,0,0,0,0,0,0,Wednesday
2022-05-25,Macau Ferry Terminal,0,0,0,0,0,0,0,0,Wednesday
2022-05-25,Total,2705,1074,143,3922,2245,448,73,2766,Wednesday
2022-05-26,Airport,1931,470,168,2569,2170,269,87,2526,Thursday
2022-05-26,Express Rail Link West Kowloon,0,0,0,0,0,0,0,0,Thursday
2022-05-26,Hung Hom,0,0,0,0,0,0,0,0,Thursday
2022-05-26,Lo Wu,0,0,0,0,0,0,0,0,Thursday
2022-05-26,Lok Ma Chau Spur Line,0,0,0,0,0,0,0,0,Thursday
2022-05-26,Heung Yuen Wai,0,0,0,0,0,0,0,0,Thursday
2022-05-26,Hong Kong-Zhuhai-Macao Bridge,75,4,10,89,129,63,1,193,Thursday
2022-05-26,Lok Ma Chau,0,0,0,0,0,0,0,0,Thursday
2022-05-26,Man Kam To,0,0,0,0,0,0,0,0,Thursday
2022-05-26,Sha Tau Kok,0,0,0,0,0,0,0,0,Thursday
2022-05-26,Shenzhen Bay,799,100,4,903,429,288,9,726,Thursday
2022-05-26,China Ferry Terminal,0,0,0,0,0,0,0,0,Thursday
2022-05-26,Harbour Control,0,0,0,0,0,0,0,0,Thursday
2022-05-26,Kai Tak Cruise Terminal,0,0,0,0,0,0,0,0,Thursday
2022-05-26,Macau Ferry Terminal,0,0,0,0,0,0,0,0,Thursday
2022-05-26,Total,2805,574,182,3561,2728,620,97,3445,Thursday
2022-05-27,Airport,1953,739,139,2831,2125,233,77,2435,Friday
2022-05-27,Express Rail Link West Kowloon,0,0,0,0,0,0,0,0,Friday
2022-05-27,Hung Hom,0,0,0,0,0,0,0,0,Friday
2022-05-27,Lo Wu,0,0,0,0,0,0,0,0,Friday
2022-05-27,Lok Ma Chau Spur Line,0,0,0,0,0,0,0,0,Friday
2022-05-27,Heung Yuen Wai,0,0,0,0,0,0,0,0,Friday
2022-05-27,Hong Kong-Zhuhai-Macao Bridge,91,10,7,108,155,28,4,187,Friday
2022-05-27,Lok Ma Chau,0,0,0,0,0,0,0,0,Friday
2022-05-27,Man Kam To,0,0,0,0,0,0,0,0,Friday
2022-05-27,Sha Tau Kok,0,0,0,0,0,0,0,0,Friday
2022-05-27,Shenzhen Bay,780,114,9,903,428,303,12,743,Friday
2022-05-27,China Ferry Terminal,0,0,0,0,0,0,0,0,Friday
2022-05-27,Harbour Control,0,0,0,0,0,0,0,0,Friday
2022-05-27,Kai Tak Cruise Terminal,0,0,0,0,0,0,0,0,Friday
2022-05-27,Macau Ferry Terminal,0,0,0,0,0,0,0,0,Friday
2022-05-27,Total,2824,863,155,3842,2708,564,93,3365,Friday
2022-05-28,Airport,1662,432,113,2207,2304,49,82,2435,Saturday
2022-05-28,Express Rail Link West Kowloon,0,0,0,0,0,0,0,0,Saturday
2022-05-28,Hung Hom,0,0,0,0,0,0,0,0,Saturday
2022-05-28,Lo Wu,0,0,0,0,0,0,0,0,Saturday
2022-05-28,Lok Ma Chau Spur Line,0,0,0,0,0,0,0,0,Saturday
2022-05-28,Heung Yuen Wai,0,0,0,0,0,0,0,0,Saturday
2022-05-28,Hong Kong-Zhuhai-Macao Bridge,103,12,23,138,151,26,4,181,Saturday
2022-05-28,Lok Ma Chau,0,0,0,0,0,0,0,0,Saturday
2022-05-28,Man Kam To,0,0,0,0,0,0,0,0,Saturday
2022-05-28,Sha Tau Kok,0,0,0,0,0,0,0,0,Saturday
2022-05-28,Shenzhen Bay,1104,151,5,1260,533,268,11,812,Saturday
2022-05-28,China Ferry Terminal,0,0,0,0,0,0,0,0,Saturday
2022-05-28,Harbour Control,0,0,0,0,0,0,0,0,Saturday
2022-05-28,Kai Tak Cruise Terminal,0,0,0,0,0,0,0,0,Saturday
2022-05-28,Macau Ferry Terminal,0,0,0,0,0,0,0,0,Saturday
2022-05-28,Total,2869,595,141,3605,2988,343,97,3428,Saturday
2022-05-29,Airport,2863,1056,238,4157,2595,194,71,2860,Sunday
2022-05-29,Express Rail Link West Kowloon,0,0,0,0,0,0,0,0,Sunday
2022-05-29,Hung Hom,0,0,0,0,0,0,0,0,Sunday
2022-05-29,Lo Wu,0,0,0,0,0,0,0,0,Sunday
2022-05-29,Lok Ma Chau Spur Line,0,0,0,0,0,0,0,0,Sunday
2022-05-29,Heung Yuen Wai,0,0,0,0,0,0,0,0,Sunday
2022-05-29,Hong Kong-Zhuhai-Macao Bridge,125,7,20,152,99,60,7,166,Sunday
2022-05-29,Lok Ma Chau,0,0,0,0,0,0,0,0,Sunday
2022-05-29,Man Kam To,0,0,0,0,0,0,0,0,Sunday
2022-05-29,Sha Tau Kok,0,0,0,0,0,0,0,0,Sunday
2022-05-29,Shenzhen Bay,1337,219,10,1566,435,390,13,838,Sunday
2022-05-29,China Ferry Terminal,0,0,0,0,0,0,0,0,Sunday
2022-05-29,Harbour Control,0,0,0,0,0,0,0,0,Sunday
2022-05-29,Kai Tak Cruise Terminal,0,0,0,0,0,0,0,0,Sunday
2022-05-29,Macau Ferry Terminal,0,0,0,0,0,0,0,0,Sunday
2022-05-29,Total,4325,1282,268,5875,3129,644,91,3864,Sunday
2022-05-30,Airport,1348,540,64,1952,1992,304,94,2390,Monday
2022-05-30,Express Rail Link West Kowloon,0,0,0,0,0,0,0,0,Monday
2022-05-30,Hung Hom,0,0,0,0,0,0,0,0,Monday
2022-05-30,Lo Wu,0,0,0,0,0,0,0,0,Monday
2022-05-30,Lok Ma Chau Spur Line,0,0,0,0,0,0,0,0,Monday
2022-05-30,Heung Yuen Wai,0,0,0,0,0,0,0,0,Monday
2022-05-30,Hong Kong-Zhuhai-Macao Bridge,73,4,7,84,107,37,5,149,Monday
2022-05-30,Lok Ma Chau,0,0,0,0,0,0,0,0,Monday
2022-05-30,Man Kam To,0,0,0,0,0,0,0,0,Monday
2022-05-30,Sha Tau Kok,0,0,0,0,0,0,0,0,Monday
2022-05-30,Shenzhen Bay,802,106,8,916,463,289,16,768,Monday
2022-05-30,China Ferry Terminal,0,0,0,0,0,0,0,0,Monday
2022-05-30,Harbour Control,0,0,0,0,0,0,0,0,Monday
2022-05-30,Kai Tak Cruise Terminal,0,0,0,0,0,0,0,0,Monday
2022-05-30,Macau Ferry Terminal,0,0,0,0,0,0,0,0,Monday
2022-05-30,Total,2223,650,79,2952,2562,630,115,3307,Monday
2022-05-31,Airport,1559,477,62,2098,2228,181,98,2507,Tuesday
2022-05-31,Express Rail Link West Kowloon,0,0,0,0,0,0,0,0,Tuesday
2022-05-31,Hung Hom,0,0,0,0,0,0,0,0,Tuesday
2022-05-31,Lo Wu,0,0,0,0,0,0,0,0,Tuesday
2022-05-31,Lok Ma Chau Spur Line,0,0,0,0,0,0,0,0,Tuesday
2022-05-31,Heung Yuen Wai,0,0,0,0,0,0,0,0,Tuesday
2022-05-31,Hong Kong-Zhuhai-Macao Bridge,92,9,27,128,133,39,4,176,Tuesday
2022-05-31,Lok Ma Chau,0,0,0,0,0,0,0,0,Tuesday
2022-05-31,Man Kam To,0,0,0,0,0,0,0,0,Tuesday
2022-05-31,Sha Tau Kok,0,0,0,0,0,0,0,0,Tuesday
2022-05-31,Shenzhen Bay,835,114,3,952,459,255,8,722,Tuesday
2022-05-31,China Ferry Terminal,0,0,0,0,0,0,0,0,Tuesday
2022-05-31,Harbour Control,0,0,0,0,0,0,0,0,Tuesday
2022-05-31,Kai Tak Cruise Terminal,0,0,0,0,0,0,0,0,Tuesday
2022-05-31,Macau Ferry Terminal,0,0,0,0,0,0,0,0,Tuesday
2022-05-31,Total,2486,600,92,3178,2820,475,110,3405,Tuesday
2022-06-01,Airport,2590,1048,163,3801,2433,338,102,2873,Wednesday
2022-06-01,Express Rail Link West Kowloon,0,0,0,0,0,0,0,0,Wednesday
2022-06-01,Hung Hom,0,0,0,0,0,0,0,0,Wednesday
2022-06-01,Lo Wu,0,0,0,0,0,0,0,0,Wednesday
2022-06-01,Lok Ma Chau Spur Line,0,0,0,0,0,0,0,0,Wednesday
2022-06-01,Heung Yuen Wai,0,0,0,0,0,0,0,0,Wednesday
2022-06-01,Hong Kong-Zhuhai-Macao Bridge,84,3,17,104,134,108,2,244,Wednesday
2022-06-01,Lok Ma Chau,0,0,0,0,0,0,0,0,Wednesday
2022-06-01,Man Kam To,0,0,0,0,0,0,0,0,Wednesday
2022-06-01,Sha Tau Kok,0,0,0,0,0,0,0,0,Wednesday
2022-06-01,Shenzhen Bay,682,99,6,787,475,387,8,870,Wednesday
2022-06-01,China Ferry Terminal,0,0,0,0,0,0,0,0,Wednesday
2022-06-01,Harbour Control,0,0,0,0,0,0,0,0,Wednesday
2022-06-01,Kai Tak Cruise Terminal,0,0,0,0,0,0,0,0,Wednesday
2022-06-01,Macau Ferry Terminal,0,0,0,0,0,0,0,0,Wednesday
2022-06-01,Total,3356,1150,186,4692,3042,833,112,3987,Wednesday
2022-06-02,Airport,2205,825,144,3174,2755,239,88,3082,Thursday
2022-06-02,Express Rail Link West Kowloon,0,0,0,0,0,0,0,0,Thursday
2022-06-02,Hung Hom,0,0,0,0,0,0,0,0,Thursday
2022-06-02,Lo Wu,0,0,0,0,0,0,0,0,Thursday
2022-06-02,Lok Ma Chau Spur Line,0,0,0,0,0,0,0,0,Thursday
2022-06-02,Heung Yuen Wai,0,0,0,0,0,0,0,0,Thursday
2022-06-02,Hong Kong-Zhuhai-Macao Bridge,76,6,18,100,132,53,7,192,Thursday
2022-06-02,Lok Ma Chau,0,0,0,0,0,0,0,0,Thursday
2022-06-02,Man Kam To,0,0,0,0,0,0,0,0,Thursday
2022-06-02,Sha Tau Kok,0,0,0,0,0,0,0,0,Thursday
2022-06-02,Shenzhen Bay,638,95,7,740,435,335,5,775,Thursday
2022-06-02,China Ferry Terminal,0,0,0,0,0,0,0,0,Thursday
2022-06-02,Harbour Control,0,0,0,0,0,0,0,0,Thursday
2022-06-02,Kai Tak Cruise Terminal,0,0,0,0,0,0,0,0,Thursday
2022-06-02,Macau Ferry Terminal,0,0,0,0,0,0,0,0,Thursday
2022-06-02,Total,2919,926,169,4014,3322,627,100,4049,Thursday
2022-06-03,Airport,2098,967,161,3226,2589,201,97,2887,Friday
2022-06-03,Express Rail Link West Kowloon,0,0,0,0,0,0,0,0,Friday
2022-06-03,Hung Hom,0,0,0,0,0,0,0,0,Friday
2022-06-03,Lo Wu,0,0,0,0,0,0,0,0,Friday
2022-06-03,Lok Ma Chau Spur Line,0,0,0,0,0,0,0,0,Friday
2022-06-03,Heung Yuen Wai,0,0,0,0,0,0,0,0,Friday
2022-06-03,Hong Kong-Zhuhai-Macao Bridge,66,7,17,90,118,110,2,230,Friday
2022-06-03,Lok Ma Chau,0,0,0,0,0,0,0,0,Friday
2022-06-03,Man Kam To,0,0,0,0,0,0,0,0,Friday
2022-06-03,Sha Tau Kok,0,0,0,0,0,0,0,0,Friday
2022-06-03,Shenzhen Bay,545,103,2,650,425,307,14,746,Friday
2022-06-03,China Ferry Terminal,0,0,0,0,0,0,0,0,Friday
2022-06-03,Harbour Control,0,0,0,0,0,0,0,0,Friday
2022-06-03,Kai Tak Cruise Terminal,0,0,0,0,0,0,0,0,Friday
2022-06-03,Macau Ferry Terminal,0,0,0,0,0,0,0,0,Friday
2022-06-03,Total,2709,1077,180,3966,3132,618,113,3863,Friday
2022-06-04,Airport,2070,526,149,2745,2205,17,94,2316,Saturday
2022-06-04,Express Rail Link West Kowloon,0,0,0,0,0,0,0,0,Saturday
2022-06-04,Hung Hom,0,0,0,0,0,0,0,0,Saturday
2022-06-04,Lo Wu,0,0,0,0,0,0,0,0,Saturday
2022-06-04,Lok Ma Chau Spur Line,0,0,0,0,0,0,0,0,Saturday
2022-06-04,Heung Yuen Wai,0,0,0,0,0,0,0,0,Saturday
2022-06-04,Hong Kong-Zhuhai-Macao Bridge,79,7,18,104,136,54,5,195,Saturday
2022-06-04,Lok Ma Chau,0,0,0,0,0,0,0,0,Saturday
2022-06-04,Man Kam To,0,0,0,0,0,0,0,0,Saturday
2022-06-04,Sha Tau Kok,0,0,0,0,0,0,0,0,Saturday
2022-06-04,Shenzhen Bay,1006,203,5,1214,531,417,9,957,Saturday
2022-06-04,China Ferry Terminal,0,0,0,0,0,0,0,0,Saturday
2022-06-04,Harbour Control,0,0,0,0,0,0,0,0,Saturday
2022-06-04,Kai Tak Cruise Terminal,0,0,0,0,0,0,0,0,Saturday
2022-06-04,Macau Ferry Terminal,0,0,0,0,0,0,0,0,Saturday
2022-06-04,Total,3155,736,172,4063,2872,488,108,3468,Saturday
2022-06-05,Airport,2753,1189,188,4130,3442,328,113,3883,Sunday
2022-06-11,Airport,2988,854,184,4026,2800,26,99,2925,Saturday
2022-06-05,Express Rail Link West Kowloon,0,0,0,0,0,0,0,0,Sunday
2022-06-05,Hung Hom,0,0,0,0,0,0,0,0,Sunday
2022-06-05,Lo Wu,0,0,0,0,0,0,0,0,Sunday
2022-06-05,Lok Ma Chau Spur Line,0,0,0,0,0,0,0,0,Sunday
2022-06-05,Heung Yuen Wai,0,0,0,0,0,0,0,0,Sunday
2022-06-05,Hong Kong-Zhuhai-Macao Bridge,134,8,29,171,126,88,5,219,Sunday
2022-06-05,Lok Ma Chau,0,0,0,0,0,0,0,0,Sunday
2022-06-05,Man Kam To,0,0,0,0,0,0,0,0,Sunday
2022-06-05,Sha Tau Kok,0,0,0,0,0,0,0,0,Sunday
2022-06-05,Shenzhen Bay,1533,248,8,1789,316,479,23,818,Sunday
2022-06-05,China Ferry Terminal,0,0,0,0,0,0,0,0,Sunday
2022-06-05,Harbour Control,0,0,0,0,0,0,0,0,Sunday
2022-06-05,Kai Tak Cruise Terminal,0,0,0,0,0,0,0,0,Sunday
2022-06-05,Macau Ferry Terminal,0,0,0,0,0,0,0,0,Sunday
2022-06-05,Total,4420,1445,225,6090,3884,895,141,4920,Sunday
2022-06-06,Airport,1611,936,134,2681,1696,270,60,2026,Monday
2022-06-06,Express Rail Link West Kowloon,0,0,0,0,0,0,0,0,Monday
2022-06-06,Hung Hom,0,0,0,0,0,0,0,0,Monday
2022-06-06,Lo Wu,0,0,0,0,0,0,0,0,Monday
2022-06-06,Lok Ma Chau Spur Line,0,0,0,0,0,0,0,0,Monday
2022-06-06,Heung Yuen Wai,0,0,0,0,0,0,0,0,Monday
2022-06-06,Hong Kong-Zhuhai-Macao Bridge,67,8,12,87,130,59,13,202,Monday
2022-06-06,Lok Ma Chau,0,0,0,0,0,0,0,0,Monday
2022-06-06,Man Kam To,0,0,0,0,0,0,0,0,Monday
2022-06-06,Sha Tau Kok,0,0,0,0,0,0,0,0,Monday
2022-06-06,Shenzhen Bay,1024,106,4,1134,481,435,18,934,Monday
2022-06-06,China Ferry Terminal,0,0,0,0,0,0,0,0,Monday
2022-06-06,Harbour Control,0,0,0,0,0,0,0,0,Monday
2022-06-06,Kai Tak Cruise Terminal,0,0,0,0,0,0,0,0,Monday
2022-06-06,Macau Ferry Terminal,0,0,0,0,0,0,0,0,Monday
2022-06-06,Total,2702,1050,150,3902,2307,764,91,3162,Monday
2022-06-07,Airport,1528,630,86,2244,2378,229,86,2693,Tuesday
2022-06-07,Express Rail Link West Kowloon,0,0,0,0,0,0,0,0,Tuesday
2022-06-07,Hung Hom,0,0,0,0,0,0,0,0,Tuesday
2022-06-07,Lo Wu,0,0,0,0,0,0,0,0,Tuesday
2022-06-07,Lok Ma Chau Spur Line,0,0,0,0,0,0,0,0,Tuesday
2022-06-07,Heung Yuen Wai,0,0,0,0,0,0,0,0,Tuesday
2022-06-07,Hong Kong-Zhuhai-Macao Bridge,77,11,18,106,136,59,5,200,Tuesday
2022-06-07,Lok Ma Chau,0,0,0,0,0,0,0,0,Tuesday
2022-06-07,Man Kam To,0,0,0,0,0,0,0,0,Tuesday
2022-06-07,Sha Tau Kok,0,0,0,0,0,0,0,0,Tuesday
2022-06-07,Shenzhen Bay,793,114,6,913,478,489,14,981,Tuesday
2022-06-07,China Ferry Terminal,0,0,0,0,0,0,0,0,Tuesday
2022-06-07,Harbour Control,0,0,0,0,0,0,0,0,Tuesday
2022-06-07,Kai Tak Cruise Terminal,0,0,0,0,0,0,0,0,Tuesday
2022-06-07,Macau Ferry Terminal,0,0,0,0,0,0,0,0,Tuesday
2022-06-07,Total,2398,755,110,3263,2992,777,105,3874,Tuesday
2022-06-08,Airport,2563,1087,142,3792,2875,352,110,3337,Wednesday
2022-06-08,Express Rail Link West Kowloon,0,0,0,0,0,0,0,0,Wednesday
2022-06-08,Hung Hom,0,0,0,0,0,0,0,0,Wednesday
2022-06-08,Lo Wu,0,0,0,0,0,0,0,0,Wednesday
2022-06-08,Lok Ma Chau Spur Line,0,0,0,0,0,0,0,0,Wednesday
2022-06-08,Heung Yuen Wai,0,0,0,0,0,0,0,0,Wednesday
2022-06-08,Hong Kong-Zhuhai-Macao Bridge,81,8,15,104,128,94,4,226,Wednesday
2022-06-08,Lok Ma Chau,0,0,0,0,0,0,0,0,Wednesday
2022-06-08,Man Kam To,0,0,0,0,0,0,0,0,Wednesday
2022-06-08,Sha Tau Kok,0,0,0,0,0,0,0,0,Wednesday
2022-06-08,Shenzhen Bay,940,109,8,1057,536,458,9,1003,Wednesday
2022-06-08,China Ferry Terminal,0,0,0,0,0,0,0,0,Wednesday
2022-06-08,Harbour Control,0,0,0,0,0,0,0,0,Wednesday
2022-06-08,Kai Tak Cruise Terminal,0,0,0,0,0,0,0,0,Wednesday
2022-06-08,Macau Ferry Terminal,0,0,0,0,0,0,0,0,Wednesday
2022-06-08,Total,3584,1204,165,4953,3539,904,123,4566,Wednesday
2022-06-09,Airport,1578,726,152,2456,2447,377,107,2931,Thursday
2022-06-09,Express Rail Link West Kowloon,0,0,0,0,0,0,0,0,Thursday
2022-06-09,Hung Hom,0,0,0,0,0,0,0,0,Thursday
2022-06-09,Lo Wu,0,0,0,0,0,0,0,0,Thursday
2022-06-09,Lok Ma Chau Spur Line,0,0,0,0,0,0,0,0,Thursday
2022-06-09,Heung Yuen Wai,0,0,0,0,0,0,0,0,Thursday
2022-06-09,Hong Kong-Zhuhai-Macao Bridge,63,4,15,82,152,59,3,214,Thursday
2022-06-09,Lok Ma Chau,0,0,0,0,0,0,0,0,Thursday
2022-06-09,Man Kam To,0,0,0,0,0,0,0,0,Thursday
2022-06-09,Sha Tau Kok,0,0,0,0,0,0,0,0,Thursday
2022-06-09,Shenzhen Bay,749,106,10,865,607,487,15,1109,Thursday
2022-06-09,China Ferry Terminal,0,0,0,0,0,0,0,0,Thursday
2022-06-09,Harbour Control,0,0,0,0,0,0,0,0,Thursday
2022-06-09,Kai Tak Cruise Terminal,0,0,0,0,0,0,0,0,Thursday
2022-06-09,Macau Ferry Terminal,0,0,0,0,0,0,0,0,Thursday
2022-06-09,Total,2390,836,177,3403,3206,923,125,4254,Thursday
2022-06-10,Airport,2534,1232,186,3952,2782,425,100,3307,Friday
2022-06-10,Express Rail Link West Kowloon,0,0,0,0,0,0,0,0,Friday
2022-06-10,Hung Hom,0,0,0,0,0,0,0,0,Friday
2022-06-10,Lo Wu,0,0,0,0,0,0,0,0,Friday
2022-06-10,Lok Ma Chau Spur Line,0,0,0,0,0,0,0,0,Friday
2022-06-10,Heung Yuen Wai,0,0,0,0,0,0,0,0,Friday
2022-06-10,Hong Kong-Zhuhai-Macao Bridge,83,9,14,106,136,99,7,242,Friday
2022-06-10,Lok Ma Chau,0,0,0,0,0,0,0,0,Friday
2022-06-10,Man Kam To,0,0,0,0,0,0,0,0,Friday
2022-06-10,Sha Tau Kok,0,0,0,0,0,0,0,0,Friday
2022-06-10,Shenzhen Bay,876,130,7,1013,491,490,7,988,Friday
2022-06-10,China Ferry Terminal,0,0,0,0,0,0,0,0,Friday
2022-06-10,Harbour Control,0,0,0,0,0,0,0,0,Friday
2022-06-10,Kai Tak Cruise Terminal,0,0,0,0,0,0,0,0,Friday
2022-06-10,Macau Ferry Terminal,0,0,0,0,0,0,0,0,Friday
2022-06-11,Express Rail Link West Kowloon,0,0,0,0,0,0,0,0,Saturday
2022-06-11,Hung Hom,0,0,0,0,0,0,0,0,Saturday
2022-06-11,Lo Wu,0,0,0,0,0,0,0,0,Saturday
2022-06-11,Lok Ma Chau Spur Line,0,0,0,0,0,0,0,0,Saturday
2022-06-11,Heung Yuen Wai,0,0,0,0,0,0,0,0,Saturday
2022-06-11,Hong Kong-Zhuhai-Macao Bridge,85,8,9,102,145,96,3,244,Saturday
2022-06-11,Lok Ma Chau,0,0,0,0,0,0,0,0,Saturday
2022-06-11,Man Kam To,0,0,0,0,0,0,0,0,Saturday
2022-06-11,Sha Tau Kok,0,0,0,0,0,0,0,0,Saturday
2022-06-11,Shenzhen Bay,1015,333,4,1352,648,500,11,1159,Saturday
2022-06-11,China Ferry Terminal,0,0,0,0,0,0,0,0,Saturday
2022-06-11,Harbour Control,0,0,0,0,0,0,0,0,Saturday
2022-06-11,Kai Tak Cruise Terminal,0,0,0,0,0,0,0,0,Saturday
2022-06-11,Macau Ferry Terminal,0,0,0,0,0,0,0,0,Saturday
2022-06-11,Total,4088,1195,197,5480,3593,622,113,4328,Saturday
2022-06-12,Airport,3089,1025,192,4306,2723,375,105,3203,Sunday
2022-06-12,Express Rail Link West Kowloon,0,0,0,0,0,0,0,0,Sunday
2022-06-12,Hung Hom,0,0,0,0,0,0,0,0,Sunday
2022-06-12,Lo Wu,0,0,0,0,0,0,0,0,Sunday
2022-06-12,Lok Ma Chau Spur Line,0,0,0,0,0,0,0,0,Sunday
2022-06-12,Heung Yuen Wai,0,0,0,0,0,0,0,0,Sunday
2022-06-12,Hong Kong-Zhuhai-Macao Bridge,114,8,10,132,120,85,10,215,Sunday
2022-06-12,Lok Ma Chau,0,0,0,0,0,0,0,0,Sunday
2022-06-12,Man Kam To,0,0,0,0,0,0,0,0,Sunday
2022-06-12,Sha Tau Kok,0,0,0,0,0,0,0,0,Sunday
2022-06-12,Shenzhen Bay,1063,192,12,1267,477,511,15,1003,Sunday
2022-06-12,China Ferry Terminal,0,0,0,0,0,0,0,0,Sunday
2022-06-12,Harbour Control,0,0,0,0,0,0,0,0,Sunday
2022-06-12,Kai Tak Cruise Terminal,0,0,0,0,0,0,0,0,Sunday
2022-06-12,Macau Ferry Terminal,0,0,0,0,0,0,0,0,Sunday
2022-06-12,Total,4266,1225,214,5705,3320,971,130,4421,Sunday
2022-06-13,Airport,1320,809,99,2228,2385,450,125,2960,Monday
2022-06-13,Express Rail Link West Kowloon,0,0,0,0,0,0,0,0,Monday
2022-06-13,Hung Hom,0,0,0,0,0,0,0,0,Monday
2022-06-13,Lo Wu,0,0,0,0,0,0,0,0,Monday
2022-06-13,Lok Ma Chau Spur Line,0,0,0,0,0,0,0,0,Monday
2022-06-13,Heung Yuen Wai,0,0,0,0,0,0,0,0,Monday
2022-06-13,Hong Kong-Zhuhai-Macao Bridge,74,4,24,102,135,96,2,233,Monday
2022-06-13,Lok Ma Chau,0,0,0,0,0,0,0,0,Monday
2022-06-13,Man Kam To,0,0,0,0,0,0,0,0,Monday
2022-06-13,Sha Tau Kok,0,0,0,0,0,0,0,0,Monday
2022-06-13,Shenzhen Bay,779,126,5,910,432,488,22,942,Monday
2022-06-13,China Ferry Terminal,0,0,0,0,0,0,0,0,Monday
2022-06-13,Harbour Control,0,0,0,0,0,0,0,0,Monday
2022-06-13,Kai Tak Cruise Terminal,0,0,0,0,0,0,0,0,Monday
2022-06-13,Macau Ferry Terminal,0,0,0,0,0,0,0,0,Monday
2022-06-13,Total,2173,939,128,3240,2952,1034,149,4135,Monday
2022-06-14,Airport,1805,796,110,2711,2380,348,96,2824,Tuesday
2022-06-14,Express Rail Link West Kowloon,0,0,0,0,0,0,0,0,Tuesday
2022-06-14,Hung Hom,0,0,0,0,0,0,0,0,Tuesday
2022-06-14,Lo Wu,0,0,0,0,0,0,0,0,Tuesday
2022-06-14,Lok Ma Chau Spur Line,0,0,0,0,0,0,0,0,Tuesday
2022-06-14,Heung Yuen Wai,0,0,0,0,0,0,0,0,Tuesday
2022-06-14,Hong Kong-Zhuhai-Macao Bridge,53,11,20,84,129,68,12,209,Tuesday
2022-06-14,Lok Ma Chau,0,0,0,0,0,0,0,0,Tuesday
2022-06-14,Man Kam To,0,0,0,0,0,0,0,0,Tuesday
2022-06-14,Sha Tau Kok,0,0,0,0,0,0,0,0,Tuesday
2022-06-14,Shenzhen Bay,748,113,16,877,483,399,14,896,Tuesday
2022-06-14,China Ferry Terminal,0,0,0,0,0,0,0,0,Tuesday
2022-06-14,Harbour Control,0,0,0,0,0,0,0,0,Tuesday
2022-06-14,Kai Tak Cruise Terminal,0,0,0,0,0,0,0,0,Tuesday
2022-06-14,Macau Ferry Terminal,0,0,0,0,0,0,0,0,Tuesday
2022-06-14,Total,2606,920,146,3672,2992,815,122,3929,Tuesday
2022-06-15,Airport,1927,1416,149,3492,2811,545,137,3493,Wednesday
2022-06-15,Express Rail Link West Kowloon,0,0,0,0,0,0,0,0,Wednesday
2022-06-15,Hung Hom,0,0,0,0,0,0,0,0,Wednesday
2022-06-15,Lo Wu,0,0,0,0,0,0,0,0,Wednesday
2022-06-15,Lok Ma Chau Spur Line,0,0,0,0,0,0,0,0,Wednesday
2022-06-15,Heung Yuen Wai,0,0,0,0,0,0,0,0,Wednesday
2022-06-15,Hong Kong-Zhuhai-Macao Bridge,104,9,25,138,190,113,9,312,Wednesday
2022-06-15,Lok Ma Chau,0,0,0,0,0,0,0,0,Wednesday
2022-06-15,Man Kam To,0,0,0,0,0,0,0,0,Wednesday
2022-06-15,Sha Tau Kok,0,0,0,0,0,0,0,0,Wednesday
2022-06-15,Shenzhen Bay,881,116,15,1012,524,463,16,1003,Wednesday
2022-06-15,China Ferry Terminal,0,0,0,0,0,0,0,0,Wednesday
2022-06-15,Harbour Control,0,0,0,0,0,0,0,0,Wednesday
2022-06-15,Kai Tak Cruise Terminal,0,0,0,0,0,0,0,0,Wednesday
2022-06-15,Macau Ferry Terminal,0,0,0,0,0,0,0,0,Wednesday
2022-06-15,Total,2912,1541,189,4642,3525,1121,162,4808,Wednesday
2022-06-17,Airport,2578,1333,172,4083,3098,343,105,3546,Friday
2022-06-17,Express Rail Link West Kowloon,0,0,0,0,0,0,0,0,Friday
2022-06-17,Hung Hom,0,0,0,0,0,0,0,0,Friday
2022-06-17,Lo Wu,0,0,0,0,0,0,0,0,Friday
2022-06-17,Lok Ma Chau Spur Line,0,0,0,0,0,0,0,0,Friday
2022-06-17,Heung Yuen Wai,0,0,0,0,0,0,0,0,Friday
2022-06-17,Hong Kong-Zhuhai-Macao Bridge,99,7,14,120,140,126,19,285,Friday
2022-06-17,Lok Ma Chau,0,0,0,0,0,0,0,0,Friday
2022-06-17,Man Kam To,0,0,0,0,0,0,0,0,Friday
2022-06-17,Sha Tau Kok,0,0,0,0,0,0,0,0,Friday
2022-06-17,Shenzhen Bay,704,344,5,1053,479,532,15,1026,Friday
2022-06-17,China Ferry Terminal,0,0,0,0,0,0,0,0,Friday
2022-06-17,Harbour Control,0,0,0,0,0,0,0,0,Friday
2022-06-17,Kai Tak Cruise Terminal,0,0,0,0,0,0,0,0,Friday
2022-06-17,Macau Ferry Terminal,0,0,0,0,0,0,0,0,Friday
2022-06-17,Total,3381,1684,191,5256,3717,1001,139,4857,Friday
2022-06-16,Airport,2192,1044,170,3406,2750,337,133,3220,Thursday
2022-06-16,Express Rail Link West Kowloon,0,0,0,0,0,0,0,0,Thursday
2022-06-16,Hung Hom,0,0,0,0,0,0,0,0,Thursday
2022-06-16,Lo Wu,0,0,0,0,0,0,0,0,Thursday
2022-06-16,Lok Ma Chau Spur Line,0,0,0,0,0,0,0,0,Thursday
2022-06-16,Heung Yuen Wai,0,0,0,0,0,0,0,0,Thursday
2022-06-16,Hong Kong-Zhuhai-Macao Bridge,71,11,12,94,171,73,8,252,Thursday
2022-06-16,Lok Ma Chau,0,0,0,0,0,0,0,0,Thursday
2022-06-16,Man Kam To,0,0,0,0,0,0,0,0,Thursday
2022-06-16,Sha Tau Kok,0,0,0,0,0,0,0,0,Thursday
2022-06-16,Shenzhen Bay,616,126,8,750,464,467,19,950,Thursday
2022-06-16,China Ferry Terminal,0,0,0,0,0,0,0,0,Thursday
2022-06-16,Harbour Control,0,0,0,0,0,0,0,0,Thursday
2022-06-16,Kai Tak Cruise Terminal,0,0,0,0,0,0,0,0,Thursday
2022-06-16,Macau Ferry Terminal,0,0,0,0,0,0,0,0,Thursday
2022-06-16,Total,2879,1181,190,4250,3385,877,160,4422,Thursday
2022-06-18,Airport,2814,1019,151,3984,4135,156,137,4428,Saturday
2022-06-18,Express Rail Link West Kowloon,0,0,0,0,0,0,0,0,Saturday
2022-06-18,Hung Hom,0,0,0,0,0,0,0,0,Saturday
2022-06-18,Lo Wu,0,0,0,0,0,0,0,0,Saturday
2022-06-18,Lok Ma Chau Spur Line,0,0,0,0,0,0,0,0,Saturday
2022-06-18,Heung Yuen Wai,0,0,0,0,0,0,0,0,Saturday
2022-06-18,Hong Kong-Zhuhai-Macao Bridge,77,9,31,117,180,77,10,267,Saturday
2022-06-18,Lok Ma Chau,0,0,0,0,0,0,0,0,Saturday
2022-06-18,Man Kam To,0,0,0,0,0,0,0,0,Saturday
2022-06-18,Sha Tau Kok,0,0,0,0,0,0,0,0,Saturday
2022-06-18,Shenzhen Bay,855,205,16,1076,634,316,10,960,Saturday
2022-06-18,China Ferry Terminal,0,0,0,0,0,0,0,0,Saturday
2022-06-18,Harbour Control,0,0,0,0,0,0,0,0,Saturday
2022-06-18,Kai Tak Cruise Terminal,0,0,0,0,0,0,0,0,Saturday
2022-06-18,Macau Ferry Terminal,0,0,0,0,0,0,0,0,Saturday
2022-06-18,Total,3746,1233,198,5177,4949,549,157,5655,Saturday
2022-06-19,Airport,2823,1351,154,4328,3817,448,125,4390,Sunday
2022-06-19,Express Rail Link West Kowloon,0,0,0,0,0,0,0,0,Sunday
2022-06-19,Hung Hom,0,0,0,0,0,0,0,0,Sunday
2022-06-19,Lo Wu,0,0,0,0,0,0,0,0,Sunday
2022-06-19,Lok Ma Chau Spur Line,0,0,0,0,0,0,0,0,Sunday
2022-06-19,Heung Yuen Wai,0,0,0,0,0,0,0,0,Sunday
2022-06-19,Hong Kong-Zhuhai-Macao Bridge,113,12,24,149,173,107,14,294,Sunday
2022-06-19,Lok Ma Chau,0,0,0,0,0,0,0,0,Sunday
2022-06-19,Man Kam To,0,0,0,0,0,0,0,0,Sunday
2022-06-19,Sha Tau Kok,0,0,0,0,0,0,0,0,Sunday
2022-06-19,Shenzhen Bay,952,175,5,1132,398,529,20,947,Sunday
2022-06-19,China Ferry Terminal,0,0,0,0,0,0,0,0,Sunday
2022-06-19,Harbour Control,0,0,0,0,0,0,0,0,Sunday
2022-06-19,Kai Tak Cruise Terminal,0,0,0,0,0,0,0,0,Sunday
2022-06-19,Macau Ferry Terminal,0,0,0,0,0,0,0,0,Sunday
2022-06-19,Total,3888,1538,183,5609,4388,1084,159,5631,Sunday
2022-06-20,Airport,1698,1087,132,2917,2497,279,117,2893,Monday
2022-06-20,Express Rail Link West Kowloon,0,0,0,0,0,0,0,0,Monday
2022-06-20,Hung Hom,0,0,0,0,0,0,0,0,Monday
2022-06-20,Lo Wu,0,0,0,0,0,0,0,0,Monday
2022-06-20,Lok Ma Chau Spur Line,0,0,0,0,0,0,0,0,Monday
2022-06-20,Heung Yuen Wai,0,0,0,0,0,0,0,0,Monday
2022-06-20,Hong Kong-Zhuhai-Macao Bridge,124,16,41,181,144,118,12,274,Monday
2022-06-20,Lok Ma Chau,0,0,0,0,0,0,0,0,Monday
2022-06-20,Man Kam To,0,0,0,0,0,0,0,0,Monday
2022-06-20,Sha Tau Kok,0,0,0,0,0,0,0,0,Monday
2022-06-20,Shenzhen Bay,820,130,10,960,392,546,15,953,Monday
2022-06-20,China Ferry Terminal,0,0,0,0,0,0,0,0,Monday
2022-06-20,Harbour Control,0,0,0,0,0,0,0,0,Monday
2022-06-20,Kai Tak Cruise Terminal,0,0,0,0,0,0,0,0,Monday
2022-06-20,Macau Ferry Terminal,0,0,0,0,0,0,0,0,Monday
2022-06-20,Total,2642,1233,183,4058,3033,943,144,4120,Monday
2022-06-21,Airport,2275,949,195,3419,3214,462,127,3803,Tuesday
2022-06-21,Express Rail Link West Kowloon,0,0,0,0,0,0,0,0,Tuesday
2022-06-21,Hung Hom,0,0,0,0,0,0,0,0,Tuesday
2022-06-21,Lo Wu,0,0,0,0,0,0,0,0,Tuesday
2022-06-21,Lok Ma Chau Spur Line,0,0,0,0,0,0,0,0,Tuesday
2022-06-21,Heung Yuen Wai,0,0,0,0,0,0,0,0,Tuesday
2022-06-21,Hong Kong-Zhuhai-Macao Bridge,91,11,26,128,83,29,2,114,Tuesday
2022-06-21,Lok Ma Chau,0,0,0,0,0,0,0,0,Tuesday
2022-06-21,Man Kam To,0,0,0,0,0,0,0,0,Tuesday
2022-06-21,Sha Tau Kok,0,0,0,0,0,0,0,0,Tuesday
2022-06-21,Shenzhen Bay,720,115,10,845,597,514,11,1122,Tuesday
2022-06-21,China Ferry Terminal,0,0,0,0,0,0,0,0,Tuesday
2022-06-21,Harbour Control,0,0,0,0,0,0,0,0,Tuesday
2022-06-21,Kai Tak Cruise Terminal,0,0,0,0,0,0,0,0,Tuesday
2022-06-21,Macau Ferry Terminal,0,0,0,0,0,0,0,0,Tuesday
2022-06-21,Total,3086,1075,231,4392,3894,1005,140,5039,Tuesday
2022-06-22,Airport,1979,1099,117,3195,2730,383,100,3213,Wednesday
2022-06-22,Express Rail Link West Kowloon,0,0,0,0,0,0,0,0,Wednesday
2022-06-22,Hung Hom,0,0,0,0,0,0,0,0,Wednesday
2022-06-22,Lo Wu,0,0,0,0,0,0,0,0,Wednesday
2022-06-22,Lok Ma Chau Spur Line,0,0,0,0,0,0,0,0,Wednesday
2022-06-22,Heung Yuen Wai,0,0,0,0,0,0,0,0,Wednesday
2022-06-22,Hong Kong-Zhuhai-Macao Bridge,83,3,26,112,125,129,11,265,Wednesday
2022-06-22,Lok Ma Chau,0,0,0,0,0,0,0,0,Wednesday
2022-06-22,Man Kam To,0,0,0,0,0,0,0,0,Wednesday
2022-06-22,Sha Tau Kok,0,0,0,0,0,0,0,0,Wednesday
2022-06-22,Shenzhen Bay,726,106,8,840,316,439,2,757,Wednesday
2022-06-22,China Ferry Terminal,0,0,0,0,0,0,0,0,Wednesday
2022-06-22,Harbour Control,0,0,0,0,0,0,0,0,Wednesday
2022-06-22,Kai Tak Cruise Terminal,0,0,0,0,0,0,0,0,Wednesday
2022-06-22,Macau Ferry Terminal,0,0,0,0,0,0,0,0,Wednesday
2022-06-22,Total,2788,1208,151,4147,3171,951,113,4235,Wednesday
2022-06-23,Airport,2643,1012,179,3834,3623,528,151,4302,Thursday
2022-06-23,Express Rail Link West Kowloon,0,0,0,0,0,0,0,0,Thursday
2022-06-23,Hung Hom,0,0,0,0,0,0,0,0,Thursday
2022-06-23,Lo Wu,0,0,0,0,0,0,0,0,Thursday
2022-06-23,Lok Ma Chau Spur Line,0,0,0,0,0,0,0,0,Thursday
2022-06-23,Heung Yuen Wai,0,0,0,0,0,0,0,0,Thursday
2022-06-23,Hong Kong-Zhuhai-Macao Bridge,85,7,30,122,154,120,4,278,Thursday
2022-06-23,Lok Ma Chau,0,0,0,0,0,0,0,0,Thursday
2022-06-23,Man Kam To,0,0,0,0,0,0,0,0,Thursday
2022-06-23,Sha Tau Kok,0,0,0,0,0,0,0,0,Thursday
2022-06-23,Shenzhen Bay,836,113,6,955,409,455,16,880,Thursday
2022-06-23,China Ferry Terminal,0,0,0,0,0,0,0,0,Thursday
2022-06-23,Harbour Control,0,0,0,0,0,0,0,0,Thursday
2022-06-23,Kai Tak Cruise Terminal,0,0,0,0,0,0,0,0,Thursday
2022-06-23,Macau Ferry Terminal,0,0,0,0,0,0,0,0,Thursday
2022-06-23,Total,3564,1132,215,4911,4186,1103,171,5460,Thursday
2022-06-24,Airport,2578,1193,168,3939,4147,249,118,4514,Friday
2022-06-24,Express Rail Link West Kowloon,0,0,0,0,0,0,0,0,Friday
2022-06-24,Hung Hom,0,0,0,0,0,0,0,0,Friday
2022-06-24,Lo Wu,0,0,0,0,0,0,0,0,Friday
2022-06-24,Lok Ma Chau Spur Line,0,0,0,0,0,0,0,0,Friday
2022-06-24,Heung Yuen Wai,0,0,0,0,0,0,0,0,Friday
2022-06-24,Hong Kong-Zhuhai-Macao Bridge,77,9,24,110,111,154,7,272,Friday
2022-06-24,Lok Ma Chau,0,0,0,0,0,0,0,0,Friday
2022-06-24,Man Kam To,0,0,0,0,0,0,0,0,Friday
2022-06-24,Sha Tau Kok,0,0,0,0,0,0,0,0,Friday
2022-06-24,Shenzhen Bay,696,118,8,822,510,410,14,934,Friday
2022-06-24,China Ferry Terminal,0,0,0,0,0,0,0,0,Friday
2022-06-24,Harbour Control,0,0,0,0,0,0,0,0,Friday
2022-06-24,Kai Tak Cruise Terminal,0,0,0,0,0,0,0,0,Friday
2022-06-24,Macau Ferry Terminal,0,0,0,0,0,0,0,0,Friday
2022-06-24,Total,3351,1320,200,4871,4768,813,139,5720,Friday
2022-06-26,Airport,3073,1081,143,4297,4268,512,138,4918,Sunday
2022-06-26,Express Rail Link West Kowloon,0,0,0,0,0,0,0,0,Sunday
2022-06-26,Hung Hom,0,0,0,0,0,0,0,0,Sunday
2022-06-26,Lo Wu,0,0,0,0,0,0,0,0,Sunday
2022-06-26,Lok Ma Chau Spur Line,0,0,0,0,0,0,0,0,Sunday
2022-06-26,Heung Yuen Wai,0,0,0,0,0,0,0,0,Sunday
2022-06-26,Hong Kong-Zhuhai-Macao Bridge,125,15,28,168,125,128,4,257,Sunday
2022-06-26,Lok Ma Chau,0,0,0,0,0,0,0,0,Sunday
2022-06-26,Man Kam To,0,0,0,0,0,0,0,0,Sunday
2022-06-26,Sha Tau Kok,0,0,0,0,0,0,0,0,Sunday
2022-06-26,Shenzhen Bay,1093,270,13,1376,374,425,14,813,Sunday
2022-06-26,China Ferry Terminal,0,0,0,0,0,0,0,0,Sunday
2022-06-26,Harbour Control,0,0,0,0,0,0,0,0,Sunday
2022-06-26,Kai Tak Cruise Terminal,0,0,0,0,0,0,0,0,Sunday
2022-06-26,Macau Ferry Terminal,0,0,0,0,0,0,0,0,Sunday
2022-06-26,Total,4291,1366,184,5841,4767,1065,156,5988,Sunday
2022-06-25,Airport,2596,1088,131,3815,4781,114,129,5024,Saturday
2022-06-25,Express Rail Link West Kowloon,0,0,0,0,0,0,0,0,Saturday
2022-06-25,Hung Hom,0,0,0,0,0,0,0,0,Saturday
2022-06-25,Lo Wu,0,0,0,0,0,0,0,0,Saturday
2022-06-25,Lok Ma Chau Spur Line,0,0,0,0,0,0,0,0,Saturday
2022-06-25,Heung Yuen Wai,0,0,0,0,0,0,0,0,Saturday
2022-06-25,Hong Kong-Zhuhai-Macao Bridge,72,5,38,115,157,108,10,275,Saturday
2022-06-25,Lok Ma Chau,0,0,0,0,0,0,0,0,Saturday
2022-06-25,Man Kam To,0,0,0,0,0,0,0,0,Saturday
2022-06-25,Sha Tau Kok,0,0,0,0,0,0,0,0,Saturday
2022-06-25,Shenzhen Bay,1055,185,8,1248,404,456,13,873,Saturday
2022-06-25,China Ferry Terminal,0,0,0,0,0,0,0,0,Saturday
2022-06-25,Harbour Control,0,0,0,0,0,0,0,0,Saturday
2022-06-25,Kai Tak Cruise Terminal,0,0,0,0,0,0,0,0,Saturday
2022-06-25,Macau Ferry Terminal,0,0,0,0,0,0,0,0,Saturday
2022-06-25,Total,3723,1278,177,5178,5342,678,152,6172,Saturday
2022-06-27,Airport,1830,1033,133,2996,2908,570,98,3576,Monday
2022-06-27,Express Rail Link West Kowloon,0,0,0,0,0,0,0,0,Monday
2022-06-27,Hung Hom,0,0,0,0,0,0,0,0,Monday
2022-06-27,Lo Wu,0,0,0,0,0,0,0,0,Monday
2022-06-27,Lok Ma Chau Spur Line,0,0,0,0,0,0,0,0,Monday
2022-06-27,Heung Yuen Wai,0,0,0,0,0,0,0,0,Monday
2022-06-27,Hong Kong-Zhuhai-Macao Bridge,87,7,29,123,111,125,8,244,Monday
2022-06-27,Lok Ma Chau,0,0,0,0,0,0,0,0,Monday
2022-06-27,Man Kam To,0,0,0,0,0,0,0,0,Monday
2022-06-27,Sha Tau Kok,0,0,0,0,0,0,0,0,Monday
2022-06-27,Shenzhen Bay,753,115,2,870,347,595,19,961,Monday
2022-06-27,China Ferry Terminal,0,0,0,0,0,0,0,0,Monday
2022-06-27,Harbour Control,0,0,0,0,0,0,0,0,Monday
2022-06-27,Kai Tak Cruise Terminal,0,0,0,0,0,0,0,0,Monday
2022-06-27,Macau Ferry Terminal,0,0,0,0,0,0,0,0,Monday
2022-06-27,Total,2670,1155,164,3989,3366,1290,125,4781,Monday
2022-06-28,Airport,2256,772,89,3117,4754,353,127,5234,Tuesday
2022-06-28,Express Rail Link West Kowloon,0,0,0,0,0,0,0,0,Tuesday
2022-06-28,Hung Hom,0,0,0,0,0,0,0,0,Tuesday
2022-06-28,Lo Wu,0,0,0,0,0,0,0,0,Tuesday
2022-06-28,Lok Ma Chau Spur Line,0,0,0,0,0,0,0,0,Tuesday
2022-06-28,Heung Yuen Wai,0,0,0,0,0,0,0,0,Tuesday
2022-06-28,Hong Kong-Zhuhai-Macao Bridge,122,11,31,164,122,188,5,315,Tuesday
2022-06-28,Lok Ma Chau,0,0,0,0,0,0,0,0,Tuesday
2022-06-28,Man Kam To,0,0,0,0,0,0,0,0,Tuesday
2022-06-28,Sha Tau Kok,0,0,0,0,0,0,0,0,Tuesday
2022-06-28,Shenzhen Bay,839,132,10,981,415,698,23,1136,Tuesday
2022-07-22,Lo Wu,0,0,0,0,0,0,0,0,Friday
2022-06-28,China Ferry Terminal,0,0,0,0,0,0,0,0,Tuesday
2022-06-28,Harbour Control,0,0,0,0,0,0,0,0,Tuesday
2022-06-28,Kai Tak Cruise Terminal,0,0,0,0,0,0,0,0,Tuesday
2022-06-28,Macau Ferry Terminal,0,0,0,0,0,0,0,0,Tuesday
2022-06-28,Total,3217,915,130,4262,5291,1239,155,6685,Tuesday
2022-06-29,Airport,1837,1131,112,3080,3781,490,155,4426,Wednesday
2022-06-29,Express Rail Link West Kowloon,0,0,0,0,0,0,0,0,Wednesday
2022-06-29,Hung Hom,0,0,0,0,0,0,0,0,Wednesday
2022-06-29,Lo Wu,0,0,0,0,0,0,0,0,Wednesday
2022-06-29,Lok Ma Chau Spur Line,0,0,0,0,0,0,0,0,Wednesday
2022-06-29,Heung Yuen Wai,0,0,0,0,0,0,0,0,Wednesday
2022-06-29,Hong Kong-Zhuhai-Macao Bridge,108,6,28,142,134,192,3,329,Wednesday
2022-06-29,Lok Ma Chau,0,0,0,0,0,0,0,0,Wednesday
2022-06-29,Man Kam To,0,0,0,0,0,0,0,0,Wednesday
2022-06-29,Sha Tau Kok,0,0,0,0,0,0,0,0,Wednesday
2022-06-29,Shenzhen Bay,847,128,18,993,490,607,16,1113,Wednesday
2022-06-29,China Ferry Terminal,0,0,0,0,0,0,0,0,Wednesday
2022-06-29,Harbour Control,0,0,0,0,0,0,0,0,Wednesday
2022-06-29,Kai Tak Cruise Terminal,0,0,0,0,0,0,0,0,Wednesday
2022-06-29,Macau Ferry Terminal,0,0,0,0,0,0,0,0,Wednesday
2022-06-29,Total,2792,1265,158,4215,4405,1289,174,5868,Wednesday
2022-06-30,Airport,2192,964,150,3306,4398,473,121,4992,Thursday
2022-06-30,Express Rail Link West Kowloon,0,0,0,0,0,0,0,0,Thursday
2022-06-30,Hung Hom,0,0,0,0,0,0,0,0,Thursday
2022-06-30,Lo Wu,0,0,0,0,0,0,0,0,Thursday
2022-06-30,Lok Ma Chau Spur Line,0,0,0,0,0,0,0,0,Thursday
2022-06-30,Heung Yuen Wai,0,0,0,0,0,0,0,0,Thursday
2022-06-30,Hong Kong-Zhuhai-Macao Bridge,150,10,37,197,174,139,14,327,Thursday
2022-06-30,Lok Ma Chau,0,0,0,0,0,0,0,0,Thursday
2022-06-30,Man Kam To,0,0,0,0,0,0,0,0,Thursday
2022-06-30,Sha Tau Kok,0,0,0,0,0,0,0,0,Thursday
2022-06-30,Shenzhen Bay,1019,145,15,1179,540,646,18,1204,Thursday
2022-06-30,China Ferry Terminal,0,0,0,0,0,0,0,0,Thursday
2022-06-30,Harbour Control,0,0,0,0,0,0,0,0,Thursday
2022-06-30,Kai Tak Cruise Terminal,0,0,0,0,0,0,0,0,Thursday
2022-06-30,Macau Ferry Terminal,0,0,0,0,0,0,0,0,Thursday
2022-06-30,Total,3361,1119,202,4682,5112,1258,153,6523,Thursday
2022-07-01,Airport,3056,1193,167,4416,4944,726,133,5803,Friday
2022-07-01,Express Rail Link West Kowloon,0,0,0,0,0,0,0,0,Friday
2022-07-01,Hung Hom,0,0,0,0,0,0,0,0,Friday
2022-07-01,Lo Wu,0,0,0,0,0,0,0,0,Friday
2022-07-01,Lok Ma Chau Spur Line,0,0,0,0,0,0,0,0,Friday
2022-07-01,Heung Yuen Wai,0,0,0,0,0,0,0,0,Friday
2022-07-01,Hong Kong-Zhuhai-Macao Bridge,106,9,36,151,170,159,9,338,Friday
2022-07-01,Lok Ma Chau,0,0,0,0,0,0,0,0,Friday
2022-07-01,Man Kam To,0,0,0,0,0,0,0,0,Friday
2022-07-01,Sha Tau Kok,0,0,0,0,0,0,0,0,Friday
2022-07-01,Shenzhen Bay,685,106,10,801,710,725,10,1445,Friday
2022-07-01,China Ferry Terminal,0,0,0,0,0,0,0,0,Friday
2022-07-01,Harbour Control,0,0,0,0,0,0,0,0,Friday
2022-07-01,Kai Tak Cruise Terminal,0,0,0,0,0,0,0,0,Friday
2022-07-01,Macau Ferry Terminal,0,0,0,0,0,0,0,0,Friday
2022-07-01,Total,3847,1308,213,5368,5824,1610,152,7586,Friday
2022-07-03,Airport,3660,903,186,4749,5140,471,199,5810,Sunday
2022-07-03,Express Rail Link West Kowloon,0,0,0,0,0,0,0,0,Sunday
2022-07-03,Hung Hom,0,0,0,0,0,0,0,0,Sunday
2022-07-03,Lo Wu,0,0,0,0,0,0,0,0,Sunday
2022-07-03,Lok Ma Chau Spur Line,0,0,0,0,0,0,0,0,Sunday
2022-07-03,Heung Yuen Wai,0,0,0,0,0,0,0,0,Sunday
2022-07-03,Hong Kong-Zhuhai-Macao Bridge,145,13,36,194,121,204,3,328,Sunday
2022-07-03,Lok Ma Chau,0,0,0,0,0,0,0,0,Sunday
2022-07-03,Man Kam To,0,0,0,0,0,0,0,0,Sunday
2022-07-03,Sha Tau Kok,0,0,0,0,0,0,0,0,Sunday
2022-07-03,Shenzhen Bay,1301,155,30,1486,492,688,20,1200,Sunday
2022-07-03,China Ferry Terminal,0,0,0,0,0,0,0,0,Sunday
2022-07-03,Harbour Control,0,0,0,0,0,0,0,0,Sunday
2022-07-03,Kai Tak Cruise Terminal,0,0,0,0,0,0,0,0,Sunday
2022-07-03,Macau Ferry Terminal,0,0,0,0,0,0,0,0,Sunday
2022-07-03,Total,5106,1071,252,6429,5753,1363,222,7338,Sunday
2022-07-02,Airport,2881,779,129,3789,4132,515,211,4858,Saturday
2022-07-02,Express Rail Link West Kowloon,0,0,0,0,0,0,0,0,Saturday
2022-07-02,Hung Hom,0,0,0,0,0,0,0,0,Saturday
2022-07-02,Lo Wu,0,0,0,0,0,0,0,0,Saturday
2022-07-02,Lok Ma Chau Spur Line,0,0,0,0,0,0,0,0,Saturday
2022-07-02,Heung Yuen Wai,0,0,0,0,0,0,0,0,Saturday
2022-07-02,Hong Kong-Zhuhai-Macao Bridge,4,0,1,5,51,57,3,111,Saturday
2022-07-02,Lok Ma Chau,0,0,0,0,0,0,0,0,Saturday
2022-07-02,Man Kam To,0,0,0,0,0,0,0,0,Saturday
2022-07-02,Sha Tau Kok,0,0,0,0,0,0,0,0,Saturday
2022-07-02,Shenzhen Bay,758,241,91,1090,725,800,23,1548,Saturday
2022-07-02,China Ferry Terminal,0,0,0,0,0,0,0,0,Saturday
2022-07-02,Harbour Control,0,0,0,0,0,0,0,0,Saturday
2022-07-02,Kai Tak Cruise Terminal,0,0,0,0,0,0,0,0,Saturday
2022-07-02,Macau Ferry Terminal,0,0,0,0,0,0,0,0,Saturday
2022-07-02,Total,3643,1020,221,4884,4908,1372,237,6517,Saturday
2022-07-04,Airport,2100,1154,136,3390,2561,384,121,3066,Monday
2022-07-04,Express Rail Link West Kowloon,0,0,0,0,0,0,0,0,Monday
2022-07-04,Hung Hom,0,0,0,0,0,0,0,0,Monday
2022-07-04,Lo Wu,0,0,0,0,0,0,0,0,Monday
2022-07-04,Lok Ma Chau Spur Line,0,0,0,0,0,0,0,0,Monday
2022-07-04,Heung Yuen Wai,0,0,0,0,0,0,0,0,Monday
2022-07-04,Hong Kong-Zhuhai-Macao Bridge,143,16,38,197,242,87,10,339,Monday
2022-07-04,Lok Ma Chau,0,0,0,0,0,0,0,0,Monday
2022-07-04,Man Kam To,0,0,0,0,0,0,0,0,Monday
2022-07-04,Sha Tau Kok,0,0,0,0,0,0,0,0,Monday
2022-07-04,Shenzhen Bay,940,109,33,1082,545,775,13,1333,Monday
2022-07-04,China Ferry Terminal,0,0,0,0,0,0,0,0,Monday
2022-07-04,Harbour Control,0,0,0,0,0,0,0,0,Monday
2022-07-04,Kai Tak Cruise Terminal,0,0,0,0,0,0,0,0,Monday
2022-07-04,Macau Ferry Terminal,0,0,0,0,0,0,0,0,Monday
2022-07-04,Total,3183,1279,207,4669,3348,1246,144,4738,Monday
2022-07-05,Airport,2179,641,81,2901,3569,366,187,4122,Tuesday
2022-07-05,Express Rail Link West Kowloon,0,0,0,0,0,0,0,0,Tuesday
2022-07-05,Hung Hom,0,0,0,0,0,0,0,0,Tuesday
2022-07-05,Lo Wu,0,0,0,0,0,0,0,0,Tuesday
2022-07-05,Lok Ma Chau Spur Line,0,0,0,0,0,0,0,0,Tuesday
2022-07-05,Heung Yuen Wai,0,0,0,0,0,0,0,0,Tuesday
2022-07-05,Hong Kong-Zhuhai-Macao Bridge,151,20,53,224,133,123,5,261,Tuesday
2022-07-05,Lok Ma Chau,0,0,0,0,0,0,0,0,Tuesday
2022-07-05,Man Kam To,0,0,0,0,0,0,0,0,Tuesday
2022-07-05,Sha Tau Kok,0,0,0,0,0,0,0,0,Tuesday
2022-07-05,Shenzhen Bay,1052,145,29,1226,638,719,13,1370,Tuesday
2022-07-05,China Ferry Terminal,0,0,0,0,0,0,0,0,Tuesday
2022-07-05,Harbour Control,0,0,0,0,0,0,0,0,Tuesday
2022-07-05,Kai Tak Cruise Terminal,0,0,0,0,0,0,0,0,Tuesday
2022-07-05,Macau Ferry Terminal,0,0,0,0,0,0,0,0,Tuesday
2022-07-05,Total,3382,806,163,4351,4340,1208,205,5753,Tuesday
2022-07-06,Airport,1923,1151,149,3223,2587,497,160,3244,Wednesday
2022-07-06,Express Rail Link West Kowloon,0,0,0,0,0,0,0,0,Wednesday
2022-07-06,Hung Hom,0,0,0,0,0,0,0,0,Wednesday
2022-07-06,Lo Wu,0,0,0,0,0,0,0,0,Wednesday
2022-07-06,Lok Ma Chau Spur Line,0,0,0,0,0,0,0,0,Wednesday
2022-07-06,Heung Yuen Wai,0,0,0,0,0,0,0,0,Wednesday
2022-07-06,Hong Kong-Zhuhai-Macao Bridge,181,17,47,245,116,135,10,261,Wednesday
2022-07-06,Lok Ma Chau,0,0,0,0,0,0,0,0,Wednesday
2022-07-06,Man Kam To,0,0,0,0,0,0,0,0,Wednesday
2022-07-06,Sha Tau Kok,0,0,0,0,0,0,0,0,Wednesday
2022-07-06,Shenzhen Bay,1114,150,29,1293,933,482,9,1424,Wednesday
2022-07-06,China Ferry Terminal,0,0,0,0,0,0,0,0,Wednesday
2022-07-06,Harbour Control,0,0,0,0,0,0,0,0,Wednesday
2022-07-06,Kai Tak Cruise Terminal,0,0,0,0,0,0,0,0,Wednesday
2022-07-06,Macau Ferry Terminal,0,0,0,0,0,0,0,0,Wednesday
2022-07-06,Total,3218,1318,225,4761,3636,1114,179,4929,Wednesday
2022-07-07,Airport,1851,646,115,2612,2719,457,134,3310,Thursday
2022-07-07,Express Rail Link West Kowloon,0,0,0,0,0,0,0,0,Thursday
2022-07-07,Hung Hom,0,0,0,0,0,0,0,0,Thursday
2022-07-07,Lo Wu,0,0,0,0,0,0,0,0,Thursday
2022-07-07,Lok Ma Chau Spur Line,0,0,0,0,0,0,0,0,Thursday
2022-07-07,Heung Yuen Wai,0,0,0,0,0,0,0,0,Thursday
2022-07-07,Hong Kong-Zhuhai-Macao Bridge,158,15,35,208,151,126,4,281,Thursday
2022-07-07,Lok Ma Chau,0,0,0,0,0,0,0,0,Thursday
2022-07-07,Man Kam To,0,0,0,0,0,0,0,0,Thursday
2022-07-07,Sha Tau Kok,0,0,0,0,0,0,0,0,Thursday
2022-07-07,Shenzhen Bay,1051,114,12,1177,853,608,16,1477,Thursday
2022-07-07,China Ferry Terminal,0,0,0,0,0,0,0,0,Thursday
2022-07-07,Harbour Control,0,0,0,0,0,0,0,0,Thursday
2022-07-07,Kai Tak Cruise Terminal,0,0,0,0,0,0,0,0,Thursday
2022-07-07,Macau Ferry Terminal,0,0,0,0,0,0,0,0,Thursday
2022-07-07,Total,3060,775,162,3997,3723,1191,154,5068,Thursday
2022-07-08,Airport,2887,1000,203,4090,4263,546,171,4980,Friday
2022-07-08,Express Rail Link West Kowloon,0,0,0,0,0,0,0,0,Friday
2022-07-08,Hung Hom,0,0,0,0,0,0,0,0,Friday
2022-07-08,Lo Wu,0,0,0,0,0,0,0,0,Friday
2022-07-08,Lok Ma Chau Spur Line,0,0,0,0,0,0,0,0,Friday
2022-07-08,Heung Yuen Wai,0,0,0,0,0,0,0,0,Friday
2022-07-08,Hong Kong-Zhuhai-Macao Bridge,151,15,62,228,178,143,9,330,Friday
2022-07-08,Lok Ma Chau,0,0,0,0,0,0,0,0,Friday
2022-07-08,Man Kam To,0,0,0,0,0,0,0,0,Friday
2022-07-08,Sha Tau Kok,0,0,0,0,0,0,0,0,Friday
2022-07-08,Shenzhen Bay,1145,187,12,1344,1129,717,11,1857,Friday
2022-07-08,China Ferry Terminal,0,0,0,0,0,0,0,0,Friday
2022-07-08,Harbour Control,0,0,0,0,0,0,0,0,Friday
2022-07-08,Kai Tak Cruise Terminal,0,0,0,0,0,0,0,0,Friday
2022-07-08,Macau Ferry Terminal,0,0,0,0,0,0,0,0,Friday
2022-07-08,Total,4183,1202,277,5662,5570,1406,191,7167,Friday
2022-07-09,Airport,2478,1060,207,3745,3697,545,223,4465,Saturday
2022-07-09,Express Rail Link West Kowloon,0,0,0,0,0,0,0,0,Saturday
2022-07-09,Hung Hom,0,0,0,0,0,0,0,0,Saturday
2022-07-09,Lo Wu,0,0,0,0,0,0,0,0,Saturday
2022-07-09,Lok Ma Chau Spur Line,0,0,0,0,0,0,0,0,Saturday
2022-07-09,Heung Yuen Wai,0,0,0,0,0,0,0,0,Saturday
2022-07-09,Hong Kong-Zhuhai-Macao Bridge,132,13,97,242,163,111,7,281,Saturday
2022-07-09,Lok Ma Chau,0,0,0,0,0,0,0,0,Saturday
2022-07-09,Man Kam To,0,0,0,0,0,0,0,0,Saturday
2022-07-09,Sha Tau Kok,0,0,0,0,0,0,0,0,Saturday
2022-07-09,Shenzhen Bay,1033,214,23,1270,1013,758,21,1792,Saturday
2022-07-09,China Ferry Terminal,0,0,0,0,0,0,0,0,Saturday
2022-07-09,Harbour Control,0,0,0,0,0,0,0,0,Saturday
2022-07-09,Kai Tak Cruise Terminal,0,0,0,0,0,0,0,0,Saturday
2022-07-09,Macau Ferry Terminal,0,0,0,0,0,0,0,0,Saturday
2022-07-09,Total,3643,1287,327,5257,4873,1414,251,6538,Saturday
2022-07-10,Airport,4025,1252,238,5515,4032,419,168,4619,Sunday
2022-07-10,Express Rail Link West Kowloon,0,0,0,0,0,0,0,0,Sunday
2022-07-10,Hung Hom,0,0,0,0,0,0,0,0,Sunday
2022-07-10,Lo Wu,0,0,0,0,0,0,0,0,Sunday
2022-07-10,Lok Ma Chau Spur Line,0,0,0,0,0,0,0,0,Sunday
2022-07-10,Heung Yuen Wai,0,0,0,0,0,0,0,0,Sunday
2022-07-16,Lok Ma Chau Spur Line,0,0,0,0,0,0,0,0,Saturday
2022-07-10,Hong Kong-Zhuhai-Macao Bridge,243,19,46,308,190,101,6,297,Sunday
2022-07-10,Lok Ma Chau,0,0,0,0,0,0,0,0,Sunday
2022-07-10,Man Kam To,0,0,0,0,0,0,0,0,Sunday
2022-07-10,Sha Tau Kok,0,0,0,0,0,0,0,0,Sunday
2022-07-10,Shenzhen Bay,1544,296,28,1868,1058,834,17,1909,Sunday
2022-07-10,China Ferry Terminal,0,0,0,0,0,0,0,0,Sunday
2022-07-10,Harbour Control,0,0,0,0,0,0,0,0,Sunday
2022-07-10,Kai Tak Cruise Terminal,0,0,0,0,0,0,0,0,Sunday
2022-07-10,Macau Ferry Terminal,0,0,0,0,0,0,0,0,Sunday
2022-07-10,Total,5812,1567,312,7691,5280,1354,191,6825,Sunday
2022-07-11,Airport,2369,1149,175,3693,2104,500,135,2739,Monday
2022-07-11,Express Rail Link West Kowloon,0,0,0,0,0,0,0,0,Monday
2022-07-11,Hung Hom,0,0,0,0,0,0,0,0,Monday
2022-07-11,Lo Wu,0,0,0,0,0,0,0,0,Monday
2022-07-11,Lok Ma Chau Spur Line,0,0,0,0,0,0,0,0,Monday
2022-07-11,Heung Yuen Wai,0,0,0,0,0,0,0,0,Monday
2022-07-11,Hong Kong-Zhuhai-Macao Bridge,131,25,46,202,145,98,10,253,Monday
2022-07-11,Lok Ma Chau,0,0,0,0,0,0,0,0,Monday
2022-07-11,Man Kam To,0,0,0,0,0,0,0,0,Monday
2022-07-11,Sha Tau Kok,0,0,0,0,0,0,0,0,Monday
2022-07-11,Shenzhen Bay,965,165,25,1155,1114,683,10,1807,Monday
2022-07-11,China Ferry Terminal,0,0,0,0,0,0,0,0,Monday
2022-07-11,Harbour Control,0,0,0,0,0,0,0,0,Monday
2022-07-11,Kai Tak Cruise Terminal,0,0,0,0,0,0,0,0,Monday
2022-07-11,Macau Ferry Terminal,0,0,0,0,0,0,0,0,Monday
2022-07-11,Total,3465,1339,246,5050,3363,1281,155,4799,Monday
2022-07-12,Airport,2602,1087,170,3859,3230,595,180,4005,Tuesday
2022-07-12,Express Rail Link West Kowloon,0,0,0,0,0,0,0,0,Tuesday
2022-07-12,Hung Hom,0,0,0,0,0,0,0,0,Tuesday
2022-07-12,Lo Wu,0,0,0,0,0,0,0,0,Tuesday
2022-07-12,Lok Ma Chau Spur Line,0,0,0,0,0,0,0,0,Tuesday
2022-07-12,Heung Yuen Wai,0,0,0,0,0,0,0,0,Tuesday
2022-07-12,Hong Kong-Zhuhai-Macao Bridge,151,18,47,216,141,79,2,222,Tuesday
2022-07-12,Lok Ma Chau,0,0,0,0,0,0,0,0,Tuesday
2022-07-12,Man Kam To,0,0,0,0,0,0,0,0,Tuesday
2022-07-12,Sha Tau Kok,0,0,0,0,0,0,0,0,Tuesday
2022-07-12,Shenzhen Bay,1165,177,29,1371,1265,714,25,2004,Tuesday
2022-07-12,China Ferry Terminal,0,0,0,0,0,0,0,0,Tuesday
2022-07-12,Harbour Control,0,0,0,0,0,0,0,0,Tuesday
2022-07-12,Kai Tak Cruise Terminal,0,0,0,0,0,0,0,0,Tuesday
2022-07-12,Macau Ferry Terminal,0,0,0,0,0,0,0,0,Tuesday
2022-07-12,Total,3918,1282,246,5446,4636,1388,207,6231,Tuesday
2022-07-14,Airport,2112,922,163,3197,2940,529,143,3612,Thursday
2022-07-14,Express Rail Link West Kowloon,0,0,0,0,0,0,0,0,Thursday
2022-07-14,Hung Hom,0,0,0,0,0,0,0,0,Thursday
2022-07-14,Lo Wu,0,0,0,0,0,0,0,0,Thursday
2022-07-14,Lok Ma Chau Spur Line,0,0,0,0,0,0,0,0,Thursday
2022-07-14,Heung Yuen Wai,0,0,0,0,0,0,0,0,Thursday
2022-07-14,Hong Kong-Zhuhai-Macao Bridge,151,27,50,228,127,94,6,227,Thursday
2022-07-14,Lok Ma Chau,0,0,0,0,0,0,0,0,Thursday
2022-07-14,Man Kam To,0,0,0,0,0,0,0,0,Thursday
2022-07-14,Sha Tau Kok,0,0,0,0,0,0,0,0,Thursday
2022-07-14,Shenzhen Bay,946,160,20,1126,1302,564,16,1882,Thursday
2022-07-14,China Ferry Terminal,0,0,0,0,0,0,0,0,Thursday
2022-07-14,Harbour Control,0,0,0,0,0,0,0,0,Thursday
2022-07-14,Kai Tak Cruise Terminal,0,0,0,0,0,0,0,0,Thursday
2022-07-14,Macau Ferry Terminal,0,0,0,0,0,0,0,0,Thursday
2022-07-14,Total,3209,1109,233,4551,4369,1187,165,5721,Thursday
2022-07-13,Airport,2044,1262,165,3471,2412,408,132,2952,Wednesday
2022-07-13,Express Rail Link West Kowloon,0,0,0,0,0,0,0,0,Wednesday
2022-07-13,Hung Hom,0,0,0,0,0,0,0,0,Wednesday
2022-07-13,Lo Wu,0,0,0,0,0,0,0,0,Wednesday
2022-07-13,Lok Ma Chau Spur Line,0,0,0,0,0,0,0,0,Wednesday
2022-07-13,Heung Yuen Wai,0,0,0,0,0,0,0,0,Wednesday
2022-07-13,Hong Kong-Zhuhai-Macao Bridge,151,12,42,205,125,113,8,246,Wednesday
2022-07-13,Lok Ma Chau,0,0,0,0,0,0,0,0,Wednesday
2022-07-13,Man Kam To,0,0,0,0,0,0,0,0,Wednesday
2022-07-13,Sha Tau Kok,0,0,0,0,0,0,0,0,Wednesday
2022-07-13,Shenzhen Bay,1100,176,28,1304,1059,728,16,1803,Wednesday
2022-07-13,China Ferry Terminal,0,0,0,0,0,0,0,0,Wednesday
2022-07-13,Harbour Control,0,0,0,0,0,0,0,0,Wednesday
2022-07-13,Kai Tak Cruise Terminal,0,0,0,0,0,0,0,0,Wednesday
2022-07-13,Macau Ferry Terminal,0,0,0,0,0,0,0,0,Wednesday
2022-07-13,Total,3295,1450,235,4980,3596,1249,156,5001,Wednesday
2022-07-15,Airport,2878,1437,225,4540,4080,599,185,4864,Friday
2022-07-15,Express Rail Link West Kowloon,0,0,0,0,0,0,0,0,Friday
2022-07-15,Hung Hom,0,0,0,0,0,0,0,0,Friday
2022-07-15,Lo Wu,0,0,0,0,0,0,0,0,Friday
2022-07-15,Lok Ma Chau Spur Line,0,0,0,0,0,0,0,0,Friday
2022-07-15,Heung Yuen Wai,0,0,0,0,0,0,0,0,Friday
2022-07-15,Hong Kong-Zhuhai-Macao Bridge,131,8,58,197,108,64,6,178,Friday
2022-07-15,Lok Ma Chau,0,0,0,0,0,0,0,0,Friday
2022-07-15,Man Kam To,0,0,0,0,0,0,0,0,Friday
2022-07-15,Sha Tau Kok,0,0,0,0,0,0,0,0,Friday
2022-07-15,Shenzhen Bay,1200,205,34,1439,1268,642,18,1928,Friday
2022-07-15,China Ferry Terminal,0,0,0,0,0,0,0,0,Friday
2022-07-15,Harbour Control,0,0,0,0,0,0,0,0,Friday
2022-07-15,Kai Tak Cruise Terminal,0,0,0,0,0,0,0,0,Friday
2022-07-15,Macau Ferry Terminal,0,0,0,0,0,0,0,0,Friday
2022-07-15,Total,4209,1650,317,6176,5456,1305,209,6970,Friday
2022-07-16,Airport,2402,1070,164,3636,3574,685,275,4534,Saturday
2022-07-16,Express Rail Link West Kowloon,0,0,0,0,0,0,0,0,Saturday
2022-07-16,Hung Hom,0,0,0,0,0,0,0,0,Saturday
2022-07-16,Lo Wu,0,0,0,0,0,0,0,0,Saturday
2022-07-16,Heung Yuen Wai,0,0,0,0,0,0,0,0,Saturday
2022-07-16,Hong Kong-Zhuhai-Macao Bridge,104,9,78,191,64,33,3,100,Saturday
2022-07-16,Lok Ma Chau,0,0,0,0,0,0,0,0,Saturday
2022-07-16,Man Kam To,0,0,0,0,0,0,0,0,Saturday
2022-07-16,Sha Tau Kok,0,0,0,0,0,0,0,0,Saturday
2022-07-16,Shenzhen Bay,1082,258,39,1379,1549,407,8,1964,Saturday
2022-07-16,China Ferry Terminal,0,0,0,0,0,0,0,0,Saturday
2022-07-16,Harbour Control,0,0,0,0,0,0,0,0,Saturday
2022-07-16,Kai Tak Cruise Terminal,0,0,0,0,0,0,0,0,Saturday
2022-07-16,Macau Ferry Terminal,0,0,0,0,0,0,0,0,Saturday
2022-07-16,Total,3588,1337,281,5206,5187,1125,286,6598,Saturday
2022-07-17,Airport,4006,1073,191,5270,3976,609,187,4772,Sunday
2022-07-17,Express Rail Link West Kowloon,0,0,0,0,0,0,0,0,Sunday
2022-07-17,Hung Hom,0,0,0,0,0,0,0,0,Sunday
2022-07-17,Lo Wu,0,0,0,0,0,0,0,0,Sunday
2022-07-17,Lok Ma Chau Spur Line,0,0,0,0,0,0,0,0,Sunday
2022-07-17,Heung Yuen Wai,0,0,0,0,0,0,0,0,Sunday
2022-07-17,Hong Kong-Zhuhai-Macao Bridge,133,25,37,195,48,45,8,101,Sunday
2022-07-17,Lok Ma Chau,0,0,0,0,0,0,0,0,Sunday
2022-07-17,Man Kam To,0,0,0,0,0,0,0,0,Sunday
2022-07-17,Sha Tau Kok,0,0,0,0,0,0,0,0,Sunday
2022-07-17,Shenzhen Bay,1362,240,44,1646,1577,401,11,1989,Sunday
2022-07-17,China Ferry Terminal,0,0,0,0,0,0,0,0,Sunday
2022-07-17,Harbour Control,0,0,0,0,0,0,0,0,Sunday
2022-07-17,Kai Tak Cruise Terminal,0,0,0,0,0,0,0,0,Sunday
2022-07-17,Macau Ferry Terminal,0,0,0,0,0,0,0,0,Sunday
2022-07-17,Total,5501,1338,272,7111,5601,1055,206,6862,Sunday
2022-07-18,Airport,2475,1305,154,3934,2069,429,145,2643,Monday
2022-07-18,Express Rail Link West Kowloon,0,0,0,0,0,0,0,0,Monday
2022-07-18,Hung Hom,0,0,0,0,0,0,0,0,Monday
2022-07-18,Lo Wu,0,0,0,0,0,0,0,0,Monday
2022-07-18,Lok Ma Chau Spur Line,0,0,0,0,0,0,0,0,Monday
2022-07-18,Heung Yuen Wai,0,0,0,0,0,0,0,0,Monday
2022-07-18,Hong Kong-Zhuhai-Macao Bridge,139,8,33,180,103,29,12,144,Monday
2022-07-18,Lok Ma Chau,0,0,0,0,0,0,0,0,Monday
2022-07-18,Man Kam To,0,0,0,0,0,0,0,0,Monday
2022-07-18,Sha Tau Kok,0,0,0,0,0,0,0,0,Monday
2022-07-18,Shenzhen Bay,994,145,23,1162,1626,446,18,2090,Monday
2022-07-18,China Ferry Terminal,0,0,0,0,0,0,0,0,Monday
2022-07-18,Harbour Control,0,0,0,0,0,0,0,0,Monday
2022-07-18,Kai Tak Cruise Terminal,0,0,0,0,0,0,0,0,Monday
2022-07-18,Macau Ferry Terminal,0,0,0,0,0,0,0,0,Monday
2022-07-18,Total,3608,1458,210,5276,3798,904,175,4877,Monday
2022-07-19,Airport,2409,1015,178,3602,2945,660,151,3756,Tuesday
2022-07-19,Express Rail Link West Kowloon,0,0,0,0,0,0,0,0,Tuesday
2022-07-19,Hung Hom,0,0,0,0,0,0,0,0,Tuesday
2022-07-19,Lo Wu,0,0,0,0,0,0,0,0,Tuesday
2022-07-19,Lok Ma Chau Spur Line,0,0,0,0,0,0,0,0,Tuesday
2022-07-19,Heung Yuen Wai,0,0,0,0,0,0,0,0,Tuesday
2022-07-19,Hong Kong-Zhuhai-Macao Bridge,86,6,35,127,85,46,0,131,Tuesday
2022-07-19,Lok Ma Chau,0,0,0,0,0,0,0,0,Tuesday
2022-07-19,Man Kam To,0,0,0,0,0,0,0,0,Tuesday
2022-07-19,Sha Tau Kok,0,0,0,0,0,0,0,0,Tuesday
2022-07-19,Shenzhen Bay,1052,216,29,1297,1658,410,16,2084,Tuesday
2022-07-19,China Ferry Terminal,0,0,0,0,0,0,0,0,Tuesday
2022-07-19,Harbour Control,0,0,0,0,0,0,0,0,Tuesday
2022-07-19,Kai Tak Cruise Terminal,0,0,0,0,0,0,0,0,Tuesday
2022-07-19,Macau Ferry Terminal,0,0,0,0,0,0,0,0,Tuesday
2022-07-19,Total,3547,1237,242,5026,4688,1116,167,5971,Tuesday
2022-07-20,Airport,2278,1209,174,3661,2379,763,179,3321,Wednesday
2022-07-20,Express Rail Link West Kowloon,0,0,0,0,0,0,0,0,Wednesday
2022-07-20,Hung Hom,0,0,0,0,0,0,0,0,Wednesday
2022-07-20,Lo Wu,0,0,0,0,0,0,0,0,Wednesday
2022-07-20,Lok Ma Chau Spur Line,0,0,0,0,0,0,0,0,Wednesday
2022-07-20,Heung Yuen Wai,0,0,0,0,0,0,0,0,Wednesday
2022-07-20,Hong Kong-Zhuhai-Macao Bridge,114,12,48,174,116,32,8,156,Wednesday
2022-07-20,Lok Ma Chau,0,0,0,0,0,0,0,0,Wednesday
2022-07-20,Man Kam To,0,0,0,0,0,0,0,0,Wednesday
2022-07-20,Sha Tau Kok,0,0,0,0,0,0,0,0,Wednesday
2022-07-20,Shenzhen Bay,1400,235,34,1669,1765,478,15,2258,Wednesday
2022-07-20,China Ferry Terminal,0,0,0,0,0,0,0,0,Wednesday
2022-07-20,Harbour Control,0,0,0,0,0,0,0,0,Wednesday
2022-07-20,Kai Tak Cruise Terminal,0,0,0,0,0,0,0,0,Wednesday
2022-07-20,Macau Ferry Terminal,0,0,0,0,0,0,0,0,Wednesday
2022-07-20,Total,3792,1456,256,5504,4260,1273,202,5735,Wednesday
2022-07-21,Airport,2337,977,137,3451,2498,847,162,3507,Thursday
2022-07-21,Express Rail Link West Kowloon,0,0,0,0,0,0,0,0,Thursday
2022-07-21,Hung Hom,0,0,0,0,0,0,0,0,Thursday
2022-07-21,Lo Wu,0,0,0,0,0,0,0,0,Thursday
2022-07-21,Lok Ma Chau Spur Line,0,0,0,0,0,0,0,0,Thursday
2022-07-21,Heung Yuen Wai,0,0,0,0,0,0,0,0,Thursday
2022-07-21,Hong Kong-Zhuhai-Macao Bridge,79,12,55,146,89,33,4,126,Thursday
2022-07-21,Lok Ma Chau,0,0,0,0,0,0,0,0,Thursday
2022-07-21,Man Kam To,0,0,0,0,0,0,0,0,Thursday
2022-07-21,Sha Tau Kok,0,0,0,0,0,0,0,0,Thursday
2022-07-21,Shenzhen Bay,1010,188,16,1214,1644,406,8,2058,Thursday
2022-07-21,China Ferry Terminal,0,0,0,0,0,0,0,0,Thursday
2022-07-21,Harbour Control,0,0,0,0,0,0,0,0,Thursday
2022-07-21,Kai Tak Cruise Terminal,0,0,0,0,0,0,0,0,Thursday
2022-07-21,Macau Ferry Terminal,0,0,0,0,0,0,0,0,Thursday
2022-07-21,Total,3426,1177,208,4811,4231,1286,174,5691,Thursday
2022-07-22,Airport,3080,1134,196,4410,3757,1135,190,5082,Friday
2022-07-22,Express Rail Link West Kowloon,0,0,0,0,0,0,0,0,Friday
2022-07-22,Hung Hom,0,0,0,0,0,0,0,0,Friday
2022-07-22,Lok Ma Chau Spur Line,0,0,0,0,0,0,0,0,Friday
2022-07-22,Heung Yuen Wai,0,0,0,0,0,0,0,0,Friday
2022-07-22,Hong Kong-Zhuhai-Macao Bridge,106,17,37,160,106,31,9,146,Friday
2022-07-22,Lok Ma Chau,0,0,0,0,0,0,0,0,Friday
2022-07-22,Man Kam To,0,0,0,0,0,0,0,0,Friday
2022-07-22,Sha Tau Kok,0,0,0,0,0,0,0,0,Friday
2022-07-22,Shenzhen Bay,1055,160,27,1242,1711,449,17,2177,Friday
2022-07-22,China Ferry Terminal,0,0,0,0,0,0,0,0,Friday
2022-07-22,Harbour Control,0,0,0,0,0,0,0,0,Friday
2022-07-22,Kai Tak Cruise Terminal,0,0,0,0,0,0,0,0,Friday
2022-07-22,Macau Ferry Terminal,0,0,0,0,0,0,0,0,Friday
2022-07-22,Total,4241,1311,260,5812,5574,1615,216,7405,Friday
2022-07-23,Airport,2894,969,117,3980,3460,781,238,4479,Saturday
2022-07-23,Express Rail Link West Kowloon,0,0,0,0,0,0,0,0,Saturday
2022-07-23,Hung Hom,0,0,0,0,0,0,0,0,Saturday
2022-07-23,Lo Wu,0,0,0,0,0,0,0,0,Saturday
2022-07-23,Lok Ma Chau Spur Line,0,0,0,0,0,0,0,0,Saturday
2022-07-23,Heung Yuen Wai,0,0,0,0,0,0,0,0,Saturday
2022-07-23,Hong Kong-Zhuhai-Macao Bridge,76,13,73,162,138,82,1,221,Saturday
2022-07-23,Lok Ma Chau,0,0,0,0,0,0,0,0,Saturday
2022-07-23,Man Kam To,0,0,0,0,0,0,0,0,Saturday
2022-07-23,Sha Tau Kok,0,0,0,0,0,0,0,0,Saturday
2022-07-23,Shenzhen Bay,1063,189,31,1283,1758,435,16,2209,Saturday
2022-07-23,China Ferry Terminal,0,0,0,0,0,0,0,0,Saturday
2022-07-23,Harbour Control,0,0,0,0,0,0,0,0,Saturday
2022-07-23,Kai Tak Cruise Terminal,0,0,0,0,0,0,0,0,Saturday
2022-07-23,Macau Ferry Terminal,0,0,0,0,0,0,0,0,Saturday
2022-07-23,Total,4033,1171,221,5425,5356,1298,255,6909,Saturday
2022-07-25,Airport,3100,1394,173,4667,2046,801,162,3009,Monday
2022-07-25,Express Rail Link West Kowloon,0,0,0,0,0,0,0,0,Monday
2022-07-25,Hung Hom,0,0,0,0,0,0,0,0,Monday
2022-07-25,Lo Wu,0,0,0,0,0,0,0,0,Monday
2022-07-25,Lok Ma Chau Spur Line,0,0,0,0,0,0,0,0,Monday
2022-07-25,Heung Yuen Wai,0,0,0,0,0,0,0,0,Monday
2022-07-25,Hong Kong-Zhuhai-Macao Bridge,97,16,20,133,121,92,8,221,Monday
2022-07-25,Lok Ma Chau,0,0,0,0,0,0,0,0,Monday
2022-07-25,Man Kam To,0,0,0,0,0,0,0,0,Monday
2022-07-25,Sha Tau Kok,0,0,0,0,0,0,0,0,Monday
2022-07-25,Shenzhen Bay,1238,240,30,1508,1704,515,12,2231,Monday
2022-07-25,China Ferry Terminal,0,0,0,0,0,0,0,0,Monday
2022-07-25,Harbour Control,0,0,0,0,0,0,0,0,Monday
2022-07-25,Kai Tak Cruise Terminal,0,0,0,0,0,0,0,0,Monday
2022-07-25,Macau Ferry Terminal,0,0,0,0,0,0,0,0,Monday
2022-07-25,Total,4435,1650,223,6308,3871,1408,182,5461,Monday
2022-07-24,Airport,4883,1109,216,6208,3641,950,201,4792,Sunday
2022-07-24,Express Rail Link West Kowloon,0,0,0,0,0,0,0,0,Sunday
2022-07-24,Hung Hom,0,0,0,0,0,0,0,0,Sunday
2022-07-24,Lo Wu,0,0,0,0,0,0,0,0,Sunday
2022-07-24,Lok Ma Chau Spur Line,0,0,0,0,0,0,0,0,Sunday
2022-07-24,Heung Yuen Wai,0,0,0,0,0,0,0,0,Sunday
2022-07-24,Hong Kong-Zhuhai-Macao Bridge,107,8,53,168,140,92,13,245,Sunday
2022-07-24,Lok Ma Chau,0,0,0,0,0,0,0,0,Sunday
2022-07-24,Man Kam To,0,0,0,0,0,0,0,0,Sunday
2022-07-24,Sha Tau Kok,0,0,0,0,0,0,0,0,Sunday
2022-07-24,Shenzhen Bay,1321,241,34,1596,1631,433,16,2080,Sunday
2022-07-24,China Ferry Terminal,0,0,0,0,0,0,0,0,Sunday
2022-07-24,Harbour Control,0,0,0,0,0,0,0,0,Sunday
2022-07-24,Kai Tak Cruise Terminal,0,0,0,0,0,0,0,0,Sunday
2022-07-24,Macau Ferry Terminal,0,0,0,0,0,0,0,0,Sunday
2022-07-24,Total,6311,1358,303,7972,5412,1475,230,7117,Sunday
2022-07-26,Airport,2539,1130,155,3824,2591,744,177,3512,Tuesday
2022-07-26,Express Rail Link West Kowloon,0,0,0,0,0,0,0,0,Tuesday
2022-07-26,Hung Hom,0,0,0,0,0,0,0,0,Tuesday
2022-07-26,Lo Wu,0,0,0,0,0,0,0,0,Tuesday
2022-07-26,Lok Ma Chau Spur Line,0,0,0,0,0,0,0,0,Tuesday
2022-07-26,Heung Yuen Wai,0,0,0,0,0,0,0,0,Tuesday
2022-07-26,Hong Kong-Zhuhai-Macao Bridge,100,4,27,131,146,84,13,243,Tuesday
2022-07-26,Lok Ma Chau,0,0,0,0,0,0,0,0,Tuesday
2022-07-26,Man Kam To,0,0,0,0,0,0,0,0,Tuesday
2022-07-26,Sha Tau Kok,0,0,0,0,0,0,0,0,Tuesday
2022-07-26,Shenzhen Bay,962,177,38,1177,1670,449,14,2133,Tuesday
2022-07-26,China Ferry Terminal,0,0,0,0,0,0,0,0,Tuesday
2022-07-26,Harbour Control,0,0,0,0,0,0,0,0,Tuesday
2022-07-26,Kai Tak Cruise Terminal,0,0,0,0,0,0,0,0,Tuesday
2022-07-26,Macau Ferry Terminal,0,0,0,0,0,0,0,0,Tuesday
2022-07-26,Total,3601,1311,220,5132,4407,1277,204,5888,Tuesday
2022-07-27,Airport,2369,1228,207,3804,2311,822,142,3275,Wednesday
2022-07-27,Express Rail Link West Kowloon,0,0,0,0,0,0,0,0,Wednesday
2022-07-27,Hung Hom,0,0,0,0,0,0,0,0,Wednesday
2022-07-27,Lo Wu,0,0,0,0,0,0,0,0,Wednesday
2022-07-27,Lok Ma Chau Spur Line,0,0,0,0,0,0,0,0,Wednesday
2022-07-27,Heung Yuen Wai,0,0,0,0,0,0,0,0,Wednesday
2022-07-27,Hong Kong-Zhuhai-Macao Bridge,98,8,31,137,159,84,9,252,Wednesday
2022-07-27,Lok Ma Chau,0,0,0,0,0,0,0,0,Wednesday
2022-07-27,Man Kam To,0,0,0,0,0,0,0,0,Wednesday
2022-07-27,Sha Tau Kok,0,0,0,0,0,0,0,0,Wednesday
2022-07-27,Shenzhen Bay,1026,161,26,1213,1637,535,19,2191,Wednesday
2022-07-27,China Ferry Terminal,0,0,0,0,0,0,0,0,Wednesday
2022-07-27,Harbour Control,0,0,0,0,0,0,0,0,Wednesday
2022-07-27,Kai Tak Cruise Terminal,0,0,0,0,0,0,0,0,Wednesday
2022-07-27,Macau Ferry Terminal,0,0,0,0,0,0,0,0,Wednesday
2022-07-27,Total,3493,1397,264,5154,4107,1441,170,5718,Wednesday
2022-07-28,Airport,2343,1090,157,3590,2793,740,180,3713,Thursday
2022-07-28,Express Rail Link West Kowloon,0,0,0,0,0,0,0,0,Thursday
2022-07-28,Hung Hom,0,0,0,0,0,0,0,0,Thursday
2022-07-28,Lo Wu,0,0,0,0,0,0,0,0,Thursday
2022-07-28,Lok Ma Chau Spur Line,0,0,0,0,0,0,0,0,Thursday
2022-07-28,Heung Yuen Wai,0,0,0,0,0,0,0,0,Thursday
2022-07-28,Hong Kong-Zhuhai-Macao Bridge,103,11,29,143,141,77,14,232,Thursday
2022-07-28,Lok Ma Chau,0,0,0,0,0,0,0,0,Thursday
2022-07-28,Man Kam To,0,0,0,0,0,0,0,0,Thursday
2022-07-28,Sha Tau Kok,0,0,0,0,0,0,0,0,Thursday
2022-07-28,Shenzhen Bay,1189,220,29,1438,1685,453,14,2152,Thursday
2022-07-28,China Ferry Terminal,0,0,0,0,0,0,0,0,Thursday
2022-07-28,Harbour Control,0,0,0,0,0,0,0,0,Thursday
2022-07-28,Kai Tak Cruise Terminal,0,0,0,0,0,0,0,0,Thursday
2022-07-28,Macau Ferry Terminal,0,0,0,0,0,0,0,0,Thursday
2022-07-28,Total,3635,1321,215,5171,4619,1270,208,6097,Thursday
2022-07-29,Airport,2710,1216,176,4102,3884,992,199,5075,Friday
2022-07-29,Express Rail Link West Kowloon,0,0,0,0,0,0,0,0,Friday
2022-07-29,Hung Hom,0,0,0,0,0,0,0,0,Friday
2022-07-29,Lo Wu,0,0,0,0,0,0,0,0,Friday
2022-07-29,Lok Ma Chau Spur Line,0,0,0,0,0,0,0,0,Friday
2022-07-29,Heung Yuen Wai,0,0,0,0,0,0,0,0,Friday
2022-07-29,Hong Kong-Zhuhai-Macao Bridge,118,7,39,164,145,69,18,232,Friday
2022-07-29,Lok Ma Chau,0,0,0,0,0,0,0,0,Friday
2022-07-29,Man Kam To,0,0,0,0,0,0,0,0,Friday
2022-07-29,Sha Tau Kok,0,0,0,0,0,0,0,0,Friday
2022-07-29,Shenzhen Bay,1150,162,31,1343,1644,469,19,2132,Friday
2022-07-29,China Ferry Terminal,0,0,0,0,0,0,0,0,Friday
2022-07-29,Harbour Control,0,0,0,0,0,0,0,0,Friday
2022-07-29,Kai Tak Cruise Terminal,0,0,0,0,0,0,0,0,Friday
2022-07-29,Macau Ferry Terminal,0,0,0,0,0,0,0,0,Friday
2022-07-29,Total,3978,1385,246,5609,5673,1530,236,7439,Friday
2022-07-30,Airport,2751,1020,189,3960,3808,889,314,5011,Saturday
2022-07-30,Express Rail Link West Kowloon,0,0,0,0,0,0,0,0,Saturday
2022-07-30,Hung Hom,0,0,0,0,0,0,0,0,Saturday
2022-07-30,Lo Wu,0,0,0,0,0,0,0,0,Saturday
2022-07-30,Lok Ma Chau Spur Line,0,0,0,0,0,0,0,0,Saturday
2022-07-30,Heung Yuen Wai,0,0,0,0,0,0,0,0,Saturday
2022-07-30,Hong Kong-Zhuhai-Macao Bridge,123,12,91,226,185,55,16,256,Saturday
2022-07-30,Lok Ma Chau,0,0,0,0,0,0,0,0,Saturday
2022-07-30,Man Kam To,0,0,0,0,0,0,0,0,Saturday
2022-07-30,Sha Tau Kok,0,0,0,0,0,0,0,0,Saturday
2022-07-30,Shenzhen Bay,1300,207,26,1533,1703,499,19,2221,Saturday
2022-07-30,China Ferry Terminal,0,0,0,0,0,0,0,0,Saturday
2022-07-30,Harbour Control,0,0,0,0,0,0,0,0,Saturday
2022-07-30,Kai Tak Cruise Terminal,0,0,0,0,0,0,0,0,Saturday
2022-07-30,Macau Ferry Terminal,0,0,0,0,0,0,0,0,Saturday
2022-07-30,Total,4174,1239,306,5719,5696,1443,349,7488,Saturday
2022-07-31,Airport,3998,1033,158,5189,4269,967,222,5458,Sunday
2022-07-31,Express Rail Link West Kowloon,0,0,0,0,0,0,0,0,Sunday
2022-07-31,Hung Hom,0,0,0,0,0,0,0,0,Sunday
2022-07-31,Lo Wu,0,0,0,0,0,0,0,0,Sunday
2022-07-31,Lok Ma Chau Spur Line,0,0,0,0,0,0,0,0,Sunday
2022-07-31,Heung Yuen Wai,0,0,0,0,0,0,0,0,Sunday
2022-07-31,Hong Kong-Zhuhai-Macao Bridge,154,12,39,205,153,63,14,230,Sunday
2022-07-31,Lok Ma Chau,0,0,0,0,0,0,0,0,Sunday
2022-07-31,Man Kam To,0,0,0,0,0,0,0,0,Sunday
2022-07-31,Sha Tau Kok,0,0,0,0,0,0,0,0,Sunday
2022-07-31,Shenzhen Bay,1671,225,45,1941,1629,471,15,2115,Sunday
2022-07-31,China Ferry Terminal,0,0,0,0,0,0,0,0,Sunday
2022-07-31,Harbour Control,0,0,0,0,0,0,0,0,Sunday
2022-07-31,Kai Tak Cruise Terminal,0,0,0,0,0,0,0,0,Sunday
2022-07-31,Macau Ferry Terminal,0,0,0,0,0,0,0,0,Sunday
2022-07-31,Total,5823,1270,242,7335,6051,1501,251,7803,Sunday
2022-08-01,Airport,4229,1225,276,5730,2647,685,142,3474,Monday
2022-08-01,Express Rail Link West Kowloon,0,0,0,0,0,0,0,0,Monday
2022-08-01,Hung Hom,0,0,0,0,0,0,0,0,Monday
2022-08-01,Lo Wu,0,0,0,0,0,0,0,0,Monday
2022-08-01,Lok Ma Chau Spur Line,0,0,0,0,0,0,0,0,Monday
2022-08-01,Heung Yuen Wai,0,0,0,0,0,0,0,0,Monday
2022-08-01,Hong Kong-Zhuhai-Macao Bridge,114,19,25,158,202,141,14,357,Monday
2022-08-01,Lok Ma Chau,0,0,0,0,0,0,0,0,Monday
2022-08-01,Man Kam To,0,0,0,0,0,0,0,0,Monday
2022-08-01,Sha Tau Kok,0,0,0,0,0,0,0,0,Monday
2022-08-01,Shenzhen Bay,1181,145,39,1365,1627,425,24,2076,Monday
2022-08-01,China Ferry Terminal,0,0,0,0,0,0,0,0,Monday
2022-08-01,Harbour Control,0,0,0,0,0,0,0,0,Monday
2022-08-01,Kai Tak Cruise Terminal,0,0,0,0,0,0,0,0,Monday
2022-08-01,Macau Ferry Terminal,0,0,0,0,0,0,0,0,Monday
2022-08-01,Total,5524,1389,340,7253,4476,1251,180,5907,Monday
2022-08-02,Airport,3537,729,187,4453,3420,813,166,4399,Tuesday
2022-08-02,Express Rail Link West Kowloon,0,0,0,0,0,0,0,0,Tuesday
2022-08-02,Hung Hom,0,0,0,0,0,0,0,0,Tuesday
2022-08-02,Lo Wu,0,0,0,0,0,0,0,0,Tuesday
2022-08-02,Lok Ma Chau Spur Line,0,0,0,0,0,0,0,0,Tuesday
2022-08-02,Heung Yuen Wai,0,0,0,0,0,0,0,0,Tuesday
2022-08-02,Hong Kong-Zhuhai-Macao Bridge,102,17,27,146,238,123,12,373,Tuesday
2022-08-02,Lok Ma Chau,0,0,0,0,0,0,0,0,Tuesday
2022-08-02,Man Kam To,0,0,0,0,0,0,0,0,Tuesday
2022-08-02,Sha Tau Kok,0,0,0,0,0,0,0,0,Tuesday
2022-08-02,Shenzhen Bay,1095,182,7,1284,1633,455,14,2102,Tuesday
2022-08-02,China Ferry Terminal,0,0,0,0,0,0,0,0,Tuesday
2022-08-02,Harbour Control,0,0,0,0,0,0,0,0,Tuesday
2022-08-02,Kai Tak Cruise Terminal,0,0,0,0,0,0,0,0,Tuesday
2022-08-02,Macau Ferry Terminal,0,0,0,0,0,0,0,0,Tuesday
2022-08-02,Total,4734,928,221,5883,5291,1391,192,6874,Tuesday
2022-08-03,Airport,3388,1240,205,4833,2700,623,199,3522,Wednesday
2022-08-03,Express Rail Link West Kowloon,0,0,0,0,0,0,0,0,Wednesday
2022-08-03,Hung Hom,0,0,0,0,0,0,0,0,Wednesday
2022-08-03,Lo Wu,0,0,0,0,0,0,0,0,Wednesday
2022-08-03,Lok Ma Chau Spur Line,0,0,0,0,0,0,0,0,Wednesday
2022-08-03,Heung Yuen Wai,0,0,0,0,0,0,0,0,Wednesday
2022-08-03,Hong Kong-Zhuhai-Macao Bridge,113,10,39,162,256,143,14,413,Wednesday
2022-08-03,Lok Ma Chau,0,0,0,0,0,0,0,0,Wednesday
2022-08-03,Man Kam To,0,0,0,0,0,0,0,0,Wednesday
2022-08-03,Sha Tau Kok,0,0,0,0,0,0,0,0,Wednesday
2022-08-03,Shenzhen Bay,1263,165,23,1451,1854,446,21,2321,Wednesday
2022-08-03,China Ferry Terminal,0,0,0,0,0,0,0,0,Wednesday
2022-08-03,Harbour Control,0,0,0,0,0,0,0,0,Wednesday
2022-08-03,Kai Tak Cruise Terminal,0,0,0,0,0,0,0,0,Wednesday
2022-08-03,Macau Ferry Terminal,0,0,0,0,0,0,0,0,Wednesday
2022-08-03,Total,4764,1415,267,6446,4810,1212,234,6256,Wednesday
2022-08-05,Airport,3646,1167,238,5051,3875,948,203,5026,Friday
2022-08-05,Express Rail Link West Kowloon,0,0,0,0,0,0,0,0,Friday
2022-08-05,Hung Hom,0,0,0,0,0,0,0,0,Friday
2022-08-05,Lo Wu,0,0,0,0,0,0,0,0,Friday
2022-08-05,Lok Ma Chau Spur Line,0,0,0,0,0,0,0,0,Friday
2022-08-05,Heung Yuen Wai,0,0,0,0,0,0,0,0,Friday
2022-08-05,Hong Kong-Zhuhai-Macao Bridge,121,21,30,172,244,111,14,369,Friday
2022-08-05,Lok Ma Chau,0,0,0,0,0,0,0,0,Friday
2022-08-05,Man Kam To,0,0,0,0,0,0,0,0,Friday
2022-08-05,Sha Tau Kok,0,0,0,0,0,0,0,0,Friday
2022-08-05,Shenzhen Bay,1314,202,23,1539,1804,447,24,2275,Friday
2022-08-05,China Ferry Terminal,0,0,0,0,0,0,0,0,Friday
2022-08-05,Harbour Control,0,0,0,0,0,0,0,0,Friday
2022-08-05,Kai Tak Cruise Terminal,0,0,0,0,0,0,0,0,Friday
2022-08-05,Macau Ferry Terminal,0,0,0,0,0,0,0,0,Friday
2022-08-05,Total,5081,1390,291,6762,5923,1506,241,7670,Friday
2022-08-04,Airport,2898,833,162,3893,3040,865,214,4119,Thursday
2022-08-04,Express Rail Link West Kowloon,0,0,0,0,0,0,0,0,Thursday
2022-08-04,Hung Hom,0,0,0,0,0,0,0,0,Thursday
2022-08-04,Lo Wu,0,0,0,0,0,0,0,0,Thursday
2022-08-04,Lok Ma Chau Spur Line,0,0,0,0,0,0,0,0,Thursday
2022-08-04,Heung Yuen Wai,0,0,0,0,0,0,0,0,Thursday
2022-08-04,Hong Kong-Zhuhai-Macao Bridge,116,11,30,157,234,128,12,374,Thursday
2022-08-04,Lok Ma Chau,0,0,0,0,0,0,0,0,Thursday
2022-08-04,Man Kam To,0,0,0,0,0,0,0,0,Thursday
2022-08-04,Sha Tau Kok,0,0,0,0,0,0,0,0,Thursday
2022-08-04,Shenzhen Bay,943,138,20,1101,1640,407,11,2058,Thursday
2022-08-04,China Ferry Terminal,0,0,0,0,0,0,0,0,Thursday
2022-08-04,Harbour Control,0,0,0,0,0,0,0,0,Thursday
2022-08-04,Kai Tak Cruise Terminal,0,0,0,0,0,0,0,0,Thursday
2022-08-04,Macau Ferry Terminal,0,0,0,0,0,0,0,0,Thursday
2022-08-04,Total,3957,982,212,5151,4914,1400,237,6551,Thursday
2022-08-06,Airport,3363,975,172,4510,3632,828,266,4726,Saturday
2022-08-06,Express Rail Link West Kowloon,0,0,0,0,0,0,0,0,Saturday
2022-08-06,Hung Hom,0,0,0,0,0,0,0,0,Saturday
2022-08-06,Lo Wu,0,0,0,0,0,0,0,0,Saturday
2022-08-06,Lok Ma Chau Spur Line,0,0,0,0,0,0,0,0,Saturday
2022-08-06,Heung Yuen Wai,0,0,0,0,0,0,0,0,Saturday
2022-08-06,Hong Kong-Zhuhai-Macao Bridge,129,24,82,235,286,131,18,435,Saturday
2022-08-06,Lok Ma Chau,0,0,0,0,0,0,0,0,Saturday
2022-08-06,Man Kam To,0,0,0,0,0,0,0,0,Saturday
2022-08-06,Sha Tau Kok,0,0,0,0,0,0,0,0,Saturday
2022-08-06,Shenzhen Bay,1352,271,24,1647,1872,490,15,2377,Saturday
2022-08-06,China Ferry Terminal,0,0,0,0,0,0,0,0,Saturday
2022-08-06,Harbour Control,0,0,0,0,0,0,0,0,Saturday
2022-08-06,Kai Tak Cruise Terminal,0,0,0,0,0,0,0,0,Saturday
2022-08-06,Macau Ferry Terminal,0,0,0,0,0,0,0,0,Saturday
2022-08-06,Total,4844,1270,278,6392,5790,1449,299,7538,Saturday
2022-08-07,Airport,5064,806,217,6087,4150,871,205,5226,Sunday
2022-08-07,Express Rail Link West Kowloon,0,0,0,0,0,0,0,0,Sunday
2022-08-07,Hung Hom,0,0,0,0,0,0,0,0,Sunday
2022-08-07,Lo Wu,0,0,0,0,0,0,0,0,Sunday
2022-08-07,Lok Ma Chau Spur Line,0,0,0,0,0,0,0,0,Sunday
2022-08-07,Heung Yuen Wai,0,0,0,0,0,0,0,0,Sunday
2022-08-07,Hong Kong-Zhuhai-Macao Bridge,164,17,26,207,235,139,14,388,Sunday
2022-08-07,Lok Ma Chau,0,0,0,0,0,0,0,0,Sunday
2022-08-07,Man Kam To,0,0,0,0,0,0,0,0,Sunday
2022-08-07,Sha Tau Kok,0,0,0,0,0,0,0,0,Sunday
2022-08-07,Shenzhen Bay,1584,215,20,1819,1747,401,16,2164,Sunday
2022-08-07,China Ferry Terminal,0,0,0,0,0,0,0,0,Sunday
2022-08-07,Harbour Control,0,0,0,0,0,0,0,0,Sunday
2022-08-07,Kai Tak Cruise Terminal,0,0,0,0,0,0,0,0,Sunday
2022-08-07,Macau Ferry Terminal,0,0,0,0,0,0,0,0,Sunday
2022-08-07,Total,6812,1038,263,8113,6132,1411,235,7778,Sunday
2022-08-08,Airport,3962,1203,238,5403,2501,805,170,3476,Monday
2022-08-08,Express Rail Link West Kowloon,0,0,0,0,0,0,0,0,Monday
2022-08-08,Hung Hom,0,0,0,0,0,0,0,0,Monday
2022-08-08,Lo Wu,0,0,0,0,0,0,0,0,Monday
2022-08-08,Lok Ma Chau Spur Line,0,0,0,0,0,0,0,0,Monday
2022-08-08,Heung Yuen Wai,0,0,0,0,0,0,0,0,Monday
2022-08-08,Hong Kong-Zhuhai-Macao Bridge,114,19,28,161,249,158,15,422,Monday
2022-08-08,Lok Ma Chau,0,0,0,0,0,0,0,0,Monday
2022-08-08,Man Kam To,0,0,0,0,0,0,0,0,Monday
2022-08-08,Sha Tau Kok,0,0,0,0,0,0,0,0,Monday
2022-08-08,Shenzhen Bay,1253,154,23,1430,1687,451,17,2155,Monday
2022-08-08,China Ferry Terminal,0,0,0,0,0,0,0,0,Monday
2022-08-08,Harbour Control,0,0,0,0,0,0,0,0,Monday
2022-08-08,Kai Tak Cruise Terminal,0,0,0,0,0,0,0,0,Monday
2022-08-08,Macau Ferry Terminal,0,0,0,0,0,0,0,0,Monday
2022-08-08,Total,5329,1376,289,6994,4437,1414,202,6053,Monday
2022-08-09,Airport,3783,1096,234,5113,3356,704,247,4307,Tuesday
2022-08-09,Express Rail Link West Kowloon,0,0,0,0,0,0,0,0,Tuesday
2022-08-09,Hung Hom,0,0,0,0,0,0,0,0,Tuesday
2022-08-09,Lo Wu,0,0,0,0,0,0,0,0,Tuesday
2022-08-09,Lok Ma Chau Spur Line,0,0,0,0,0,0,0,0,Tuesday
2022-08-09,Heung Yuen Wai,0,0,0,0,0,0,0,0,Tuesday
2022-08-09,Hong Kong-Zhuhai-Macao Bridge,136,21,35,192,257,156,9,422,Tuesday
2022-08-09,Lok Ma Chau,0,0,0,0,0,0,0,0,Tuesday
2022-08-09,Man Kam To,0,0,0,0,0,0,0,0,Tuesday
2022-08-09,Sha Tau Kok,0,0,0,0,0,0,0,0,Tuesday
2022-08-09,Shenzhen Bay,1515,204,16,1735,1822,479,6,2307,Tuesday
2022-08-09,China Ferry Terminal,0,0,0,0,0,0,0,0,Tuesday
2022-08-09,Harbour Control,0,0,0,0,0,0,0,0,Tuesday
2022-08-09,Kai Tak Cruise Terminal,0,0,0,0,0,0,0,0,Tuesday
2022-08-09,Macau Ferry Terminal,0,0,0,0,0,0,0,0,Tuesday
2022-08-09,Total,5434,1321,285,7040,5435,1339,262,7036,Tuesday
2022-08-10,Airport,2824,1037,202,4063,2927,808,230,3965,Wednesday
2022-08-10,Express Rail Link West Kowloon,0,0,0,0,0,0,0,0,Wednesday
2022-08-10,Hung Hom,0,0,0,0,0,0,0,0,Wednesday
2022-08-10,Lo Wu,0,0,0,0,0,0,0,0,Wednesday
2022-08-10,Lok Ma Chau Spur Line,0,0,0,0,0,0,0,0,Wednesday
2022-08-10,Heung Yuen Wai,0,0,0,0,0,0,0,0,Wednesday
2022-08-10,Hong Kong-Zhuhai-Macao Bridge,128,18,22,168,315,104,14,433,Wednesday
2022-08-10,Lok Ma Chau,0,0,0,0,0,0,0,0,Wednesday
2022-08-10,Man Kam To,0,0,0,0,0,0,0,0,Wednesday
2022-08-10,Sha Tau Kok,0,0,0,0,0,0,0,0,Wednesday
2022-08-10,Shenzhen Bay,1635,464,79,2178,1822,392,26,2240,Wednesday
2022-08-10,China Ferry Terminal,0,0,0,0,0,0,0,0,Wednesday
2022-08-10,Harbour Control,0,0,0,0,0,0,0,0,Wednesday
2022-08-10,Kai Tak Cruise Terminal,0,0,0,0,0,0,0,0,Wednesday
2022-08-10,Macau Ferry Terminal,0,0,0,0,0,0,0,0,Wednesday
2022-08-10,Total,4587,1519,303,6409,5064,1304,270,6638,Wednesday
2022-08-11,Airport,3284,1176,244,4704,3274,963,232,4469,Thursday
2022-08-11,Express Rail Link West Kowloon,0,0,0,0,0,0,0,0,Thursday
2022-08-11,Hung Hom,0,0,0,0,0,0,0,0,Thursday
2022-08-11,Lo Wu,0,0,0,0,0,0,0,0,Thursday
2022-08-11,Lok Ma Chau Spur Line,0,0,0,0,0,0,0,0,Thursday
2022-08-11,Heung Yuen Wai,0,0,0,0,0,0,0,0,Thursday
2022-08-11,Hong Kong-Zhuhai-Macao Bridge,109,14,30,153,283,134,24,441,Thursday
2022-08-11,Lok Ma Chau,0,0,0,0,0,0,0,0,Thursday
2022-08-11,Man Kam To,0,0,0,0,0,0,0,0,Thursday
2022-08-11,Sha Tau Kok,0,0,0,0,0,0,0,0,Thursday
2022-08-11,Shenzhen Bay,1222,172,24,1418,1653,383,21,2057,Thursday
2022-08-11,China Ferry Terminal,0,0,0,0,0,0,0,0,Thursday
2022-08-11,Harbour Control,0,0,0,0,0,0,0,0,Thursday
2022-08-11,Kai Tak Cruise Terminal,0,0,0,0,0,0,0,0,Thursday
2022-08-11,Macau Ferry Terminal,0,0,0,0,0,0,0,0,Thursday
2022-08-11,Total,4615,1362,298,6275,5210,1480,277,6967,Thursday
2022-08-12,Airport,4351,1516,290,6157,4180,984,252,5416,Friday
2022-08-12,Express Rail Link West Kowloon,0,0,0,0,0,0,0,0,Friday
2022-08-12,Hung Hom,0,0,0,0,0,0,0,0,Friday
2022-08-12,Lo Wu,0,0,0,0,0,0,0,0,Friday
2022-08-12,Lok Ma Chau Spur Line,0,0,0,0,0,0,0,0,Friday
2022-08-12,Heung Yuen Wai,0,0,0,0,0,0,0,0,Friday
2022-08-12,Hong Kong-Zhuhai-Macao Bridge,162,14,28,204,316,92,21,429,Friday
2022-08-12,Lok Ma Chau,0,0,0,0,0,0,0,0,Friday
2022-08-12,Man Kam To,0,0,0,0,0,0,0,0,Friday
2022-08-12,Sha Tau Kok,0,0,0,0,0,0,0,0,Friday
2022-08-12,Shenzhen Bay,1517,203,27,1747,1781,428,28,2237,Friday
2022-08-12,China Ferry Terminal,0,0,0,0,0,0,0,0,Friday
2022-08-12,Harbour Control,0,0,0,0,0,0,0,0,Friday
2022-08-12,Kai Tak Cruise Terminal,0,0,0,0,0,0,0,0,Friday
2022-08-12,Macau Ferry Terminal,0,0,0,0,0,0,0,0,Friday
2022-08-12,Total,6030,1733,345,8108,6277,1504,301,8082,Friday
2022-08-13,Airport,3422,1136,227,4785,3595,822,344,4761,Saturday
2022-08-13,Express Rail Link West Kowloon,0,0,0,0,0,0,0,0,Saturday
2022-08-13,Hung Hom,0,0,0,0,0,0,0,0,Saturday
2022-08-13,Lo Wu,0,0,0,0,0,0,0,0,Saturday
2022-08-13,Lok Ma Chau Spur Line,0,0,0,0,0,0,0,0,Saturday
2022-08-13,Heung Yuen Wai,0,0,0,0,0,0,0,0,Saturday
2022-08-13,Hong Kong-Zhuhai-Macao Bridge,182,15,99,296,323,87,7,417,Saturday
2022-08-13,Lok Ma Chau,0,0,0,0,0,0,0,0,Saturday
2022-08-13,Man Kam To,0,0,0,0,0,0,0,0,Saturday
2022-08-13,Sha Tau Kok,0,0,0,0,0,0,0,0,Saturday
2022-08-13,Shenzhen Bay,1958,283,28,2269,1912,411,14,2337,Saturday
2022-08-13,China Ferry Terminal,0,0,0,0,0,0,0,0,Saturday
2022-08-13,Harbour Control,0,0,0,0,0,0,0,0,Saturday
2022-08-13,Kai Tak Cruise Terminal,0,0,0,0,0,0,0,0,Saturday
2022-08-13,Macau Ferry Terminal,0,0,0,0,0,0,0,0,Saturday
2022-08-13,Total,5562,1434,354,7350,5830,1320,365,7515,Saturday
2022-08-14,Airport,5840,1264,324,7428,4488,970,237,5695,Sunday
2022-08-14,Express Rail Link West Kowloon,0,0,0,0,0,0,0,0,Sunday
2022-08-14,Hung Hom,0,0,0,0,0,0,0,0,Sunday
2022-08-14,Lo Wu,0,0,0,0,0,0,0,0,Sunday
2022-08-14,Lok Ma Chau Spur Line,0,0,0,0,0,0,0,0,Sunday
2022-08-14,Heung Yuen Wai,0,0,0,0,0,0,0,0,Sunday
2022-08-14,Hong Kong-Zhuhai-Macao Bridge,219,22,45,286,302,117,16,435,Sunday
2022-08-14,Lok Ma Chau,0,0,0,0,0,0,0,0,Sunday
2022-08-14,Man Kam To,0,0,0,0,0,0,0,0,Sunday
2022-08-14,Sha Tau Kok,0,0,0,0,0,0,0,0,Sunday
2022-08-14,Shenzhen Bay,2378,288,18,2684,1725,397,23,2145,Sunday
2022-08-14,China Ferry Terminal,0,0,0,0,0,0,0,0,Sunday
2022-08-14,Harbour Control,0,0,0,0,0,0,0,0,Sunday
2022-08-14,Kai Tak Cruise Terminal,0,0,0,0,0,0,0,0,Sunday
2022-08-14,Macau Ferry Terminal,0,0,0,0,0,0,0,0,Sunday
2022-08-14,Total,8437,1574,387,10398,6515,1484,276,8275,Sunday
2022-08-15,Airport,4107,1257,280,5644,2494,555,168,3217,Monday
2022-08-15,Express Rail Link West Kowloon,0,0,0,0,0,0,0,0,Monday
2022-08-15,Hung Hom,0,0,0,0,0,0,0,0,Monday
2022-08-15,Lo Wu,0,0,0,0,0,0,0,0,Monday
2022-08-15,Lok Ma Chau Spur Line,0,0,0,0,0,0,0,0,Monday
2022-08-15,Heung Yuen Wai,0,0,0,0,0,0,0,0,Monday
2022-08-15,Hong Kong-Zhuhai-Macao Bridge,253,17,26,296,282,130,13,425,Monday
2022-08-15,Lok Ma Chau,0,0,0,0,0,0,0,0,Monday
2022-08-15,Man Kam To,0,0,0,0,0,0,0,0,Monday
2022-08-15,Sha Tau Kok,0,0,0,0,0,0,0,0,Monday
2022-08-15,Shenzhen Bay,2730,214,37,2981,1838,446,22,2306,Monday
2022-08-15,China Ferry Terminal,0,0,0,0,0,0,0,0,Monday
2022-08-15,Harbour Control,0,0,0,0,0,0,0,0,Monday
2022-08-15,Kai Tak Cruise Terminal,0,0,0,0,0,0,0,0,Monday
2022-08-15,Macau Ferry Terminal,0,0,0,0,0,0,0,0,Monday
2022-08-15,Total,7090,1488,343,8921,4614,1131,203,5948,Monday
2022-08-16,Airport,4742,1079,328,6149,3389,496,188,4073,Tuesday
2022-08-16,Express Rail Link West Kowloon,0,0,0,0,0,0,0,0,Tuesday
2022-08-16,Hung Hom,0,0,0,0,0,0,0,0,Tuesday
2022-08-16,Lo Wu,0,0,0,0,0,0,0,0,Tuesday
2022-08-16,Lok Ma Chau Spur Line,0,0,0,0,0,0,0,0,Tuesday
2022-08-16,Heung Yuen Wai,0,0,0,0,0,0,0,0,Tuesday
2022-08-16,Hong Kong-Zhuhai-Macao Bridge,241,18,33,292,252,150,20,422,Tuesday
2022-08-16,Lok Ma Chau,0,0,0,0,0,0,0,0,Tuesday
2022-08-16,Man Kam To,0,0,0,0,0,0,0,0,Tuesday
2022-08-16,Sha Tau Kok,0,0,0,0,0,0,0,0,Tuesday
2022-08-16,Shenzhen Bay,2251,254,21,2526,1759,423,30,2212,Tuesday
2022-08-16,China Ferry Terminal,0,0,0,0,0,0,0,0,Tuesday
2022-08-16,Harbour Control,0,0,0,0,0,0,0,0,Tuesday
2022-08-16,Kai Tak Cruise Terminal,0,0,0,0,0,0,0,0,Tuesday
2022-08-16,Macau Ferry Terminal,0,0,0,0,0,0,0,0,Tuesday
2022-08-16,Total,7234,1351,382,8967,5400,1069,238,6707,Tuesday
2022-08-17,Airport,3584,1459,308,5351,2868,677,238,3783,Wednesday
2022-08-17,Express Rail Link West Kowloon,0,0,0,0,0,0,0,0,Wednesday
2022-08-17,Hung Hom,0,0,0,0,0,0,0,0,Wednesday
2022-08-17,Lo Wu,0,0,0,0,0,0,0,0,Wednesday
2022-08-17,Lok Ma Chau Spur Line,0,0,0,0,0,0,0,0,Wednesday
2022-08-17,Heung Yuen Wai,0,0,0,0,0,0,0,0,Wednesday
2022-08-17,Hong Kong-Zhuhai-Macao Bridge,196,19,38,253,261,146,25,432,Wednesday
2022-08-17,Lok Ma Chau,0,0,0,0,0,0,0,0,Wednesday
2022-08-17,Man Kam To,0,0,0,0,0,0,0,0,Wednesday
2022-08-17,Sha Tau Kok,0,0,0,0,0,0,0,0,Wednesday
2022-08-17,Shenzhen Bay,1989,200,26,2215,1827,548,28,2403,Wednesday
2022-08-17,China Ferry Terminal,0,0,0,0,0,0,0,0,Wednesday
2022-08-17,Harbour Control,0,0,0,0,0,0,0,0,Wednesday
2022-08-17,Kai Tak Cruise Terminal,0,0,0,0,0,0,0,0,Wednesday
2022-08-17,Macau Ferry Terminal,0,0,0,0,0,0,0,0,Wednesday
2022-08-17,Total,5769,1678,372,7819,4956,1371,291,6618,Wednesday
2022-08-18,Airport,4356,1136,351,5843,3715,960,230,4905,Thursday
2022-08-18,Express Rail Link West Kowloon,0,0,0,0,0,0,0,0,Thursday
2022-08-18,Hung Hom,0,0,0,0,0,0,0,0,Thursday
2022-08-18,Lo Wu,0,0,0,0,0,0,0,0,Thursday
2022-08-18,Lok Ma Chau Spur Line,0,0,0,0,0,0,0,0,Thursday
2022-08-18,Heung Yuen Wai,0,0,0,0,0,0,0,0,Thursday
2022-08-18,Hong Kong-Zhuhai-Macao Bridge,258,20,28,306,274,140,6,420,Thursday
2022-08-18,Lok Ma Chau,0,0,0,0,0,0,0,0,Thursday
2022-08-18,Man Kam To,0,0,0,0,0,0,0,0,Thursday
2022-08-18,Sha Tau Kok,0,0,0,0,0,0,0,0,Thursday
2022-08-18,Shenzhen Bay,2490,266,11,2767,1638,477,34,2149,Thursday
2022-08-18,China Ferry Terminal,0,0,0,0,0,0,0,0,Thursday
2022-08-18,Harbour Control,0,0,0,0,0,0,0,0,Thursday
2022-08-18,Kai Tak Cruise Terminal,0,0,0,0,0,0,0,0,Thursday
2022-08-18,Macau Ferry Terminal,0,0,0,0,0,0,0,0,Thursday
2022-08-18,Total,7104,1422,390,8916,5627,1577,270,7474,Thursday
2022-08-19,Airport,4343,1327,362,6032,3957,1163,263,5383,Friday
2022-08-19,Express Rail Link West Kowloon,0,0,0,0,0,0,0,0,Friday
2022-08-19,Hung Hom,0,0,0,0,0,0,0,0,Friday
2022-08-19,Lo Wu,0,0,0,0,0,0,0,0,Friday
2022-08-19,Lok Ma Chau Spur Line,0,0,0,0,0,0,0,0,Friday
2022-08-19,Heung Yuen Wai,0,0,0,0,0,0,0,0,Friday
2022-08-19,Hong Kong-Zhuhai-Macao Bridge,219,27,23,269,270,153,10,433,Friday
2022-08-19,Lok Ma Chau,0,0,0,0,0,0,0,0,Friday
2022-08-19,Man Kam To,0,0,0,0,0,0,0,0,Friday
2022-08-19,Sha Tau Kok,0,0,0,0,0,0,0,0,Friday
2022-08-19,Shenzhen Bay,2354,281,17,2652,1570,557,24,2151,Friday
2022-08-19,China Ferry Terminal,0,0,0,0,0,0,0,0,Friday
2022-08-19,Harbour Control,0,0,0,0,0,0,0,0,Friday
2022-08-19,Kai Tak Cruise Terminal,0,0,0,0,0,0,0,0,Friday
2022-08-19,Macau Ferry Terminal,0,0,0,0,0,0,0,0,Friday
2022-08-19,Total,6916,1635,402,8953,5797,1873,297,7967,Friday
2022-08-21,Airport,6214,1382,367,7963,4233,914,270,5417,Sunday
2022-08-21,Express Rail Link West Kowloon,0,0,0,0,0,0,0,0,Sunday
2022-08-21,Hung Hom,0,0,0,0,0,0,0,0,Sunday
2022-08-21,Lo Wu,0,0,0,0,0,0,0,0,Sunday
2022-08-21,Lok Ma Chau Spur Line,0,0,0,0,0,0,0,0,Sunday
2022-08-21,Heung Yuen Wai,0,0,0,0,0,0,0,0,Sunday
2022-08-21,Hong Kong-Zhuhai-Macao Bridge,400,27,23,450,252,135,19,406,Sunday
2022-08-21,Lok Ma Chau,0,0,0,0,0,0,0,0,Sunday
2022-08-21,Man Kam To,0,0,0,0,0,0,0,0,Sunday
2022-08-21,Sha Tau Kok,0,0,0,0,0,0,0,0,Sunday
2022-08-21,Shenzhen Bay,3849,261,16,4126,1489,595,28,2112,Sunday
2022-08-21,China Ferry Terminal,0,0,0,0,0,0,0,0,Sunday
2022-08-21,Harbour Control,0,0,0,0,0,0,0,0,Sunday
2022-08-21,Kai Tak Cruise Terminal,0,0,0,0,0,0,0,0,Sunday
2022-08-21,Macau Ferry Terminal,0,0,0,0,0,0,0,0,Sunday
2022-08-21,Total,10463,1670,406,12539,5974,1644,317,7935,Sunday
2022-08-20,Airport,4218,1160,301,5679,4120,781,404,5305,Saturday
2022-08-20,Express Rail Link West Kowloon,0,0,0,0,0,0,0,0,Saturday
2022-08-20,Hung Hom,0,0,0,0,0,0,0,0,Saturday
2022-08-20,Lo Wu,0,0,0,0,0,0,0,0,Saturday
2022-08-20,Lok Ma Chau Spur Line,0,0,0,0,0,0,0,0,Saturday
2022-08-20,Heung Yuen Wai,0,0,0,0,0,0,0,0,Saturday
2022-08-20,Hong Kong-Zhuhai-Macao Bridge,346,35,97,478,277,109,24,410,Saturday
2022-08-20,Lok Ma Chau,0,0,0,0,0,0,0,0,Saturday
2022-08-20,Man Kam To,0,0,0,0,0,0,0,0,Saturday
2022-08-20,Sha Tau Kok,0,0,0,0,0,0,0,0,Saturday
2022-08-20,Shenzhen Bay,3220,266,22,3508,1681,590,36,2307,Saturday
2022-08-20,China Ferry Terminal,0,0,0,0,0,0,0,0,Saturday
2022-08-20,Harbour Control,0,0,0,0,0,0,0,0,Saturday
2022-08-20,Kai Tak Cruise Terminal,0,0,0,0,0,0,0,0,Saturday
2022-08-20,Macau Ferry Terminal,0,0,0,0,0,0,0,0,Saturday
2022-08-20,Total,7784,1461,420,9665,6078,1480,464,8022,Saturday
2022-08-22,Airport,4154,1196,333,5683,2562,698,206,3466,Monday
2022-08-22,Express Rail Link West Kowloon,0,0,0,0,0,0,0,0,Monday
2022-08-22,Hung Hom,0,0,0,0,0,0,0,0,Monday
2022-08-22,Lo Wu,0,0,0,0,0,0,0,0,Monday
2022-08-22,Lok Ma Chau Spur Line,0,0,0,0,0,0,0,0,Monday
2022-08-22,Heung Yuen Wai,0,0,0,0,0,0,0,0,Monday
2022-08-22,Hong Kong-Zhuhai-Macao Bridge,308,30,24,362,268,171,17,456,Monday
2022-08-22,Lok Ma Chau,0,0,0,0,0,0,0,0,Monday
2022-08-22,Man Kam To,0,0,0,0,0,0,0,0,Monday
2022-08-22,Sha Tau Kok,0,0,0,0,0,0,0,0,Monday
2022-08-22,Shenzhen Bay,3176,264,21,3461,1476,584,23,2083,Monday
2022-08-22,China Ferry Terminal,0,0,0,0,0,0,0,0,Monday
2022-08-22,Harbour Control,0,0,0,0,0,0,0,0,Monday
2022-08-22,Kai Tak Cruise Terminal,0,0,0,0,0,0,0,0,Monday
2022-08-22,Macau Ferry Terminal,0,0,0,0,0,0,0,0,Monday
2022-08-22,Total,7638,1490,378,9506,4306,1453,246,6005,Monday
2022-08-23,Airport,4794,1213,320,6327,3550,654,269,4473,Tuesday
2022-08-23,Express Rail Link West Kowloon,0,0,0,0,0,0,0,0,Tuesday
2022-08-23,Hung Hom,0,0,0,0,0,0,0,0,Tuesday
2022-08-23,Lo Wu,0,0,0,0,0,0,0,0,Tuesday
2022-08-23,Lok Ma Chau Spur Line,0,0,0,0,0,0,0,0,Tuesday
2022-08-23,Heung Yuen Wai,0,0,0,0,0,0,0,0,Tuesday
2022-08-23,Hong Kong-Zhuhai-Macao Bridge,319,23,40,382,259,164,29,452,Tuesday
2022-08-23,Lok Ma Chau,0,0,0,0,0,0,0,0,Tuesday
2022-08-23,Man Kam To,0,0,0,0,0,0,0,0,Tuesday
2022-08-23,Sha Tau Kok,0,0,0,0,0,0,0,0,Tuesday
2022-08-23,Shenzhen Bay,3174,315,22,3511,1488,622,47,2157,Tuesday
2022-08-23,China Ferry Terminal,0,0,0,0,0,0,0,0,Tuesday
2022-08-23,Harbour Control,0,0,0,0,0,0,0,0,Tuesday
2022-08-23,Kai Tak Cruise Terminal,0,0,0,0,0,0,0,0,Tuesday
2022-08-23,Macau Ferry Terminal,0,0,0,0,0,0,0,0,Tuesday
2022-08-23,Total,8287,1551,382,10220,5297,1440,345,7082,Tuesday
2022-08-24,Airport,4162,1094,293,5549,3349,1093,227,4669,Wednesday
2022-08-24,Express Rail Link West Kowloon,0,0,0,0,0,0,0,0,Wednesday
2022-08-24,Hung Hom,0,0,0,0,0,0,0,0,Wednesday
2022-08-24,Lo Wu,0,0,0,0,0,0,0,0,Wednesday
2022-08-24,Lok Ma Chau Spur Line,0,0,0,0,0,0,0,0,Wednesday
2022-08-24,Heung Yuen Wai,0,0,0,0,0,0,0,0,Wednesday
2022-08-24,Hong Kong-Zhuhai-Macao Bridge,316,104,35,455,219,186,25,430,Wednesday
2022-08-24,Lok Ma Chau,0,0,0,0,0,0,0,0,Wednesday
2022-08-24,Man Kam To,0,0,0,0,0,0,0,0,Wednesday
2022-08-24,Sha Tau Kok,0,0,0,0,0,0,0,0,Wednesday
2022-08-24,Shenzhen Bay,3412,548,25,3985,1470,649,45,2164,Wednesday
2022-08-24,China Ferry Terminal,0,0,0,0,0,0,0,0,Wednesday
2022-08-24,Harbour Control,0,0,0,0,0,0,0,0,Wednesday
2022-08-24,Kai Tak Cruise Terminal,0,0,0,0,0,0,0,0,Wednesday
2022-08-24,Macau Ferry Terminal,0,0,0,0,0,0,0,0,Wednesday
2022-08-24,Total,7890,1746,353,9989,5038,1928,297,7263,Wednesday
2022-08-25,Airport,2789,662,268,3719,2684,876,228,3788,Thursday
2022-08-25,Express Rail Link West Kowloon,0,0,0,0,0,0,0,0,Thursday
2022-08-25,Hung Hom,0,0,0,0,0,0,0,0,Thursday
2022-08-25,Lo Wu,0,0,0,0,0,0,0,0,Thursday
2022-08-25,Lok Ma Chau Spur Line,0,0,0,0,0,0,0,0,Thursday
2022-08-25,Heung Yuen Wai,0,0,0,0,0,0,0,0,Thursday
2022-08-25,Hong Kong-Zhuhai-Macao Bridge,90,7,13,110,146,145,15,306,Thursday
2022-08-25,Lok Ma Chau,0,0,0,0,0,0,0,0,Thursday
2022-08-25,Man Kam To,0,0,0,0,0,0,0,0,Thursday
2022-08-25,Sha Tau Kok,0,0,0,0,0,0,0,0,Thursday
2022-08-25,Shenzhen Bay,2389,446,30,2865,1326,574,48,1948,Thursday
2022-08-25,China Ferry Terminal,0,0,0,0,0,0,0,0,Thursday
2022-08-25,Harbour Control,0,0,0,0,0,0,0,0,Thursday
2022-08-25,Kai Tak Cruise Terminal,0,0,0,0,0,0,0,0,Thursday
2022-08-25,Macau Ferry Terminal,0,0,0,0,0,0,0,0,Thursday
2022-08-25,Total,5268,1115,311,6694,4156,1595,291,6042,Thursday
2022-08-26,Airport,4986,2439,521,7946,4393,1723,398,6514,Friday
2022-08-26,Express Rail Link West Kowloon,0,0,0,0,0,0,0,0,Friday
2022-08-26,Hung Hom,0,0,0,0,0,0,0,0,Friday
2022-08-26,Lo Wu,0,0,0,0,0,0,0,0,Friday
2022-08-26,Lok Ma Chau Spur Line,0,0,0,0,0,0,0,0,Friday
2022-08-26,Heung Yuen Wai,0,0,0,0,0,0,0,0,Friday
2022-08-26,Hong Kong-Zhuhai-Macao Bridge,351,35,28,414,235,149,15,399,Friday
2022-08-26,Lok Ma Chau,0,0,0,0,0,0,0,0,Friday
2022-09-19,Airport,2509,1318,325,4152,3057,937,251,4245,Monday
2022-08-26,Man Kam To,0,0,0,0,0,0,0,0,Friday
2022-08-26,Sha Tau Kok,0,0,0,0,0,0,0,0,Friday
2022-08-26,Shenzhen Bay,3806,362,39,4207,1434,625,47,2106,Friday
2022-08-26,China Ferry Terminal,0,0,0,0,0,0,0,0,Friday
2022-08-26,Harbour Control,0,0,0,0,0,0,0,0,Friday
2022-08-26,Kai Tak Cruise Terminal,0,0,0,0,0,0,0,0,Friday
2022-08-26,Macau Ferry Terminal,0,0,0,0,0,0,0,0,Friday
2022-08-26,Total,9143,2836,588,12567,6062,2497,460,9019,Friday
2022-08-27,Airport,3873,1480,283,5636,3891,943,369,5203,Saturday
2022-08-27,Express Rail Link West Kowloon,0,0,0,0,0,0,0,0,Saturday
2022-08-27,Hung Hom,0,0,0,0,0,0,0,0,Saturday
2022-08-27,Lo Wu,0,0,0,0,0,0,0,0,Saturday
2022-08-27,Lok Ma Chau Spur Line,0,0,0,0,0,0,0,0,Saturday
2022-08-27,Heung Yuen Wai,0,0,0,0,0,0,0,0,Saturday
2022-08-27,Hong Kong-Zhuhai-Macao Bridge,492,37,76,605,205,144,16,365,Saturday
2022-08-27,Lok Ma Chau,0,0,0,0,0,0,0,0,Saturday
2022-08-27,Man Kam To,0,0,0,0,0,0,0,0,Saturday
2022-08-27,Sha Tau Kok,0,0,0,0,0,0,0,0,Saturday
2022-08-27,Shenzhen Bay,4031,416,20,4467,1445,641,55,2141,Saturday
2022-08-27,China Ferry Terminal,0,0,0,0,0,0,0,0,Saturday
2022-08-27,Harbour Control,0,0,0,0,0,0,0,0,Saturday
2022-08-27,Kai Tak Cruise Terminal,0,0,0,0,0,0,0,0,Saturday
2022-08-27,Macau Ferry Terminal,0,0,0,0,0,0,0,0,Saturday
2022-08-27,Total,8396,1933,379,10708,5541,1728,440,7709,Saturday
2022-08-28,Airport,6121,1615,470,8206,4564,1278,319,6161,Sunday
2022-08-28,Express Rail Link West Kowloon,0,0,0,0,0,0,0,0,Sunday
2022-08-28,Hung Hom,0,0,0,0,0,0,0,0,Sunday
2022-08-28,Lo Wu,0,0,0,0,0,0,0,0,Sunday
2022-08-28,Lok Ma Chau Spur Line,0,0,0,0,0,0,0,0,Sunday
2022-08-28,Heung Yuen Wai,0,0,0,0,0,0,0,0,Sunday
2022-08-28,Hong Kong-Zhuhai-Macao Bridge,703,38,28,769,217,155,15,387,Sunday
2022-08-28,Lok Ma Chau,0,0,0,0,0,0,0,0,Sunday
2022-08-28,Man Kam To,0,0,0,0,0,0,0,0,Sunday
2022-08-28,Sha Tau Kok,0,0,0,0,0,0,0,0,Sunday
2022-08-28,Shenzhen Bay,4180,332,21,4533,1347,621,42,2010,Sunday
2022-08-28,China Ferry Terminal,0,0,0,0,0,0,0,0,Sunday
2022-08-28,Harbour Control,0,0,0,0,0,0,0,0,Sunday
2022-08-28,Kai Tak Cruise Terminal,0,0,0,0,0,0,0,0,Sunday
2022-08-28,Macau Ferry Terminal,0,0,0,0,0,0,0,0,Sunday
2022-08-28,Total,11004,1985,519,13508,6128,2054,376,8558,Sunday
2022-08-29,Airport,2914,1228,283,4425,2776,571,291,3638,Monday
2022-08-29,Express Rail Link West Kowloon,0,0,0,0,0,0,0,0,Monday
2022-08-29,Hung Hom,0,0,0,0,0,0,0,0,Monday
2022-08-29,Lo Wu,0,0,0,0,0,0,0,0,Monday
2022-08-29,Lok Ma Chau Spur Line,0,0,0,0,0,0,0,0,Monday
2022-08-29,Heung Yuen Wai,0,0,0,0,0,0,0,0,Monday
2022-08-29,Hong Kong-Zhuhai-Macao Bridge,552,25,30,607,188,185,19,392,Monday
2022-08-29,Lok Ma Chau,0,0,0,0,0,0,0,0,Monday
2022-08-29,Man Kam To,0,0,0,0,0,0,0,0,Monday
2022-08-29,Sha Tau Kok,0,0,0,0,0,0,0,0,Monday
2022-08-29,Shenzhen Bay,3663,450,31,4144,1366,626,38,2030,Monday
2022-08-29,China Ferry Terminal,0,0,0,0,0,0,0,0,Monday
2022-08-29,Harbour Control,0,0,0,0,0,0,0,0,Monday
2022-08-29,Kai Tak Cruise Terminal,0,0,0,0,0,0,0,0,Monday
2022-08-29,Macau Ferry Terminal,0,0,0,0,0,0,0,0,Monday
2022-08-29,Total,7129,1703,344,9176,4330,1382,348,6060,Monday
2022-08-30,Airport,3780,1785,425,5990,3959,1238,339,5536,Tuesday
2022-08-30,Express Rail Link West Kowloon,0,0,0,0,0,0,0,0,Tuesday
2022-08-30,Hung Hom,0,0,0,0,0,0,0,0,Tuesday
2022-08-30,Lo Wu,0,0,0,0,0,0,0,0,Tuesday
2022-08-30,Lok Ma Chau Spur Line,0,0,0,0,0,0,0,0,Tuesday
2022-08-30,Heung Yuen Wai,0,0,0,0,0,0,0,0,Tuesday
2022-08-30,Hong Kong-Zhuhai-Macao Bridge,498,41,24,563,197,178,25,400,Tuesday
2022-08-30,Lok Ma Chau,0,0,0,0,0,0,0,0,Tuesday
2022-08-30,Man Kam To,0,0,0,0,0,0,0,0,Tuesday
2022-08-30,Sha Tau Kok,0,0,0,0,0,0,0,0,Tuesday
2022-08-30,Shenzhen Bay,3533,521,20,4074,1439,643,51,2133,Tuesday
2022-08-30,China Ferry Terminal,0,0,0,0,0,0,0,0,Tuesday
2022-08-30,Harbour Control,0,0,0,0,0,0,0,0,Tuesday
2022-08-30,Kai Tak Cruise Terminal,0,0,0,0,0,0,0,0,Tuesday
2022-08-30,Macau Ferry Terminal,0,0,0,0,0,0,0,0,Tuesday
2022-08-30,Total,7811,2347,469,10627,5595,2059,415,8069,Tuesday
2022-08-31,Airport,3215,1302,302,4819,3088,997,286,4371,Wednesday
2022-08-31,Express Rail Link West Kowloon,0,0,0,0,0,0,0,0,Wednesday
2022-08-31,Hung Hom,0,0,0,0,0,0,0,0,Wednesday
2022-08-31,Lo Wu,0,0,0,0,0,0,0,0,Wednesday
2022-08-31,Lok Ma Chau Spur Line,0,0,0,0,0,0,0,0,Wednesday
2022-08-31,Heung Yuen Wai,0,0,0,0,0,0,0,0,Wednesday
2022-08-31,Hong Kong-Zhuhai-Macao Bridge,552,29,22,603,209,166,18,393,Wednesday
2022-08-31,Lok Ma Chau,0,0,0,0,0,0,0,0,Wednesday
2022-08-31,Man Kam To,0,0,0,0,0,0,0,0,Wednesday
2022-08-31,Sha Tau Kok,0,0,0,0,0,0,0,0,Wednesday
2022-08-31,Shenzhen Bay,3472,486,26,3984,1409,585,51,2045,Wednesday
2022-08-31,China Ferry Terminal,0,0,0,0,0,0,0,0,Wednesday
2022-08-31,Harbour Control,0,0,0,0,0,0,0,0,Wednesday
2022-08-31,Kai Tak Cruise Terminal,0,0,0,0,0,0,0,0,Wednesday
2022-08-31,Macau Ferry Terminal,0,0,0,0,0,0,0,0,Wednesday
2022-08-31,Total,7239,1817,350,9406,4706,1748,355,6809,Wednesday
2022-09-01,Airport,4258,1488,422,6168,3775,1154,315,5244,Thursday
2022-09-01,Express Rail Link West Kowloon,0,0,0,0,0,0,0,0,Thursday
2022-09-01,Hung Hom,0,0,0,0,0,0,0,0,Thursday
2022-09-01,Lo Wu,0,0,0,0,0,0,0,0,Thursday
2022-09-01,Lok Ma Chau Spur Line,0,0,0,0,0,0,0,0,Thursday
2022-09-01,Heung Yuen Wai,0,0,0,0,0,0,0,0,Thursday
2022-09-01,Hong Kong-Zhuhai-Macao Bridge,333,28,39,400,243,194,15,452,Thursday
2022-09-01,Lok Ma Chau,0,0,0,0,0,0,0,0,Thursday
2022-09-01,Man Kam To,0,0,0,0,0,0,0,0,Thursday
2022-09-01,Sha Tau Kok,0,0,0,0,0,0,0,0,Thursday
2022-09-01,Shenzhen Bay,3404,348,37,3789,1301,524,28,1853,Thursday
2022-09-01,China Ferry Terminal,0,0,0,0,0,0,0,0,Thursday
2022-09-01,Harbour Control,0,0,0,0,0,0,0,0,Thursday
2022-09-01,Kai Tak Cruise Terminal,0,0,0,0,0,0,0,0,Thursday
2022-09-01,Macau Ferry Terminal,0,0,0,0,0,0,0,0,Thursday
2022-09-01,Total,7995,1864,498,10357,5319,1872,358,7549,Thursday
2022-09-03,Airport,3196,1385,362,4943,4833,1089,395,6317,Saturday
2022-09-03,Express Rail Link West Kowloon,0,0,0,0,0,0,0,0,Saturday
2022-09-03,Hung Hom,0,0,0,0,0,0,0,0,Saturday
2022-09-03,Lo Wu,0,0,0,0,0,0,0,0,Saturday
2022-09-03,Lok Ma Chau Spur Line,0,0,0,0,0,0,0,0,Saturday
2022-09-03,Heung Yuen Wai,0,0,0,0,0,0,0,0,Saturday
2022-09-03,Hong Kong-Zhuhai-Macao Bridge,419,48,71,538,227,207,17,451,Saturday
2022-09-03,Lok Ma Chau,0,0,0,0,0,0,0,0,Saturday
2022-09-03,Man Kam To,0,0,0,0,0,0,0,0,Saturday
2022-09-03,Sha Tau Kok,0,0,0,0,0,0,0,0,Saturday
2022-09-03,Shenzhen Bay,2781,307,25,3113,1358,524,49,1931,Saturday
2022-09-03,China Ferry Terminal,0,0,0,0,0,0,0,0,Saturday
2022-09-03,Harbour Control,0,0,0,0,0,0,0,0,Saturday
2022-09-03,Kai Tak Cruise Terminal,0,0,0,0,0,0,0,0,Saturday
2022-09-03,Macau Ferry Terminal,0,0,0,0,0,0,0,0,Saturday
2022-09-03,Total,6396,1740,458,8594,6418,1820,461,8699,Saturday
2022-09-02,Airport,3596,1602,500,5698,4753,1430,454,6637,Friday
2022-09-02,Express Rail Link West Kowloon,0,0,0,0,0,0,0,0,Friday
2022-09-02,Hung Hom,0,0,0,0,0,0,0,0,Friday
2022-09-02,Lo Wu,0,0,0,0,0,0,0,0,Friday
2022-09-02,Lok Ma Chau Spur Line,0,0,0,0,0,0,0,0,Friday
2022-09-02,Heung Yuen Wai,0,0,0,0,0,0,0,0,Friday
2022-09-02,Hong Kong-Zhuhai-Macao Bridge,303,41,36,380,226,208,20,454,Friday
2022-09-02,Lok Ma Chau,0,0,0,0,0,0,0,0,Friday
2022-09-02,Man Kam To,0,0,0,0,0,0,0,0,Friday
2022-09-02,Sha Tau Kok,0,0,0,0,0,0,0,0,Friday
2022-09-02,Shenzhen Bay,2907,287,38,3232,1277,536,51,1864,Friday
2022-09-02,China Ferry Terminal,0,0,0,0,0,0,0,0,Friday
2022-09-02,Harbour Control,0,0,0,0,0,0,0,0,Friday
2022-09-02,Kai Tak Cruise Terminal,0,0,0,0,0,0,0,0,Friday
2022-09-02,Macau Ferry Terminal,0,0,0,0,0,0,0,0,Friday
2022-09-02,Total,6806,1930,574,9310,6256,2174,525,8955,Friday
2022-09-04,Airport,4859,1654,417,6930,5415,1424,369,7208,Sunday
2022-09-04,Express Rail Link West Kowloon,0,0,0,0,0,0,0,0,Sunday
2022-09-04,Hung Hom,0,0,0,0,0,0,0,0,Sunday
2022-09-04,Lo Wu,0,0,0,0,0,0,0,0,Sunday
2022-09-04,Lok Ma Chau Spur Line,0,0,0,0,0,0,0,0,Sunday
2022-09-04,Heung Yuen Wai,0,0,0,0,0,0,0,0,Sunday
2022-09-04,Hong Kong-Zhuhai-Macao Bridge,531,60,32,623,181,216,19,416,Sunday
2022-09-04,Lok Ma Chau,0,0,0,0,0,0,0,0,Sunday
2022-09-04,Man Kam To,0,0,0,0,0,0,0,0,Sunday
2022-09-04,Sha Tau Kok,0,0,0,0,0,0,0,0,Sunday
2022-09-04,Shenzhen Bay,2478,254,25,2757,1318,549,52,1919,Sunday
2022-09-04,China Ferry Terminal,0,0,0,0,0,0,0,0,Sunday
2022-09-04,Harbour Control,0,0,0,0,0,0,0,0,Sunday
2022-09-04,Kai Tak Cruise Terminal,0,0,0,0,0,0,0,0,Sunday
2022-09-04,Macau Ferry Terminal,0,0,0,0,0,0,0,0,Sunday
2022-09-04,Total,7868,1968,474,10310,6914,2189,440,9543,Sunday
2022-09-06,Airport,3878,1906,431,6215,4129,1350,345,5824,Tuesday
2022-09-06,Express Rail Link West Kowloon,0,0,0,0,0,0,0,0,Tuesday
2022-09-06,Hung Hom,0,0,0,0,0,0,0,0,Tuesday
2022-09-06,Lo Wu,0,0,0,0,0,0,0,0,Tuesday
2022-09-06,Lok Ma Chau Spur Line,0,0,0,0,0,0,0,0,Tuesday
2022-09-06,Heung Yuen Wai,0,0,0,0,0,0,0,0,Tuesday
2022-09-06,Hong Kong-Zhuhai-Macao Bridge,222,40,44,306,187,198,20,405,Tuesday
2022-09-06,Lok Ma Chau,0,0,0,0,0,0,0,0,Tuesday
2022-09-06,Man Kam To,0,0,0,0,0,0,0,0,Tuesday
2022-09-06,Sha Tau Kok,0,0,0,0,0,0,0,0,Tuesday
2022-09-06,Shenzhen Bay,1358,236,17,1611,1198,484,24,1706,Tuesday
2022-09-06,China Ferry Terminal,0,0,0,0,0,0,0,0,Tuesday
2022-09-06,Harbour Control,0,0,0,0,0,0,0,0,Tuesday
2022-09-06,Kai Tak Cruise Terminal,0,0,0,0,0,0,0,0,Tuesday
2022-09-06,Macau Ferry Terminal,0,0,0,0,0,0,0,0,Tuesday
2022-09-06,Total,5458,2182,492,8132,5514,2032,389,7935,Tuesday
2022-09-05,Airport,2593,1193,319,4105,3003,851,262,4116,Monday
2022-09-05,Express Rail Link West Kowloon,0,0,0,0,0,0,0,0,Monday
2022-09-05,Hung Hom,0,0,0,0,0,0,0,0,Monday
2022-09-05,Lo Wu,0,0,0,0,0,0,0,0,Monday
2022-09-05,Lok Ma Chau Spur Line,0,0,0,0,0,0,0,0,Monday
2022-09-05,Heung Yuen Wai,0,0,0,0,0,0,0,0,Monday
2022-09-05,Hong Kong-Zhuhai-Macao Bridge,274,67,39,380,225,228,11,464,Monday
2022-09-05,Lok Ma Chau,0,0,0,0,0,0,0,0,Monday
2022-09-05,Man Kam To,0,0,0,0,0,0,0,0,Monday
2022-09-05,Sha Tau Kok,0,0,0,0,0,0,0,0,Monday
2022-09-05,Shenzhen Bay,1566,181,28,1775,1227,506,52,1785,Monday
2022-09-05,China Ferry Terminal,0,0,0,0,0,0,0,0,Monday
2022-09-05,Harbour Control,0,0,0,0,0,0,0,0,Monday
2022-09-05,Kai Tak Cruise Terminal,0,0,0,0,0,0,0,0,Monday
2022-09-05,Macau Ferry Terminal,0,0,0,0,0,0,0,0,Monday
2022-09-05,Total,4433,1441,386,6260,4455,1585,325,6365,Monday
2022-09-07,Airport,3029,1367,365,4761,3281,975,346,4602,Wednesday
2022-09-07,Express Rail Link West Kowloon,0,0,0,0,0,0,0,0,Wednesday
2022-09-07,Hung Hom,0,0,0,0,0,0,0,0,Wednesday
2022-09-07,Lo Wu,0,0,0,0,0,0,0,0,Wednesday
2022-11-05,Airport,8684,1470,1410,11564,10327,1057,1398,12782,Saturday
2022-09-07,Lok Ma Chau Spur Line,0,0,0,0,0,0,0,0,Wednesday
2022-09-07,Heung Yuen Wai,0,0,0,0,0,0,0,0,Wednesday
2022-09-07,Hong Kong-Zhuhai-Macao Bridge,198,41,53,292,174,199,25,398,Wednesday
2022-09-07,Lok Ma Chau,0,0,0,0,0,0,0,0,Wednesday
2022-09-07,Man Kam To,0,0,0,0,0,0,0,0,Wednesday
2022-09-07,Sha Tau Kok,0,0,0,0,0,0,0,0,Wednesday
2022-09-07,Shenzhen Bay,1175,191,14,1380,1038,433,39,1510,Wednesday
2022-09-07,China Ferry Terminal,0,0,0,0,0,0,0,0,Wednesday
2022-09-07,Harbour Control,0,0,0,0,0,0,0,0,Wednesday
2022-09-07,Kai Tak Cruise Terminal,0,0,0,0,0,0,0,0,Wednesday
2022-09-07,Macau Ferry Terminal,0,0,0,0,0,0,0,0,Wednesday
2022-09-07,Total,4402,1599,432,6433,4493,1607,410,6510,Wednesday
2022-09-08,Airport,3274,1349,447,5070,3008,1214,248,4470,Thursday
2022-09-08,Express Rail Link West Kowloon,0,0,0,0,0,0,0,0,Thursday
2022-09-08,Hung Hom,0,0,0,0,0,0,0,0,Thursday
2022-09-08,Lo Wu,0,0,0,0,0,0,0,0,Thursday
2022-09-08,Lok Ma Chau Spur Line,0,0,0,0,0,0,0,0,Thursday
2022-09-08,Heung Yuen Wai,0,0,0,0,0,0,0,0,Thursday
2022-09-08,Hong Kong-Zhuhai-Macao Bridge,228,54,46,328,144,190,25,359,Thursday
2022-09-08,Lok Ma Chau,0,0,0,0,0,0,0,0,Thursday
2022-09-08,Man Kam To,0,0,0,0,0,0,0,0,Thursday
2022-09-08,Sha Tau Kok,0,0,0,0,0,0,0,0,Thursday
2022-09-08,Shenzhen Bay,1268,254,23,1545,1107,433,27,1567,Thursday
2022-09-08,China Ferry Terminal,0,0,0,0,0,0,0,0,Thursday
2022-09-08,Harbour Control,0,0,0,0,0,0,0,0,Thursday
2022-09-08,Kai Tak Cruise Terminal,0,0,0,0,0,0,0,0,Thursday
2022-09-08,Macau Ferry Terminal,0,0,0,0,0,0,0,0,Thursday
2022-09-08,Total,4770,1657,516,6943,4259,1837,300,6396,Thursday
2022-09-09,Airport,3773,1759,483,6015,4630,1437,412,6479,Friday
2022-09-09,Express Rail Link West Kowloon,0,0,0,0,0,0,0,0,Friday
2022-09-09,Hung Hom,0,0,0,0,0,0,0,0,Friday
2022-09-09,Lo Wu,0,0,0,0,0,0,0,0,Friday
2022-09-09,Lok Ma Chau Spur Line,0,0,0,0,0,0,0,0,Friday
2022-09-09,Heung Yuen Wai,0,0,0,0,0,0,0,0,Friday
2022-09-09,Hong Kong-Zhuhai-Macao Bridge,221,66,29,316,143,222,31,396,Friday
2022-09-09,Lok Ma Chau,0,0,0,0,0,0,0,0,Friday
2022-09-09,Man Kam To,0,0,0,0,0,0,0,0,Friday
2022-09-09,Sha Tau Kok,0,0,0,0,0,0,0,0,Friday
2022-09-09,Shenzhen Bay,1339,211,21,1571,1110,487,38,1635,Friday
2022-09-09,China Ferry Terminal,0,0,0,0,0,0,0,0,Friday
2022-09-09,Harbour Control,0,0,0,0,0,0,0,0,Friday
2022-09-09,Kai Tak Cruise Terminal,0,0,0,0,0,0,0,0,Friday
2022-09-09,Macau Ferry Terminal,0,0,0,0,0,0,0,0,Friday
2022-09-09,Total,5333,2036,533,7902,5883,2146,481,8510,Friday
2022-09-10,Airport,2439,1189,316,3944,3856,935,346,5137,Saturday
2022-09-10,Express Rail Link West Kowloon,0,0,0,0,0,0,0,0,Saturday
2022-09-10,Hung Hom,0,0,0,0,0,0,0,0,Saturday
2022-09-10,Lo Wu,0,0,0,0,0,0,0,0,Saturday
2022-09-10,Lok Ma Chau Spur Line,0,0,0,0,0,0,0,0,Saturday
2022-09-10,Heung Yuen Wai,0,0,0,0,0,0,0,0,Saturday
2022-09-10,Hong Kong-Zhuhai-Macao Bridge,146,41,71,258,131,182,18,331,Saturday
2022-09-10,Lok Ma Chau,0,0,0,0,0,0,0,0,Saturday
2022-09-10,Man Kam To,0,0,0,0,0,0,0,0,Saturday
2022-09-10,Sha Tau Kok,0,0,0,0,0,0,0,0,Saturday
2022-09-10,Shenzhen Bay,787,181,23,991,1020,531,29,1580,Saturday
2022-09-10,China Ferry Terminal,0,0,0,0,0,0,0,0,Saturday
2022-09-10,Harbour Control,0,0,0,0,0,0,0,0,Saturday
2022-09-10,Kai Tak Cruise Terminal,0,0,0,0,0,0,0,0,Saturday
2022-09-10,Macau Ferry Terminal,0,0,0,0,0,0,0,0,Saturday
2022-09-10,Total,3372,1411,410,5193,5007,1648,393,7048,Saturday
2022-09-11,Airport,4219,1447,452,6118,4860,1633,427,6920,Sunday
2022-09-11,Express Rail Link West Kowloon,0,0,0,0,0,0,0,0,Sunday
2022-09-11,Hung Hom,0,0,0,0,0,0,0,0,Sunday
2022-09-11,Lo Wu,0,0,0,0,0,0,0,0,Sunday
2022-09-11,Lok Ma Chau Spur Line,0,0,0,0,0,0,0,0,Sunday
2022-09-11,Heung Yuen Wai,0,0,0,0,0,0,0,0,Sunday
2022-09-11,Hong Kong-Zhuhai-Macao Bridge,251,44,24,319,193,180,16,389,Sunday
2022-09-11,Lok Ma Chau,0,0,0,0,0,0,0,0,Sunday
2022-09-11,Man Kam To,0,0,0,0,0,0,0,0,Sunday
2022-09-11,Sha Tau Kok,0,0,0,0,0,0,0,0,Sunday
2022-09-11,Shenzhen Bay,1688,299,20,2007,892,434,33,1359,Sunday
2022-09-11,China Ferry Terminal,0,0,0,0,0,0,0,0,Sunday
2022-09-11,Harbour Control,0,0,0,0,0,0,0,0,Sunday
2022-09-11,Kai Tak Cruise Terminal,0,0,0,0,0,0,0,0,Sunday
2022-09-11,Macau Ferry Terminal,0,0,0,0,0,0,0,0,Sunday
2022-09-11,Total,6158,1790,496,8444,5945,2247,476,8668,Sunday
2022-09-12,Airport,2750,1367,379,4496,3397,852,218,4467,Monday
2022-09-12,Express Rail Link West Kowloon,0,0,0,0,0,0,0,0,Monday
2022-09-12,Hung Hom,0,0,0,0,0,0,0,0,Monday
2022-09-12,Lo Wu,0,0,0,0,0,0,0,0,Monday
2022-09-12,Lok Ma Chau Spur Line,0,0,0,0,0,0,0,0,Monday
2022-09-12,Heung Yuen Wai,0,0,0,0,0,0,0,0,Monday
2022-09-12,Hong Kong-Zhuhai-Macao Bridge,301,62,25,388,223,213,20,456,Monday
2022-09-12,Lok Ma Chau,0,0,0,0,0,0,0,0,Monday
2022-09-12,Man Kam To,0,0,0,0,0,0,0,0,Monday
2022-09-12,Sha Tau Kok,0,0,0,0,0,0,0,0,Monday
2022-09-12,Shenzhen Bay,2122,330,20,2472,756,365,34,1155,Monday
2022-09-12,China Ferry Terminal,0,0,0,0,0,0,0,0,Monday
2022-09-12,Harbour Control,0,0,0,0,0,0,0,0,Monday
2022-09-12,Kai Tak Cruise Terminal,0,0,0,0,0,0,0,0,Monday
2022-09-12,Macau Ferry Terminal,0,0,0,0,0,0,0,0,Monday
2022-09-12,Total,5173,1759,424,7356,4376,1430,272,6078,Monday
2022-09-13,Airport,3542,1210,416,5168,4114,1430,290,5834,Tuesday
2022-09-13,Express Rail Link West Kowloon,0,0,0,0,0,0,0,0,Tuesday
2022-09-13,Hung Hom,0,0,0,0,0,0,0,0,Tuesday
2022-09-13,Lo Wu,0,0,0,0,0,0,0,0,Tuesday
2022-09-13,Lok Ma Chau Spur Line,0,0,0,0,0,0,0,0,Tuesday
2022-09-13,Heung Yuen Wai,0,0,0,0,0,0,0,0,Tuesday
2022-09-13,Hong Kong-Zhuhai-Macao Bridge,236,49,27,312,220,167,20,407,Tuesday
2022-09-13,Lok Ma Chau,0,0,0,0,0,0,0,0,Tuesday
2022-09-13,Man Kam To,0,0,0,0,0,0,0,0,Tuesday
2022-09-13,Sha Tau Kok,0,0,0,0,0,0,0,0,Tuesday
2022-09-13,Shenzhen Bay,1510,289,13,1812,927,347,34,1308,Tuesday
2022-09-13,China Ferry Terminal,0,0,0,0,0,0,0,0,Tuesday
2022-09-13,Harbour Control,0,0,0,0,0,0,0,0,Tuesday
2022-09-13,Kai Tak Cruise Terminal,0,0,0,0,0,0,0,0,Tuesday
2022-09-13,Macau Ferry Terminal,0,0,0,0,0,0,0,0,Tuesday
2022-09-13,Total,5288,1548,456,7292,5261,1944,344,7549,Tuesday
2022-09-15,Airport,3717,1242,502,5461,3529,1388,283,5200,Thursday
2022-09-15,Express Rail Link West Kowloon,0,0,0,0,0,0,0,0,Thursday
2022-09-15,Hung Hom,0,0,0,0,0,0,0,0,Thursday
2022-09-15,Lo Wu,0,0,0,0,0,0,0,0,Thursday
2022-09-15,Lok Ma Chau Spur Line,0,0,0,0,0,0,0,0,Thursday
2022-09-15,Heung Yuen Wai,0,0,0,0,0,0,0,0,Thursday
2022-09-15,Hong Kong-Zhuhai-Macao Bridge,202,61,24,287,226,189,20,435,Thursday
2022-09-15,Lok Ma Chau,0,0,0,0,0,0,0,0,Thursday
2022-09-15,Man Kam To,0,0,0,0,0,0,0,0,Thursday
2022-09-15,Sha Tau Kok,0,0,0,0,0,0,0,0,Thursday
2022-09-15,Shenzhen Bay,1544,268,24,1836,943,332,31,1306,Thursday
2022-09-15,China Ferry Terminal,0,0,0,0,0,0,0,0,Thursday
2022-09-15,Harbour Control,0,0,0,0,0,0,0,0,Thursday
2022-09-15,Kai Tak Cruise Terminal,0,0,0,0,0,0,0,0,Thursday
2022-09-15,Macau Ferry Terminal,0,0,0,0,0,0,0,0,Thursday
2022-09-15,Total,5463,1571,550,7584,4698,1909,334,6941,Thursday
2022-09-14,Airport,2752,1494,334,4580,3097,946,320,4363,Wednesday
2022-09-14,Express Rail Link West Kowloon,0,0,0,0,0,0,0,0,Wednesday
2022-09-14,Hung Hom,0,0,0,0,0,0,0,0,Wednesday
2022-09-14,Lo Wu,0,0,0,0,0,0,0,0,Wednesday
2022-09-14,Lok Ma Chau Spur Line,0,0,0,0,0,0,0,0,Wednesday
2022-09-14,Heung Yuen Wai,0,0,0,0,0,0,0,0,Wednesday
2022-09-14,Hong Kong-Zhuhai-Macao Bridge,182,53,35,270,228,171,23,422,Wednesday
2022-09-14,Lok Ma Chau,0,0,0,0,0,0,0,0,Wednesday
2022-09-14,Man Kam To,0,0,0,0,0,0,0,0,Wednesday
2022-09-14,Sha Tau Kok,0,0,0,0,0,0,0,0,Wednesday
2022-09-14,Shenzhen Bay,1350,260,24,1634,774,353,29,1156,Wednesday
2022-09-14,China Ferry Terminal,0,0,0,0,0,0,0,0,Wednesday
2022-09-14,Harbour Control,0,0,0,0,0,0,0,0,Wednesday
2022-09-14,Kai Tak Cruise Terminal,0,0,0,0,0,0,0,0,Wednesday
2022-09-14,Macau Ferry Terminal,0,0,0,0,0,0,0,0,Wednesday
2022-09-14,Total,4284,1807,393,6484,4099,1470,372,5941,Wednesday
2022-09-16,Airport,3439,1504,492,5435,4675,1631,470,6776,Friday
2022-09-16,Express Rail Link West Kowloon,0,0,0,0,0,0,0,0,Friday
2022-09-16,Hung Hom,0,0,0,0,0,0,0,0,Friday
2022-09-16,Lo Wu,0,0,0,0,0,0,0,0,Friday
2022-09-16,Lok Ma Chau Spur Line,0,0,0,0,0,0,0,0,Friday
2022-09-16,Heung Yuen Wai,0,0,0,0,0,0,0,0,Friday
2022-09-16,Hong Kong-Zhuhai-Macao Bridge,165,73,52,290,256,176,17,449,Friday
2022-09-16,Lok Ma Chau,0,0,0,0,0,0,0,0,Friday
2022-09-16,Man Kam To,0,0,0,0,0,0,0,0,Friday
2022-09-16,Sha Tau Kok,0,0,0,0,0,0,0,0,Friday
2022-09-16,Shenzhen Bay,1289,331,26,1646,782,309,40,1131,Friday
2022-09-16,China Ferry Terminal,0,0,0,0,0,0,0,0,Friday
2022-09-16,Harbour Control,0,0,0,0,0,0,0,0,Friday
2022-09-16,Kai Tak Cruise Terminal,0,0,0,0,0,0,0,0,Friday
2022-09-16,Macau Ferry Terminal,0,0,0,0,0,0,0,0,Friday
2022-09-16,Total,4893,1908,570,7371,5713,2116,527,8356,Friday
2022-09-17,Airport,2918,1081,336,4335,4437,921,442,5800,Saturday
2022-09-17,Express Rail Link West Kowloon,0,0,0,0,0,0,0,0,Saturday
2022-09-17,Hung Hom,0,0,0,0,0,0,0,0,Saturday
2022-09-17,Lo Wu,0,0,0,0,0,0,0,0,Saturday
2022-09-17,Lok Ma Chau Spur Line,0,0,0,0,0,0,0,0,Saturday
2022-09-17,Heung Yuen Wai,0,0,0,0,0,0,0,0,Saturday
2022-09-17,Hong Kong-Zhuhai-Macao Bridge,180,58,93,331,176,181,26,383,Saturday
2022-09-17,Lok Ma Chau,0,0,0,0,0,0,0,0,Saturday
2022-09-17,Man Kam To,0,0,0,0,0,0,0,0,Saturday
2022-09-17,Sha Tau Kok,0,0,0,0,0,0,0,0,Saturday
2022-09-17,Shenzhen Bay,1391,354,33,1778,959,349,24,1332,Saturday
2022-09-17,China Ferry Terminal,0,0,0,0,0,0,0,0,Saturday
2022-09-17,Harbour Control,0,0,0,0,0,0,0,0,Saturday
2022-09-17,Kai Tak Cruise Terminal,0,0,0,0,0,0,0,0,Saturday
2022-09-17,Macau Ferry Terminal,0,0,0,0,0,0,0,0,Saturday
2022-09-17,Total,4489,1493,462,6444,5572,1451,492,7515,Saturday
2022-09-18,Airport,4767,1303,439,6509,4840,1531,425,6796,Sunday
2022-09-18,Express Rail Link West Kowloon,0,0,0,0,0,0,0,0,Sunday
2022-09-18,Hung Hom,0,0,0,0,0,0,0,0,Sunday
2022-09-18,Lo Wu,0,0,0,0,0,0,0,0,Sunday
2022-09-18,Lok Ma Chau Spur Line,0,0,0,0,0,0,0,0,Sunday
2022-09-18,Heung Yuen Wai,0,0,0,0,0,0,0,0,Sunday
2022-09-18,Hong Kong-Zhuhai-Macao Bridge,241,64,46,351,165,184,29,378,Sunday
2022-09-18,Lok Ma Chau,0,0,0,0,0,0,0,0,Sunday
2022-09-18,Man Kam To,0,0,0,0,0,0,0,0,Sunday
2022-09-18,Sha Tau Kok,0,0,0,0,0,0,0,0,Sunday
2022-09-18,Shenzhen Bay,1790,302,17,2109,1018,335,20,1373,Sunday
2022-09-18,China Ferry Terminal,0,0,0,0,0,0,0,0,Sunday
2022-09-18,Harbour Control,0,0,0,0,0,0,0,0,Sunday
2022-09-18,Kai Tak Cruise Terminal,0,0,0,0,0,0,0,0,Sunday
2022-09-18,Macau Ferry Terminal,0,0,0,0,0,0,0,0,Sunday
2022-09-18,Total,6798,1669,502,8969,6023,2050,474,8547,Sunday
2022-09-19,Express Rail Link West Kowloon,0,0,0,0,0,0,0,0,Monday
2022-09-19,Hung Hom,0,0,0,0,0,0,0,0,Monday
2022-09-19,Lo Wu,0,0,0,0,0,0,0,0,Monday
2022-09-19,Lok Ma Chau Spur Line,0,0,0,0,0,0,0,0,Monday
2022-09-19,Heung Yuen Wai,0,0,0,0,0,0,0,0,Monday
2022-09-19,Hong Kong-Zhuhai-Macao Bridge,173,63,39,275,196,157,19,372,Monday
2022-09-19,Lok Ma Chau,0,0,0,0,0,0,0,0,Monday
2022-09-19,Man Kam To,0,0,0,0,0,0,0,0,Monday
2022-09-19,Sha Tau Kok,0,0,0,0,0,0,0,0,Monday
2022-09-19,Shenzhen Bay,1176,312,21,1509,976,317,34,1327,Monday
2022-09-19,China Ferry Terminal,0,0,0,0,0,0,0,0,Monday
2022-09-19,Harbour Control,0,0,0,0,0,0,0,0,Monday
2022-09-19,Kai Tak Cruise Terminal,0,0,0,0,0,0,0,0,Monday
2022-09-19,Macau Ferry Terminal,0,0,0,0,0,0,0,0,Monday
2022-09-19,Total,3858,1693,385,5936,4229,1411,304,5944,Monday
2022-09-21,Airport,2832,1645,344,4821,3189,1031,333,4553,Wednesday
2022-09-21,Express Rail Link West Kowloon,0,0,0,0,0,0,0,0,Wednesday
2022-09-21,Hung Hom,0,0,0,0,0,0,0,0,Wednesday
2022-09-21,Lo Wu,0,0,0,0,0,0,0,0,Wednesday
2022-09-21,Lok Ma Chau Spur Line,0,0,0,0,0,0,0,0,Wednesday
2022-09-21,Heung Yuen Wai,0,0,0,0,0,0,0,0,Wednesday
2022-09-21,Hong Kong-Zhuhai-Macao Bridge,162,55,35,252,193,162,20,375,Wednesday
2022-09-21,Lok Ma Chau,0,0,0,0,0,0,0,0,Wednesday
2022-09-21,Man Kam To,0,0,0,0,0,0,0,0,Wednesday
2022-09-21,Sha Tau Kok,0,0,0,0,0,0,0,0,Wednesday
2022-09-21,Shenzhen Bay,1317,305,20,1642,1130,333,22,1485,Wednesday
2022-09-21,China Ferry Terminal,0,0,0,0,0,0,0,0,Wednesday
2022-09-21,Harbour Control,0,0,0,0,0,0,0,0,Wednesday
2022-09-21,Kai Tak Cruise Terminal,0,0,0,0,0,0,0,0,Wednesday
2022-09-21,Macau Ferry Terminal,0,0,0,0,0,0,0,0,Wednesday
2022-09-21,Total,4311,2005,399,6715,4512,1526,375,6413,Wednesday
2022-09-20,Airport,3557,1406,427,5390,3981,1480,396,5857,Tuesday
2022-09-20,Express Rail Link West Kowloon,0,0,0,0,0,0,0,0,Tuesday
2022-09-20,Hung Hom,0,0,0,0,0,0,0,0,Tuesday
2022-09-20,Lo Wu,0,0,0,0,0,0,0,0,Tuesday
2022-09-20,Lok Ma Chau Spur Line,0,0,0,0,0,0,0,0,Tuesday
2022-09-20,Heung Yuen Wai,0,0,0,0,0,0,0,0,Tuesday
2022-09-20,Hong Kong-Zhuhai-Macao Bridge,165,48,34,247,210,144,25,379,Tuesday
2022-09-20,Lok Ma Chau,0,0,0,0,0,0,0,0,Tuesday
2022-09-20,Man Kam To,0,0,0,0,0,0,0,0,Tuesday
2022-09-20,Sha Tau Kok,0,0,0,0,0,0,0,0,Tuesday
2022-09-20,Shenzhen Bay,1415,263,20,1698,1095,320,32,1447,Tuesday
2022-09-20,China Ferry Terminal,0,0,0,0,0,0,0,0,Tuesday
2022-09-20,Harbour Control,0,0,0,0,0,0,0,0,Tuesday
2022-09-20,Kai Tak Cruise Terminal,0,0,0,0,0,0,0,0,Tuesday
2022-09-20,Macau Ferry Terminal,0,0,0,0,0,0,0,0,Tuesday
2022-09-20,Total,5137,1717,481,7335,5286,1944,453,7683,Tuesday
2022-09-22,Airport,3492,1194,432,5118,3057,1154,303,4514,Thursday
2022-09-22,Express Rail Link West Kowloon,0,0,0,0,0,0,0,0,Thursday
2022-09-22,Hung Hom,0,0,0,0,0,0,0,0,Thursday
2022-09-22,Lo Wu,0,0,0,0,0,0,0,0,Thursday
2022-09-22,Lok Ma Chau Spur Line,0,0,0,0,0,0,0,0,Thursday
2022-09-22,Heung Yuen Wai,0,0,0,0,0,0,0,0,Thursday
2022-09-22,Hong Kong-Zhuhai-Macao Bridge,127,50,33,210,187,180,20,387,Thursday
2022-09-22,Lok Ma Chau,0,0,0,0,0,0,0,0,Thursday
2022-09-22,Man Kam To,0,0,0,0,0,0,0,0,Thursday
2022-09-22,Sha Tau Kok,0,0,0,0,0,0,0,0,Thursday
2022-09-22,Shenzhen Bay,1117,240,27,1384,1152,359,34,1545,Thursday
2022-09-22,China Ferry Terminal,0,0,0,0,0,0,0,0,Thursday
2022-09-22,Harbour Control,0,0,0,0,0,0,0,0,Thursday
2022-09-22,Kai Tak Cruise Terminal,0,0,0,0,0,0,0,0,Thursday
2022-09-22,Macau Ferry Terminal,0,0,0,0,0,0,0,0,Thursday
2022-09-22,Total,4736,1484,492,6712,4396,1693,357,6446,Thursday
2022-09-23,Airport,3345,1113,433,4891,4488,1563,455,6506,Friday
2022-09-23,Express Rail Link West Kowloon,0,0,0,0,0,0,0,0,Friday
2022-09-23,Hung Hom,0,0,0,0,0,0,0,0,Friday
2022-09-23,Lo Wu,0,0,0,0,0,0,0,0,Friday
2022-09-23,Lok Ma Chau Spur Line,0,0,0,0,0,0,0,0,Friday
2022-09-23,Heung Yuen Wai,0,0,0,0,0,0,0,0,Friday
2022-09-23,Hong Kong-Zhuhai-Macao Bridge,144,68,39,251,202,142,18,362,Friday
2022-09-23,Lok Ma Chau,0,0,0,0,0,0,0,0,Friday
2022-09-23,Man Kam To,0,0,0,0,0,0,0,0,Friday
2022-09-23,Sha Tau Kok,0,0,0,0,0,0,0,0,Friday
2022-09-23,Shenzhen Bay,1330,293,25,1648,1243,343,27,1613,Friday
2022-09-23,China Ferry Terminal,0,0,0,0,0,0,0,0,Friday
2022-09-23,Harbour Control,0,0,0,0,0,0,0,0,Friday
2022-09-23,Kai Tak Cruise Terminal,0,0,0,0,0,0,0,0,Friday
2022-09-23,Macau Ferry Terminal,0,0,0,0,0,0,0,0,Friday
2022-09-23,Total,4819,1474,497,6790,5933,2048,500,8481,Friday
2022-09-24,Airport,2416,1125,293,3834,3695,906,342,4943,Saturday
2022-09-24,Express Rail Link West Kowloon,0,0,0,0,0,0,0,0,Saturday
2022-09-24,Hung Hom,0,0,0,0,0,0,0,0,Saturday
2022-09-24,Lo Wu,0,0,0,0,0,0,0,0,Saturday
2022-09-24,Lok Ma Chau Spur Line,0,0,0,0,0,0,0,0,Saturday
2022-09-24,Heung Yuen Wai,0,0,0,0,0,0,0,0,Saturday
2022-09-24,Hong Kong-Zhuhai-Macao Bridge,143,41,59,243,152,157,20,329,Saturday
2022-09-24,Lok Ma Chau,0,0,0,0,0,0,0,0,Saturday
2022-09-24,Man Kam To,0,0,0,0,0,0,0,0,Saturday
2022-09-24,Sha Tau Kok,0,0,0,0,0,0,0,0,Saturday
2022-09-24,Shenzhen Bay,1401,341,24,1766,1466,399,36,1901,Saturday
2022-09-24,China Ferry Terminal,0,0,0,0,0,0,0,0,Saturday
2022-09-24,Harbour Control,0,0,0,0,0,0,0,0,Saturday
2022-09-24,Kai Tak Cruise Terminal,0,0,0,0,0,0,0,0,Saturday
2022-12-21,Total,14510,2069,3583,20162,24946,1910,2182,29038,Wednesday
2022-09-24,Macau Ferry Terminal,0,0,0,0,0,0,0,0,Saturday
2022-09-24,Total,3960,1507,376,5843,5313,1462,398,7173,Saturday
2022-09-25,Airport,3667,1242,347,5256,4946,1402,510,6858,Sunday
2022-09-25,Express Rail Link West Kowloon,0,0,0,0,0,0,0,0,Sunday
2022-09-25,Hung Hom,0,0,0,0,0,0,0,0,Sunday
2022-09-25,Lo Wu,0,0,0,0,0,0,0,0,Sunday
2022-09-25,Lok Ma Chau Spur Line,0,0,0,0,0,0,0,0,Sunday
2022-09-25,Heung Yuen Wai,0,0,0,0,0,0,0,0,Sunday
2022-09-25,Hong Kong-Zhuhai-Macao Bridge,196,46,28,270,164,176,25,365,Sunday
2022-09-25,Lok Ma Chau,0,0,0,0,0,0,0,0,Sunday
2022-09-25,Man Kam To,0,0,0,0,0,0,0,0,Sunday
2022-09-25,Sha Tau Kok,0,0,0,0,0,0,0,0,Sunday
2022-09-25,Shenzhen Bay,1593,297,23,1913,1234,391,26,1651,Sunday
2022-09-25,China Ferry Terminal,0,0,0,0,0,0,0,0,Sunday
2022-09-25,Harbour Control,0,0,0,0,0,0,0,0,Sunday
2022-09-25,Kai Tak Cruise Terminal,0,0,0,0,0,0,0,0,Sunday
2022-09-25,Macau Ferry Terminal,0,0,0,0,0,0,0,0,Sunday
2022-09-25,Total,5456,1585,398,7439,6344,1969,561,8874,Sunday
2022-09-26,Airport,2921,1308,298,4527,3400,694,330,4424,Monday
2022-09-26,Express Rail Link West Kowloon,0,0,0,0,0,0,0,0,Monday
2022-09-26,Hung Hom,0,0,0,0,0,0,0,0,Monday
2022-09-26,Lo Wu,0,0,0,0,0,0,0,0,Monday
2022-09-26,Lok Ma Chau Spur Line,0,0,0,0,0,0,0,0,Monday
2022-09-26,Heung Yuen Wai,0,0,0,0,0,0,0,0,Monday
2022-09-26,Hong Kong-Zhuhai-Macao Bridge,169,38,24,231,159,173,27,359,Monday
2022-09-26,Lok Ma Chau,0,0,0,0,0,0,0,0,Monday
2022-09-26,Man Kam To,0,0,0,0,0,0,0,0,Monday
2022-09-26,Sha Tau Kok,0,0,0,0,0,0,0,0,Monday
2022-09-26,Shenzhen Bay,1426,278,20,1724,1192,382,28,1602,Monday
2022-09-26,China Ferry Terminal,0,0,0,0,0,0,0,0,Monday
2022-09-26,Harbour Control,0,0,0,0,0,0,0,0,Monday
2022-09-26,Kai Tak Cruise Terminal,0,0,0,0,0,0,0,0,Monday
2022-09-26,Macau Ferry Terminal,0,0,0,0,0,0,0,0,Monday
2022-09-26,Total,4516,1624,342,6482,4751,1249,385,6385,Monday
2022-09-27,Airport,3893,1196,460,5549,4408,1302,413,6123,Tuesday
2022-09-27,Express Rail Link West Kowloon,0,0,0,0,0,0,0,0,Tuesday
2022-09-27,Hung Hom,0,0,0,0,0,0,0,0,Tuesday
2022-09-27,Lo Wu,0,0,0,0,0,0,0,0,Tuesday
2022-09-27,Lok Ma Chau Spur Line,0,0,0,0,0,0,0,0,Tuesday
2022-09-27,Heung Yuen Wai,0,0,0,0,0,0,0,0,Tuesday
2022-09-27,Hong Kong-Zhuhai-Macao Bridge,176,43,39,258,208,153,19,380,Tuesday
2022-09-27,Lok Ma Chau,0,0,0,0,0,0,0,0,Tuesday
2022-09-27,Man Kam To,0,0,0,0,0,0,0,0,Tuesday
2022-09-27,Sha Tau Kok,0,0,0,0,0,0,0,0,Tuesday
2022-09-27,Shenzhen Bay,1450,285,16,1751,1238,377,25,1640,Tuesday
2022-09-27,China Ferry Terminal,0,0,0,0,0,0,0,0,Tuesday
2022-09-27,Harbour Control,0,0,0,0,0,0,0,0,Tuesday
2022-09-27,Kai Tak Cruise Terminal,0,0,0,0,0,0,0,0,Tuesday
2022-09-27,Macau Ferry Terminal,0,0,0,0,0,0,0,0,Tuesday
2022-09-27,Total,5519,1524,515,7558,5854,1832,457,8143,Tuesday
2022-09-28,Airport,3292,1371,480,5143,4174,1035,431,5640,Wednesday
2022-09-28,Express Rail Link West Kowloon,0,0,0,0,0,0,0,0,Wednesday
2022-09-28,Hung Hom,0,0,0,0,0,0,0,0,Wednesday
2022-09-28,Lo Wu,0,0,0,0,0,0,0,0,Wednesday
2022-09-28,Lok Ma Chau Spur Line,0,0,0,0,0,0,0,0,Wednesday
2022-09-28,Heung Yuen Wai,0,0,0,0,0,0,0,0,Wednesday
2022-09-28,Hong Kong-Zhuhai-Macao Bridge,195,44,38,277,191,145,23,359,Wednesday
2022-09-28,Lok Ma Chau,0,0,0,0,0,0,0,0,Wednesday
2022-09-28,Man Kam To,0,0,0,0,0,0,0,0,Wednesday
2022-09-28,Sha Tau Kok,0,0,0,0,0,0,0,0,Wednesday
2022-09-28,Shenzhen Bay,1787,267,40,2094,1227,288,26,1541,Wednesday
2022-09-28,China Ferry Terminal,0,0,0,0,0,0,0,0,Wednesday
2022-09-28,Harbour Control,0,0,0,0,0,0,0,0,Wednesday
2022-09-28,Kai Tak Cruise Terminal,0,0,0,0,0,0,0,0,Wednesday
2022-09-28,Macau Ferry Terminal,0,0,0,0,0,0,0,0,Wednesday
2022-09-28,Total,5274,1682,558,7514,5592,1468,480,7540,Wednesday
2022-09-29,Airport,3799,1115,550,5464,4422,1169,441,6032,Thursday
2022-09-29,Express Rail Link West Kowloon,0,0,0,0,0,0,0,0,Thursday
2022-09-29,Hung Hom,0,0,0,0,0,0,0,0,Thursday
2022-09-29,Lo Wu,0,0,0,0,0,0,0,0,Thursday
2022-09-29,Lok Ma Chau Spur Line,0,0,0,0,0,0,0,0,Thursday
2022-09-29,Heung Yuen Wai,0,0,0,0,0,0,0,0,Thursday
2022-09-29,Hong Kong-Zhuhai-Macao Bridge,202,43,30,275,192,136,30,358,Thursday
2022-09-29,Lok Ma Chau,0,0,0,0,0,0,0,0,Thursday
2022-09-29,Man Kam To,0,0,0,0,0,0,0,0,Thursday
2022-09-29,Sha Tau Kok,0,0,0,0,0,0,0,0,Thursday
2022-09-29,Shenzhen Bay,1759,339,35,2133,1212,340,23,1575,Thursday
2022-09-29,China Ferry Terminal,0,0,0,0,0,0,0,0,Thursday
2022-09-29,Harbour Control,0,0,0,0,0,0,0,0,Thursday
2022-09-29,Kai Tak Cruise Terminal,0,0,0,0,0,0,0,0,Thursday
2022-09-29,Macau Ferry Terminal,0,0,0,0,0,0,0,0,Thursday
2022-09-29,Total,5760,1497,615,7872,5826,1645,494,7965,Thursday
2022-09-30,Airport,4031,1432,645,6108,7252,1478,534,9264,Friday
2022-09-30,Express Rail Link West Kowloon,0,0,0,0,0,0,0,0,Friday
2022-09-30,Hung Hom,0,0,0,0,0,0,0,0,Friday
2022-09-30,Lo Wu,0,0,0,0,0,0,0,0,Friday
2022-09-30,Lok Ma Chau Spur Line,0,0,0,0,0,0,0,0,Friday
2022-09-30,Heung Yuen Wai,0,0,0,0,0,0,0,0,Friday
2022-09-30,Hong Kong-Zhuhai-Macao Bridge,228,31,26,285,207,94,19,320,Friday
2022-09-30,Lok Ma Chau,0,0,0,0,0,0,0,0,Friday
2022-09-30,Man Kam To,0,0,0,0,0,0,0,0,Friday
2022-09-30,Sha Tau Kok,0,0,0,0,0,0,0,0,Friday
2022-09-30,Shenzhen Bay,2098,363,53,2514,1145,351,34,1530,Friday
2022-09-30,China Ferry Terminal,0,0,0,0,0,0,0,0,Friday
2022-09-30,Harbour Control,0,0,0,0,0,0,0,0,Friday
2022-09-30,Kai Tak Cruise Terminal,0,0,0,0,0,0,0,0,Friday
2022-09-30,Macau Ferry Terminal,0,0,0,0,0,0,0,0,Friday
2022-09-30,Total,6357,1826,724,8907,8604,1923,587,11114,Friday
2022-10-01,Airport,3650,1076,572,5298,7170,932,582,8684,Saturday
2022-10-01,Express Rail Link West Kowloon,0,0,0,0,0,0,0,0,Saturday
2022-10-01,Hung Hom,0,0,0,0,0,0,0,0,Saturday
2022-10-01,Lo Wu,0,0,0,0,0,0,0,0,Saturday
2022-10-01,Lok Ma Chau Spur Line,0,0,0,0,0,0,0,0,Saturday
2022-10-01,Heung Yuen Wai,0,0,0,0,0,0,0,0,Saturday
2022-10-01,Hong Kong-Zhuhai-Macao Bridge,189,30,77,296,201,121,16,338,Saturday
2022-10-01,Lok Ma Chau,0,0,0,0,0,0,0,0,Saturday
2022-10-01,Man Kam To,0,0,0,0,0,0,0,0,Saturday
2022-10-01,Sha Tau Kok,0,0,0,0,0,0,0,0,Saturday
2022-10-01,Shenzhen Bay,1052,276,34,1362,1178,368,31,1577,Saturday
2022-10-01,China Ferry Terminal,0,0,0,0,0,0,0,0,Saturday
2022-10-01,Harbour Control,0,0,0,0,0,0,0,0,Saturday
2022-10-01,Kai Tak Cruise Terminal,0,0,0,0,0,0,0,0,Saturday
2022-10-01,Macau Ferry Terminal,0,0,0,0,0,0,0,0,Saturday
2022-10-01,Total,4891,1382,683,6956,8549,1421,629,10599,Saturday
2022-10-02,Airport,5490,972,732,7194,5797,1332,592,7721,Sunday
2022-10-02,Express Rail Link West Kowloon,0,0,0,0,0,0,0,0,Sunday
2022-10-02,Hung Hom,0,0,0,0,0,0,0,0,Sunday
2022-10-02,Lo Wu,0,0,0,0,0,0,0,0,Sunday
2022-10-02,Lok Ma Chau Spur Line,0,0,0,0,0,0,0,0,Sunday
2022-10-02,Heung Yuen Wai,0,0,0,0,0,0,0,0,Sunday
2022-10-02,Hong Kong-Zhuhai-Macao Bridge,178,30,34,242,200,161,25,386,Sunday
2022-10-02,Lok Ma Chau,0,0,0,0,0,0,0,0,Sunday
2022-10-02,Man Kam To,0,0,0,0,0,0,0,0,Sunday
2022-10-02,Sha Tau Kok,0,0,0,0,0,0,0,0,Sunday
2022-10-02,Shenzhen Bay,1171,258,28,1457,1127,355,40,1522,Sunday
2022-10-02,China Ferry Terminal,0,0,0,0,0,0,0,0,Sunday
2022-10-02,Harbour Control,0,0,0,0,0,0,0,0,Sunday
2022-10-02,Kai Tak Cruise Terminal,0,0,0,0,0,0,0,0,Sunday
2022-10-02,Macau Ferry Terminal,0,0,0,0,0,0,0,0,Sunday
2022-10-02,Total,6839,1260,794,8893,7124,1848,657,9629,Sunday
2022-10-03,Airport,4400,1574,722,6696,4220,609,421,5250,Monday
2022-10-03,Express Rail Link West Kowloon,0,0,0,0,0,0,0,0,Monday
2022-10-03,Hung Hom,0,0,0,0,0,0,0,0,Monday
2022-10-03,Lo Wu,0,0,0,0,0,0,0,0,Monday
2022-10-03,Lok Ma Chau Spur Line,0,0,0,0,0,0,0,0,Monday
2022-10-03,Heung Yuen Wai,0,0,0,0,0,0,0,0,Monday
2022-10-03,Hong Kong-Zhuhai-Macao Bridge,136,28,25,189,172,133,18,323,Monday
2022-10-03,Lok Ma Chau,0,0,0,0,0,0,0,0,Monday
2022-10-03,Man Kam To,0,0,0,0,0,0,0,0,Monday
2022-10-03,Sha Tau Kok,0,0,0,0,0,0,0,0,Monday
2022-10-03,Shenzhen Bay,1173,234,21,1428,1234,350,32,1616,Monday
2022-10-03,China Ferry Terminal,0,0,0,0,0,0,0,0,Monday
2022-10-03,Harbour Control,0,0,0,0,0,0,0,0,Monday
2022-10-03,Kai Tak Cruise Terminal,0,0,0,0,0,0,0,0,Monday
2022-10-03,Macau Ferry Terminal,0,0,0,0,0,0,0,0,Monday
2022-10-03,Total,5709,1836,768,8313,5626,1092,471,7189,Monday
2022-10-04,Airport,5977,1004,677,7658,5301,1291,480,7072,Tuesday
2022-10-04,Express Rail Link West Kowloon,0,0,0,0,0,0,0,0,Tuesday
2022-10-04,Hung Hom,0,0,0,0,0,0,0,0,Tuesday
2022-10-04,Lo Wu,0,0,0,0,0,0,0,0,Tuesday
2022-10-04,Lok Ma Chau Spur Line,0,0,0,0,0,0,0,0,Tuesday
2022-10-04,Heung Yuen Wai,0,0,0,0,0,0,0,0,Tuesday
2022-10-04,Hong Kong-Zhuhai-Macao Bridge,172,40,26,238,195,150,31,376,Tuesday
2022-10-04,Lok Ma Chau,0,0,0,0,0,0,0,0,Tuesday
2022-10-04,Man Kam To,0,0,0,0,0,0,0,0,Tuesday
2022-10-04,Sha Tau Kok,0,0,0,0,0,0,0,0,Tuesday
2022-10-04,Shenzhen Bay,1218,225,17,1460,1133,355,45,1533,Tuesday
2022-10-04,China Ferry Terminal,0,0,0,0,0,0,0,0,Tuesday
2022-10-04,Harbour Control,0,0,0,0,0,0,0,0,Tuesday
2022-10-04,Kai Tak Cruise Terminal,0,0,0,0,0,0,0,0,Tuesday
2022-10-04,Macau Ferry Terminal,0,0,0,0,0,0,0,0,Tuesday
2022-10-04,Total,7367,1269,720,9356,6629,1796,556,8981,Tuesday
2022-10-05,Airport,4196,1293,593,6082,4231,901,538,5670,Wednesday
2022-10-05,Express Rail Link West Kowloon,0,0,0,0,0,0,0,0,Wednesday
2022-10-05,Hung Hom,0,0,0,0,0,0,0,0,Wednesday
2022-10-05,Lo Wu,0,0,0,0,0,0,0,0,Wednesday
2022-10-05,Lok Ma Chau Spur Line,0,0,0,0,0,0,0,0,Wednesday
2022-10-05,Heung Yuen Wai,0,0,0,0,0,0,0,0,Wednesday
2022-10-05,Hong Kong-Zhuhai-Macao Bridge,145,21,50,216,179,140,16,335,Wednesday
2022-10-05,Lok Ma Chau,0,0,0,0,0,0,0,0,Wednesday
2022-10-05,Man Kam To,0,0,0,0,0,0,0,0,Wednesday
2022-10-05,Sha Tau Kok,0,0,0,0,0,0,0,0,Wednesday
2022-10-05,Shenzhen Bay,1272,186,11,1469,1192,327,42,1561,Wednesday
2022-10-05,China Ferry Terminal,0,0,0,0,0,0,0,0,Wednesday
2022-10-05,Harbour Control,0,0,0,0,0,0,0,0,Wednesday
2022-10-05,Kai Tak Cruise Terminal,0,0,0,0,0,0,0,0,Wednesday
2022-10-05,Macau Ferry Terminal,0,0,0,0,0,0,0,0,Wednesday
2022-10-05,Total,5613,1500,654,7767,5602,1368,596,7566,Wednesday
2022-10-06,Airport,4802,1163,770,6735,4625,922,523,6070,Thursday
2022-10-06,Express Rail Link West Kowloon,0,0,0,0,0,0,0,0,Thursday
2022-10-06,Hung Hom,0,0,0,0,0,0,0,0,Thursday
2022-10-06,Lo Wu,0,0,0,0,0,0,0,0,Thursday
2022-10-06,Lok Ma Chau Spur Line,0,0,0,0,0,0,0,0,Thursday
2022-10-06,Heung Yuen Wai,0,0,0,0,0,0,0,0,Thursday
2022-10-06,Hong Kong-Zhuhai-Macao Bridge,123,24,36,183,222,136,18,376,Thursday
2022-10-06,Lok Ma Chau,0,0,0,0,0,0,0,0,Thursday
2022-10-06,Man Kam To,0,0,0,0,0,0,0,0,Thursday
2022-10-06,Sha Tau Kok,0,0,0,0,0,0,0,0,Thursday
2022-10-06,Shenzhen Bay,1006,192,15,1213,1199,403,30,1632,Thursday
2022-10-06,China Ferry Terminal,0,0,0,0,0,0,0,0,Thursday
2022-10-06,Harbour Control,0,0,0,0,0,0,0,0,Thursday
2022-10-06,Kai Tak Cruise Terminal,0,0,0,0,0,0,0,0,Thursday
2022-10-06,Macau Ferry Terminal,0,0,0,0,0,0,0,0,Thursday
2022-10-06,Total,5931,1379,821,8131,6046,1461,571,8078,Thursday
2022-10-07,Airport,4870,1386,852,7108,5575,1315,606,7496,Friday
2022-10-07,Express Rail Link West Kowloon,0,0,0,0,0,0,0,0,Friday
2022-10-07,Hung Hom,0,0,0,0,0,0,0,0,Friday
2022-10-07,Lo Wu,0,0,0,0,0,0,0,0,Friday
2022-10-07,Lok Ma Chau Spur Line,0,0,0,0,0,0,0,0,Friday
2022-10-07,Heung Yuen Wai,0,0,0,0,0,0,0,0,Friday
2022-10-07,Hong Kong-Zhuhai-Macao Bridge,156,23,29,208,230,118,21,369,Friday
2022-10-07,Lok Ma Chau,0,0,0,0,0,0,0,0,Friday
2022-10-07,Man Kam To,0,0,0,0,0,0,0,0,Friday
2022-10-07,Sha Tau Kok,0,0,0,0,0,0,0,0,Friday
2022-10-07,Shenzhen Bay,828,150,16,994,1242,318,34,1594,Friday
2022-10-07,China Ferry Terminal,0,0,0,0,0,0,0,0,Friday
2022-10-07,Harbour Control,0,0,0,0,0,0,0,0,Friday
2022-10-07,Kai Tak Cruise Terminal,0,0,0,0,0,0,0,0,Friday
2022-10-07,Macau Ferry Terminal,0,0,0,0,0,0,0,0,Friday
2022-10-07,Total,5854,1559,897,8310,7047,1751,661,9459,Friday
2022-10-08,Airport,4684,1226,795,6705,5593,919,648,7160,Saturday
2022-10-08,Express Rail Link West Kowloon,0,0,0,0,0,0,0,0,Saturday
2022-10-08,Hung Hom,0,0,0,0,0,0,0,0,Saturday
2022-10-08,Lo Wu,0,0,0,0,0,0,0,0,Saturday
2022-10-08,Lok Ma Chau Spur Line,0,0,0,0,0,0,0,0,Saturday
2022-10-08,Heung Yuen Wai,0,0,0,0,0,0,0,0,Saturday
2022-10-08,Hong Kong-Zhuhai-Macao Bridge,170,30,67,267,196,123,12,331,Saturday
2022-10-08,Lok Ma Chau,0,0,0,0,0,0,0,0,Saturday
2022-10-08,Man Kam To,0,0,0,0,0,0,0,0,Saturday
2022-10-08,Sha Tau Kok,0,0,0,0,0,0,0,0,Saturday
2022-10-08,Shenzhen Bay,1561,286,16,1863,1148,359,27,1534,Saturday
2022-10-08,China Ferry Terminal,0,0,0,0,0,0,0,0,Saturday
2022-10-08,Harbour Control,0,0,0,0,0,0,0,0,Saturday
2022-10-08,Kai Tak Cruise Terminal,0,0,0,0,0,0,0,0,Saturday
2022-10-08,Macau Ferry Terminal,0,0,0,0,0,0,0,0,Saturday
2022-10-08,Total,6415,1542,878,8835,6937,1401,687,9025,Saturday
2022-10-10,Airport,4757,1445,885,7087,4116,560,489,5165,Monday
2022-10-10,Express Rail Link West Kowloon,0,0,0,0,0,0,0,0,Monday
2022-10-10,Hung Hom,0,0,0,0,0,0,0,0,Monday
2022-10-10,Lo Wu,0,0,0,0,0,0,0,0,Monday
2022-10-10,Lok Ma Chau Spur Line,0,0,0,0,0,0,0,0,Monday
2022-10-10,Heung Yuen Wai,0,0,0,0,0,0,0,0,Monday
2022-10-10,Hong Kong-Zhuhai-Macao Bridge,174,35,56,265,176,168,26,370,Monday
2022-10-10,Lok Ma Chau,0,0,0,0,0,0,0,0,Monday
2022-10-10,Man Kam To,0,0,0,0,0,0,0,0,Monday
2022-10-10,Sha Tau Kok,0,0,0,0,0,0,0,0,Monday
2022-10-10,Shenzhen Bay,1788,436,27,2251,696,273,24,993,Monday
2022-10-10,China Ferry Terminal,0,0,0,0,0,0,0,0,Monday
2022-10-10,Harbour Control,0,0,0,0,0,0,0,0,Monday
2022-10-10,Kai Tak Cruise Terminal,0,0,0,0,0,0,0,0,Monday
2022-10-10,Macau Ferry Terminal,0,0,0,0,0,0,0,0,Monday
2022-10-10,Total,6719,1916,968,9603,4988,1001,539,6528,Monday
2022-10-09,Airport,7003,1104,987,9094,6033,1221,672,7926,Sunday
2022-10-09,Express Rail Link West Kowloon,0,0,0,0,0,0,0,0,Sunday
2022-10-09,Hung Hom,0,0,0,0,0,0,0,0,Sunday
2022-10-09,Lo Wu,0,0,0,0,0,0,0,0,Sunday
2022-10-09,Lok Ma Chau Spur Line,0,0,0,0,0,0,0,0,Sunday
2022-10-09,Heung Yuen Wai,0,0,0,0,0,0,0,0,Sunday
2022-10-09,Hong Kong-Zhuhai-Macao Bridge,224,43,30,297,218,152,31,401,Sunday
2022-10-09,Lok Ma Chau,0,0,0,0,0,0,0,0,Sunday
2022-10-09,Man Kam To,0,0,0,0,0,0,0,0,Sunday
2022-10-09,Sha Tau Kok,0,0,0,0,0,0,0,0,Sunday
2022-10-09,Shenzhen Bay,1816,289,27,2132,624,221,12,857,Sunday
2022-10-09,China Ferry Terminal,0,0,0,0,0,0,0,0,Sunday
2022-10-09,Harbour Control,0,0,0,0,0,0,0,0,Sunday
2022-10-09,Kai Tak Cruise Terminal,0,0,0,0,0,0,0,0,Sunday
2022-10-09,Macau Ferry Terminal,0,0,0,0,0,0,0,0,Sunday
2022-10-09,Total,9043,1436,1044,11523,6875,1594,715,9184,Sunday
2022-10-11,Airport,5044,1174,949,7167,6649,1245,730,8624,Tuesday
2022-10-11,Express Rail Link West Kowloon,0,0,0,0,0,0,0,0,Tuesday
2022-10-11,Hung Hom,0,0,0,0,0,0,0,0,Tuesday
2022-10-11,Lo Wu,0,0,0,0,0,0,0,0,Tuesday
2022-10-11,Lok Ma Chau Spur Line,0,0,0,0,0,0,0,0,Tuesday
2022-10-11,Heung Yuen Wai,0,0,0,0,0,0,0,0,Tuesday
2022-10-11,Hong Kong-Zhuhai-Macao Bridge,157,35,14,206,202,177,17,396,Tuesday
2022-10-11,Lok Ma Chau,0,0,0,0,0,0,0,0,Tuesday
2022-10-11,Man Kam To,0,0,0,0,0,0,0,0,Tuesday
2022-10-11,Sha Tau Kok,0,0,0,0,0,0,0,0,Tuesday
2022-10-11,Shenzhen Bay,1482,298,11,1791,683,218,34,935,Tuesday
2022-10-11,China Ferry Terminal,0,0,0,0,0,0,0,0,Tuesday
2022-10-11,Harbour Control,0,0,0,0,0,0,0,0,Tuesday
2022-10-11,Kai Tak Cruise Terminal,0,0,0,0,0,0,0,0,Tuesday
2022-10-11,Macau Ferry Terminal,0,0,0,0,0,0,0,0,Tuesday
2022-10-11,Total,6683,1507,974,9164,7534,1640,781,9955,Tuesday
2022-10-12,Airport,3754,1262,846,5862,5679,847,609,7135,Wednesday
2022-10-12,Express Rail Link West Kowloon,0,0,0,0,0,0,0,0,Wednesday
2022-10-12,Hung Hom,0,0,0,0,0,0,0,0,Wednesday
2022-10-12,Lo Wu,0,0,0,0,0,0,0,0,Wednesday
2022-10-12,Lok Ma Chau Spur Line,0,0,0,0,0,0,0,0,Wednesday
2022-10-12,Heung Yuen Wai,0,0,0,0,0,0,0,0,Wednesday
2022-10-12,Hong Kong-Zhuhai-Macao Bridge,164,26,45,235,210,126,16,352,Wednesday
2022-10-12,Lok Ma Chau,0,0,0,0,0,0,0,0,Wednesday
2022-10-12,Man Kam To,0,0,0,0,0,0,0,0,Wednesday
2022-10-12,Sha Tau Kok,0,0,0,0,0,0,0,0,Wednesday
2022-10-12,Shenzhen Bay,1311,253,14,1578,680,224,30,934,Wednesday
2022-10-12,China Ferry Terminal,0,0,0,0,0,0,0,0,Wednesday
2022-10-12,Harbour Control,0,0,0,0,0,0,0,0,Wednesday
2022-10-12,Kai Tak Cruise Terminal,0,0,0,0,0,0,0,0,Wednesday
2022-10-12,Macau Ferry Terminal,0,0,0,0,0,0,0,0,Wednesday
2022-10-12,Total,5229,1541,905,7675,6569,1197,655,8421,Wednesday
2022-10-13,Airport,4632,971,912,6515,6881,929,781,8591,Thursday
2022-10-13,Express Rail Link West Kowloon,0,0,0,0,0,0,0,0,Thursday
2022-10-13,Hung Hom,0,0,0,0,0,0,0,0,Thursday
2022-10-13,Lo Wu,0,0,0,0,0,0,0,0,Thursday
2022-10-13,Lok Ma Chau Spur Line,0,0,0,0,0,0,0,0,Thursday
2022-10-13,Heung Yuen Wai,0,0,0,0,0,0,0,0,Thursday
2022-10-13,Hong Kong-Zhuhai-Macao Bridge,167,30,33,230,220,175,37,432,Thursday
2022-10-13,Lok Ma Chau,0,0,0,0,0,0,0,0,Thursday
2022-10-13,Man Kam To,0,0,0,0,0,0,0,0,Thursday
2022-10-13,Sha Tau Kok,0,0,0,0,0,0,0,0,Thursday
2022-10-13,Shenzhen Bay,1204,255,24,1483,738,220,22,980,Thursday
2022-10-13,China Ferry Terminal,0,0,0,0,0,0,0,0,Thursday
2022-10-13,Harbour Control,0,0,0,0,0,0,0,0,Thursday
2022-10-13,Kai Tak Cruise Terminal,0,0,0,0,0,0,0,0,Thursday
2022-10-13,Macau Ferry Terminal,0,0,0,0,0,0,0,0,Thursday
2022-10-13,Total,6003,1256,969,8228,7839,1324,840,10003,Thursday
2022-10-14,Airport,5063,1426,950,7439,8565,1517,954,11036,Friday
2022-10-14,Express Rail Link West Kowloon,0,0,0,0,0,0,0,0,Friday
2022-10-14,Hung Hom,0,0,0,0,0,0,0,0,Friday
2022-10-14,Lo Wu,0,0,0,0,0,0,0,0,Friday
2022-10-14,Lok Ma Chau Spur Line,0,0,0,0,0,0,0,0,Friday
2022-10-14,Heung Yuen Wai,0,0,0,0,0,0,0,0,Friday
2022-10-14,Hong Kong-Zhuhai-Macao Bridge,155,22,29,206,230,148,18,396,Friday
2022-10-14,Lok Ma Chau,0,0,0,0,0,0,0,0,Friday
2022-10-14,Man Kam To,0,0,0,0,0,0,0,0,Friday
2022-10-14,Sha Tau Kok,0,0,0,0,0,0,0,0,Friday
2022-10-14,Shenzhen Bay,1214,224,30,1468,654,240,23,917,Friday
2022-10-14,China Ferry Terminal,0,0,0,0,0,0,0,0,Friday
2022-10-14,Harbour Control,0,0,0,0,0,0,0,0,Friday
2022-10-14,Kai Tak Cruise Terminal,0,0,0,0,0,0,0,0,Friday
2022-10-14,Macau Ferry Terminal,0,0,0,0,0,0,0,0,Friday
2022-10-14,Total,6432,1672,1009,9113,9449,1905,995,12349,Friday
2022-10-15,Airport,5002,1082,836,6920,8532,1047,918,10497,Saturday
2022-10-15,Express Rail Link West Kowloon,0,0,0,0,0,0,0,0,Saturday
2022-10-15,Hung Hom,0,0,0,0,0,0,0,0,Saturday
2022-10-15,Lo Wu,0,0,0,0,0,0,0,0,Saturday
2022-10-15,Lok Ma Chau Spur Line,0,0,0,0,0,0,0,0,Saturday
2022-10-15,Heung Yuen Wai,0,0,0,0,0,0,0,0,Saturday
2022-10-15,Hong Kong-Zhuhai-Macao Bridge,196,28,72,296,195,135,21,351,Saturday
2022-10-15,Lok Ma Chau,0,0,0,0,0,0,0,0,Saturday
2022-10-15,Man Kam To,0,0,0,0,0,0,0,0,Saturday
2022-10-15,Sha Tau Kok,0,0,0,0,0,0,0,0,Saturday
2022-10-15,Shenzhen Bay,1555,346,24,1925,646,262,18,926,Saturday
2022-10-15,China Ferry Terminal,0,0,0,0,0,0,0,0,Saturday
2022-10-15,Harbour Control,0,0,0,0,0,0,0,0,Saturday
2022-10-15,Kai Tak Cruise Terminal,0,0,0,0,0,0,0,0,Saturday
2022-10-15,Macau Ferry Terminal,0,0,0,0,0,0,0,0,Saturday
2022-10-15,Total,6753,1456,932,9141,9373,1444,957,11774,Saturday
2022-10-16,Airport,8434,1024,1102,10560,8915,1267,1153,11335,Sunday
2022-10-16,Express Rail Link West Kowloon,0,0,0,0,0,0,0,0,Sunday
2022-10-16,Hung Hom,0,0,0,0,0,0,0,0,Sunday
2022-10-16,Lo Wu,0,0,0,0,0,0,0,0,Sunday
2022-10-16,Lok Ma Chau Spur Line,0,0,0,0,0,0,0,0,Sunday
2022-10-16,Heung Yuen Wai,0,0,0,0,0,0,0,0,Sunday
2022-10-16,Hong Kong-Zhuhai-Macao Bridge,239,24,29,292,221,138,30,389,Sunday
2022-10-16,Lok Ma Chau,0,0,0,0,0,0,0,0,Sunday
2022-10-16,Man Kam To,0,0,0,0,0,0,0,0,Sunday
2022-10-16,Sha Tau Kok,0,0,0,0,0,0,0,0,Sunday
2022-10-16,Shenzhen Bay,1616,311,28,1955,719,242,13,974,Sunday
2022-10-16,China Ferry Terminal,0,0,0,0,0,0,0,0,Sunday
2022-10-16,Harbour Control,0,0,0,0,0,0,0,0,Sunday
2022-10-16,Kai Tak Cruise Terminal,0,0,0,0,0,0,0,0,Sunday
2022-10-16,Macau Ferry Terminal,0,0,0,0,0,0,0,0,Sunday
2022-10-16,Total,10289,1359,1159,12807,9855,1647,1196,12698,Sunday
2022-10-17,Airport,5687,1310,1034,8031,6786,629,699,8114,Monday
2022-10-17,Express Rail Link West Kowloon,0,0,0,0,0,0,0,0,Monday
2022-10-17,Hung Hom,0,0,0,0,0,0,0,0,Monday
2022-10-17,Lo Wu,0,0,0,0,0,0,0,0,Monday
2022-10-17,Lok Ma Chau Spur Line,0,0,0,0,0,0,0,0,Monday
2022-10-17,Heung Yuen Wai,0,0,0,0,0,0,0,0,Monday
2022-10-17,Hong Kong-Zhuhai-Macao Bridge,195,41,43,279,169,188,27,384,Monday
2022-10-17,Lok Ma Chau,0,0,0,0,0,0,0,0,Monday
2022-10-17,Man Kam To,0,0,0,0,0,0,0,0,Monday
2022-10-17,Sha Tau Kok,0,0,0,0,0,0,0,0,Monday
2022-10-17,Shenzhen Bay,1387,261,20,1668,703,203,22,928,Monday
2022-10-17,China Ferry Terminal,0,0,0,0,0,0,0,0,Monday
2022-10-17,Harbour Control,0,0,0,0,0,0,0,0,Monday
2022-10-17,Kai Tak Cruise Terminal,0,0,0,0,0,0,0,0,Monday
2022-10-17,Macau Ferry Terminal,0,0,0,0,0,0,0,0,Monday
2022-10-17,Total,7269,1612,1097,9978,7658,1020,748,9426,Monday
2022-10-18,Airport,6372,1064,1071,8507,6840,1275,841,8956,Tuesday
2022-10-18,Express Rail Link West Kowloon,0,0,0,0,0,0,0,0,Tuesday
2022-10-18,Hung Hom,0,0,0,0,0,0,0,0,Tuesday
2022-10-18,Lo Wu,0,0,0,0,0,0,0,0,Tuesday
2022-10-18,Lok Ma Chau Spur Line,0,0,0,0,0,0,0,0,Tuesday
2022-10-18,Heung Yuen Wai,0,0,0,0,0,0,0,0,Tuesday
2022-12-22,Airport,13324,2217,3673,19214,25321,1553,1953,28827,Thursday
2022-10-18,Hong Kong-Zhuhai-Macao Bridge,158,23,37,218,245,160,18,423,Tuesday
2022-10-18,Lok Ma Chau,0,0,0,0,0,0,0,0,Tuesday
2022-10-18,Man Kam To,0,0,0,0,0,0,0,0,Tuesday
2022-10-18,Sha Tau Kok,0,0,0,0,0,0,0,0,Tuesday
2022-10-18,Shenzhen Bay,1233,202,37,1472,681,238,21,940,Tuesday
2022-10-18,China Ferry Terminal,0,0,0,0,0,0,0,0,Tuesday
2022-10-18,Harbour Control,0,0,0,0,0,0,0,0,Tuesday
2022-10-18,Kai Tak Cruise Terminal,0,0,0,0,0,0,0,0,Tuesday
2022-10-18,Macau Ferry Terminal,0,0,0,0,0,0,0,0,Tuesday
2022-10-18,Total,7763,1289,1145,10197,7766,1673,880,10319,Tuesday
2022-10-19,Airport,5521,1279,887,7687,6649,959,872,8480,Wednesday
2022-10-19,Express Rail Link West Kowloon,0,0,0,0,0,0,0,0,Wednesday
2022-10-19,Hung Hom,0,0,0,0,0,0,0,0,Wednesday
2022-10-19,Lo Wu,0,0,0,0,0,0,0,0,Wednesday
2022-10-19,Lok Ma Chau Spur Line,0,0,0,0,0,0,0,0,Wednesday
2022-10-19,Heung Yuen Wai,0,0,0,0,0,0,0,0,Wednesday
2022-10-19,Hong Kong-Zhuhai-Macao Bridge,166,29,45,240,200,134,24,358,Wednesday
2022-10-19,Lok Ma Chau,0,0,0,0,0,0,0,0,Wednesday
2022-10-19,Man Kam To,0,0,0,0,0,0,0,0,Wednesday
2022-10-19,Sha Tau Kok,0,0,0,0,0,0,0,0,Wednesday
2022-10-19,Shenzhen Bay,1197,201,27,1425,696,168,23,887,Wednesday
2022-10-19,China Ferry Terminal,0,0,0,0,0,0,0,0,Wednesday
2022-10-19,Harbour Control,0,0,0,0,0,0,0,0,Wednesday
2022-10-19,Kai Tak Cruise Terminal,0,0,0,0,0,0,0,0,Wednesday
2022-10-19,Macau Ferry Terminal,0,0,0,0,0,0,0,0,Wednesday
2022-10-19,Total,6884,1509,959,9352,7545,1261,919,9725,Wednesday
2022-10-20,Airport,6867,1161,1090,9118,7188,983,819,8990,Thursday
2022-10-20,Express Rail Link West Kowloon,0,0,0,0,0,0,0,0,Thursday
2022-10-20,Hung Hom,0,0,0,0,0,0,0,0,Thursday
2022-10-20,Lo Wu,0,0,0,0,0,0,0,0,Thursday
2022-10-20,Lok Ma Chau Spur Line,0,0,0,0,0,0,0,0,Thursday
2022-10-20,Heung Yuen Wai,0,0,0,0,0,0,0,0,Thursday
2022-10-20,Hong Kong-Zhuhai-Macao Bridge,173,27,53,253,227,138,28,393,Thursday
2022-10-20,Lok Ma Chau,0,0,0,0,0,0,0,0,Thursday
2022-10-20,Man Kam To,0,0,0,0,0,0,0,0,Thursday
2022-10-20,Sha Tau Kok,0,0,0,0,0,0,0,0,Thursday
2022-10-20,Shenzhen Bay,1423,239,29,1691,711,190,23,924,Thursday
2022-10-20,China Ferry Terminal,0,0,0,0,0,0,0,0,Thursday
2022-10-20,Harbour Control,0,0,0,0,0,0,0,0,Thursday
2022-10-20,Kai Tak Cruise Terminal,0,0,0,0,0,0,0,0,Thursday
2022-10-20,Macau Ferry Terminal,0,0,0,0,0,0,0,0,Thursday
2022-10-20,Total,8463,1427,1172,11062,8126,1311,870,10307,Thursday
2022-10-21,Airport,7550,1428,1192,10170,9071,1487,1092,11650,Friday
2022-10-21,Express Rail Link West Kowloon,0,0,0,0,0,0,0,0,Friday
2022-10-21,Hung Hom,0,0,0,0,0,0,0,0,Friday
2022-10-21,Lo Wu,0,0,0,0,0,0,0,0,Friday
2022-10-21,Lok Ma Chau Spur Line,0,0,0,0,0,0,0,0,Friday
2022-10-21,Heung Yuen Wai,0,0,0,0,0,0,0,0,Friday
2022-10-21,Hong Kong-Zhuhai-Macao Bridge,170,27,32,229,236,122,21,379,Friday
2022-10-21,Lok Ma Chau,0,0,0,0,0,0,0,0,Friday
2022-10-21,Man Kam To,0,0,0,0,0,0,0,0,Friday
2022-10-21,Sha Tau Kok,0,0,0,0,0,0,0,0,Friday
2022-10-21,Shenzhen Bay,1205,218,20,1443,705,206,25,936,Friday
2022-10-21,China Ferry Terminal,0,0,0,0,0,0,0,0,Friday
2022-10-21,Harbour Control,0,0,0,0,0,0,0,0,Friday
2022-10-21,Kai Tak Cruise Terminal,0,0,0,0,0,0,0,0,Friday
2022-10-21,Macau Ferry Terminal,0,0,0,0,0,0,0,0,Friday
2022-10-21,Total,8925,1673,1244,11842,10012,1815,1138,12965,Friday
2022-10-22,Airport,7726,1078,924,9728,8104,957,1042,10103,Saturday
2022-10-22,Express Rail Link West Kowloon,0,0,0,0,0,0,0,0,Saturday
2022-10-22,Hung Hom,0,0,0,0,0,0,0,0,Saturday
2022-10-22,Lo Wu,0,0,0,0,0,0,0,0,Saturday
2022-10-22,Lok Ma Chau Spur Line,0,0,0,0,0,0,0,0,Saturday
2022-10-22,Heung Yuen Wai,0,0,0,0,0,0,0,0,Saturday
2022-10-22,Hong Kong-Zhuhai-Macao Bridge,159,21,80,260,218,118,23,359,Saturday
2022-10-22,Lok Ma Chau,0,0,0,0,0,0,0,0,Saturday
2022-10-22,Man Kam To,0,0,0,0,0,0,0,0,Saturday
2022-10-22,Sha Tau Kok,0,0,0,0,0,0,0,0,Saturday
2022-10-22,Shenzhen Bay,1301,324,15,1640,727,212,14,953,Saturday
2022-10-22,China Ferry Terminal,0,0,0,0,0,0,0,0,Saturday
2022-10-22,Harbour Control,0,0,0,0,0,0,0,0,Saturday
2022-10-22,Kai Tak Cruise Terminal,0,0,0,0,0,0,0,0,Saturday
2022-10-22,Macau Ferry Terminal,0,0,0,0,0,0,0,0,Saturday
2022-10-22,Total,9186,1423,1019,11628,9049,1287,1079,11415,Saturday
2022-10-23,Airport,9371,1085,1179,11635,8191,1235,1158,10584,Sunday
2022-10-23,Express Rail Link West Kowloon,0,0,0,0,0,0,0,0,Sunday
2022-10-23,Hung Hom,0,0,0,0,0,0,0,0,Sunday
2022-10-23,Lo Wu,0,0,0,0,0,0,0,0,Sunday
2022-10-23,Lok Ma Chau Spur Line,0,0,0,0,0,0,0,0,Sunday
2022-10-23,Heung Yuen Wai,0,0,0,0,0,0,0,0,Sunday
2022-10-23,Hong Kong-Zhuhai-Macao Bridge,205,29,26,260,227,157,25,409,Sunday
2022-10-23,Lok Ma Chau,0,0,0,0,0,0,0,0,Sunday
2022-10-23,Man Kam To,0,0,0,0,0,0,0,0,Sunday
2022-10-23,Sha Tau Kok,0,0,0,0,0,0,0,0,Sunday
2022-10-23,Shenzhen Bay,1529,284,32,1845,724,197,26,947,Sunday
2022-10-23,China Ferry Terminal,0,0,0,0,0,0,0,0,Sunday
2022-10-23,Harbour Control,0,0,0,0,0,0,0,0,Sunday
2022-10-23,Kai Tak Cruise Terminal,0,0,0,0,0,0,0,0,Sunday
2022-10-23,Macau Ferry Terminal,0,0,0,0,0,0,0,0,Sunday
2022-10-23,Total,11105,1398,1237,13740,9142,1589,1209,11940,Sunday
2022-10-24,Airport,7614,1487,989,10090,6420,664,752,7836,Monday
2022-10-24,Express Rail Link West Kowloon,0,0,0,0,0,0,0,0,Monday
2022-10-24,Hung Hom,0,0,0,0,0,0,0,0,Monday
2022-10-24,Lo Wu,0,0,0,0,0,0,0,0,Monday
2022-10-24,Lok Ma Chau Spur Line,0,0,0,0,0,0,0,0,Monday
2022-10-24,Heung Yuen Wai,0,0,0,0,0,0,0,0,Monday
2022-10-24,Hong Kong-Zhuhai-Macao Bridge,162,24,37,223,191,177,15,383,Monday
2022-10-24,Lok Ma Chau,0,0,0,0,0,0,0,0,Monday
2022-10-24,Man Kam To,0,0,0,0,0,0,0,0,Monday
2022-10-24,Sha Tau Kok,0,0,0,0,0,0,0,0,Monday
2022-10-24,Shenzhen Bay,1350,260,14,1624,790,288,34,1112,Monday
2022-10-24,China Ferry Terminal,0,0,0,0,0,0,0,0,Monday
2022-10-24,Harbour Control,0,0,0,0,0,0,0,0,Monday
2022-10-24,Kai Tak Cruise Terminal,0,0,0,0,0,0,0,0,Monday
2022-10-24,Macau Ferry Terminal,0,0,0,0,0,0,0,0,Monday
2022-10-24,Total,9126,1771,1040,11937,7401,1129,801,9331,Monday
2022-10-25,Airport,7123,1264,1078,9465,7031,1188,996,9215,Tuesday
2022-10-25,Express Rail Link West Kowloon,0,0,0,0,0,0,0,0,Tuesday
2022-10-25,Hung Hom,0,0,0,0,0,0,0,0,Tuesday
2022-10-25,Lo Wu,0,0,0,0,0,0,0,0,Tuesday
2022-10-25,Lok Ma Chau Spur Line,0,0,0,0,0,0,0,0,Tuesday
2022-10-25,Heung Yuen Wai,0,0,0,0,0,0,0,0,Tuesday
2022-10-25,Hong Kong-Zhuhai-Macao Bridge,147,30,21,198,226,145,35,406,Tuesday
2022-10-25,Lok Ma Chau,0,0,0,0,0,0,0,0,Tuesday
2022-10-25,Man Kam To,0,0,0,0,0,0,0,0,Tuesday
2022-10-25,Sha Tau Kok,0,0,0,0,0,0,0,0,Tuesday
2022-10-25,Shenzhen Bay,1476,224,36,1736,999,266,25,1290,Tuesday
2022-10-25,China Ferry Terminal,0,0,0,0,0,0,0,0,Tuesday
2022-10-25,Harbour Control,0,0,0,0,0,0,0,0,Tuesday
2022-10-25,Kai Tak Cruise Terminal,0,0,0,0,0,0,0,0,Tuesday
2022-10-25,Macau Ferry Terminal,0,0,0,0,0,0,0,0,Tuesday
2022-10-25,Total,8746,1518,1135,11399,8256,1599,1056,10911,Tuesday
2022-10-26,Airport,6179,1484,876,8539,7165,1021,1059,9245,Wednesday
2022-10-26,Express Rail Link West Kowloon,0,0,0,0,0,0,0,0,Wednesday
2022-10-26,Hung Hom,0,0,0,0,0,0,0,0,Wednesday
2022-10-26,Lo Wu,0,0,0,0,0,0,0,0,Wednesday
2022-10-26,Lok Ma Chau Spur Line,0,0,0,0,0,0,0,0,Wednesday
2022-10-26,Heung Yuen Wai,0,0,0,0,0,0,0,0,Wednesday
2022-10-26,Hong Kong-Zhuhai-Macao Bridge,170,21,54,245,214,158,24,396,Wednesday
2022-10-26,Lok Ma Chau,0,0,0,0,0,0,0,0,Wednesday
2022-10-26,Man Kam To,0,0,0,0,0,0,0,0,Wednesday
2022-10-26,Sha Tau Kok,0,0,0,0,0,0,0,0,Wednesday
2022-10-26,Shenzhen Bay,1470,257,26,1753,1067,265,20,1352,Wednesday
2022-10-26,China Ferry Terminal,0,0,0,0,0,0,0,0,Wednesday
2022-10-26,Harbour Control,0,0,0,0,0,0,0,0,Wednesday
2022-10-26,Kai Tak Cruise Terminal,0,0,0,0,0,0,0,0,Wednesday
2022-10-26,Macau Ferry Terminal,0,0,0,0,0,0,0,0,Wednesday
2022-10-26,Total,7819,1762,956,10537,8446,1444,1103,10993,Wednesday
2022-10-27,Airport,7221,1239,1162,9622,7389,874,894,9157,Thursday
2022-10-27,Express Rail Link West Kowloon,0,0,0,0,0,0,0,0,Thursday
2022-10-27,Hung Hom,0,0,0,0,0,0,0,0,Thursday
2022-10-27,Lo Wu,0,0,0,0,0,0,0,0,Thursday
2022-10-27,Lok Ma Chau Spur Line,0,0,0,0,0,0,0,0,Thursday
2022-10-27,Heung Yuen Wai,0,0,0,0,0,0,0,0,Thursday
2022-10-27,Hong Kong-Zhuhai-Macao Bridge,189,15,39,243,220,181,24,425,Thursday
2022-10-27,Lok Ma Chau,0,0,0,0,0,0,0,0,Thursday
2022-10-27,Man Kam To,0,0,0,0,0,0,0,0,Thursday
2022-10-27,Sha Tau Kok,0,0,0,0,0,0,0,0,Thursday
2022-10-27,Shenzhen Bay,1261,246,24,1531,1084,256,36,1376,Thursday
2022-10-27,China Ferry Terminal,0,0,0,0,0,0,0,0,Thursday
2022-10-27,Harbour Control,0,0,0,0,0,0,0,0,Thursday
2022-10-27,Kai Tak Cruise Terminal,0,0,0,0,0,0,0,0,Thursday
2022-10-27,Macau Ferry Terminal,0,0,0,0,0,0,0,0,Thursday
2022-10-27,Total,8671,1500,1225,11396,8693,1311,954,10958,Thursday
2022-10-28,Airport,8093,1580,1291,10964,9548,1587,1202,12337,Friday
2022-10-28,Express Rail Link West Kowloon,0,0,0,0,0,0,0,0,Friday
2022-10-28,Hung Hom,0,0,0,0,0,0,0,0,Friday
2022-10-28,Lo Wu,0,0,0,0,0,0,0,0,Friday
2022-10-28,Lok Ma Chau Spur Line,0,0,0,0,0,0,0,0,Friday
2022-10-28,Heung Yuen Wai,0,0,0,0,0,0,0,0,Friday
2022-10-28,Hong Kong-Zhuhai-Macao Bridge,178,13,42,233,210,173,35,418,Friday
2022-10-28,Lok Ma Chau,0,0,0,0,0,0,0,0,Friday
2022-10-28,Man Kam To,0,0,0,0,0,0,0,0,Friday
2022-10-28,Sha Tau Kok,0,0,0,0,0,0,0,0,Friday
2022-10-28,Shenzhen Bay,1376,259,44,1679,1063,280,38,1381,Friday
2022-10-28,China Ferry Terminal,0,0,0,0,0,0,0,0,Friday
2022-10-28,Harbour Control,0,0,0,0,0,0,0,0,Friday
2022-10-28,Kai Tak Cruise Terminal,0,0,0,0,0,0,0,0,Friday
2022-10-28,Macau Ferry Terminal,0,0,0,0,0,0,0,0,Friday
2022-10-28,Total,9647,1852,1377,12876,10821,2040,1275,14136,Friday
2022-10-30,Airport,10256,1345,1610,13211,8824,1140,1139,11103,Sunday
2022-10-30,Express Rail Link West Kowloon,0,0,0,0,0,0,0,0,Sunday
2022-10-30,Hung Hom,0,0,0,0,0,0,0,0,Sunday
2022-10-30,Lo Wu,0,0,0,0,0,0,0,0,Sunday
2022-10-30,Lok Ma Chau Spur Line,0,0,0,0,0,0,0,0,Sunday
2022-10-30,Heung Yuen Wai,0,0,0,0,0,0,0,0,Sunday
2022-10-30,Hong Kong-Zhuhai-Macao Bridge,224,26,36,286,237,176,46,459,Sunday
2022-10-30,Lok Ma Chau,0,0,0,0,0,0,0,0,Sunday
2022-10-30,Man Kam To,0,0,0,0,0,0,0,0,Sunday
2022-10-30,Sha Tau Kok,0,0,0,0,0,0,0,0,Sunday
2022-10-30,Shenzhen Bay,1626,263,27,1916,1076,281,40,1397,Sunday
2022-10-30,China Ferry Terminal,0,0,0,0,0,0,0,0,Sunday
2022-10-30,Harbour Control,0,0,0,0,0,0,0,0,Sunday
2022-10-30,Kai Tak Cruise Terminal,0,0,0,0,0,0,0,0,Sunday
2022-10-30,Macau Ferry Terminal,0,0,0,0,0,0,0,0,Sunday
2022-10-30,Total,12106,1634,1673,15413,10137,1597,1225,12959,Sunday
2022-10-29,Airport,7661,1136,1168,9965,8224,1011,1034,10269,Saturday
2022-10-29,Express Rail Link West Kowloon,0,0,0,0,0,0,0,0,Saturday
2022-10-29,Hung Hom,0,0,0,0,0,0,0,0,Saturday
2022-10-29,Lo Wu,0,0,0,0,0,0,0,0,Saturday
2022-10-29,Lok Ma Chau Spur Line,0,0,0,0,0,0,0,0,Saturday
2022-10-29,Heung Yuen Wai,0,0,0,0,0,0,0,0,Saturday
2022-10-29,Hong Kong-Zhuhai-Macao Bridge,170,44,55,269,192,163,30,385,Saturday
2022-10-29,Lok Ma Chau,0,0,0,0,0,0,0,0,Saturday
2022-10-29,Man Kam To,0,0,0,0,0,0,0,0,Saturday
2022-10-29,Sha Tau Kok,0,0,0,0,0,0,0,0,Saturday
2022-10-29,Shenzhen Bay,1375,325,27,1727,1026,316,20,1362,Saturday
2022-10-29,China Ferry Terminal,0,0,0,0,0,0,0,0,Saturday
2022-10-29,Harbour Control,0,0,0,0,0,0,0,0,Saturday
2022-10-29,Kai Tak Cruise Terminal,0,0,0,0,0,0,0,0,Saturday
2022-10-29,Macau Ferry Terminal,0,0,0,0,0,0,0,0,Saturday
2022-10-29,Total,9206,1505,1250,11961,9442,1490,1084,12016,Saturday
2022-10-31,Airport,7294,1217,1263,9774,7340,701,926,8967,Monday
2022-10-31,Express Rail Link West Kowloon,0,0,0,0,0,0,0,0,Monday
2022-10-31,Hung Hom,0,0,0,0,0,0,0,0,Monday
2022-10-31,Lo Wu,0,0,0,0,0,0,0,0,Monday
2022-10-31,Lok Ma Chau Spur Line,0,0,0,0,0,0,0,0,Monday
2022-10-31,Heung Yuen Wai,0,0,0,0,0,0,0,0,Monday
2022-10-31,Hong Kong-Zhuhai-Macao Bridge,196,30,49,275,169,213,32,414,Monday
2022-10-31,Lok Ma Chau,0,0,0,0,0,0,0,0,Monday
2022-10-31,Man Kam To,0,0,0,0,0,0,0,0,Monday
2022-10-31,Sha Tau Kok,0,0,0,0,0,0,0,0,Monday
2022-10-31,Shenzhen Bay,1472,237,44,1753,954,319,21,1294,Monday
2022-10-31,China Ferry Terminal,0,0,0,0,0,0,0,0,Monday
2022-10-31,Harbour Control,0,0,0,0,0,0,0,0,Monday
2022-10-31,Kai Tak Cruise Terminal,0,0,0,0,0,0,0,0,Monday
2022-10-31,Macau Ferry Terminal,0,0,0,0,0,0,0,0,Monday
2022-10-31,Total,8962,1484,1356,11802,8463,1233,979,10675,Monday
2022-11-01,Airport,7917,1284,1515,10716,9433,1385,1161,11979,Tuesday
2022-11-01,Express Rail Link West Kowloon,0,0,0,0,0,0,0,0,Tuesday
2022-11-01,Hung Hom,0,0,0,0,0,0,0,0,Tuesday
2022-11-01,Lo Wu,0,0,0,0,0,0,0,0,Tuesday
2022-11-01,Lok Ma Chau Spur Line,0,0,0,0,0,0,0,0,Tuesday
2022-11-01,Heung Yuen Wai,0,0,0,0,0,0,0,0,Tuesday
2022-11-01,Hong Kong-Zhuhai-Macao Bridge,179,30,45,254,260,161,45,466,Tuesday
2022-11-01,Lok Ma Chau,0,0,0,0,0,0,0,0,Tuesday
2022-11-01,Man Kam To,0,0,0,0,0,0,0,0,Tuesday
2022-11-01,Sha Tau Kok,0,0,0,0,0,0,0,0,Tuesday
2022-11-01,Shenzhen Bay,1386,286,57,1729,1083,248,24,1355,Tuesday
2022-11-01,China Ferry Terminal,0,0,0,0,0,0,0,0,Tuesday
2022-11-01,Harbour Control,0,0,0,0,0,0,0,0,Tuesday
2022-11-01,Kai Tak Cruise Terminal,0,0,0,0,0,0,0,0,Tuesday
2022-11-01,Macau Ferry Terminal,0,0,0,0,0,0,0,0,Tuesday
2022-11-01,Total,9482,1600,1617,12699,10776,1794,1230,13800,Tuesday
2022-11-03,Airport,7798,1521,1430,10749,9367,1104,1177,11648,Thursday
2022-11-03,Express Rail Link West Kowloon,0,0,0,0,0,0,0,0,Thursday
2022-11-03,Hung Hom,0,0,0,0,0,0,0,0,Thursday
2022-11-03,Lo Wu,0,0,0,0,0,0,0,0,Thursday
2022-11-03,Lok Ma Chau Spur Line,0,0,0,0,0,0,0,0,Thursday
2022-11-03,Heung Yuen Wai,0,0,0,0,0,0,0,0,Thursday
2022-11-03,Hong Kong-Zhuhai-Macao Bridge,144,17,45,206,244,149,52,445,Thursday
2022-11-03,Lok Ma Chau,0,0,0,0,0,0,0,0,Thursday
2022-11-03,Man Kam To,0,0,0,0,0,0,0,0,Thursday
2022-11-03,Sha Tau Kok,0,0,0,0,0,0,0,0,Thursday
2022-11-03,Shenzhen Bay,1255,242,44,1541,1060,280,33,1373,Thursday
2022-11-03,China Ferry Terminal,0,0,0,0,0,0,0,0,Thursday
2022-11-03,Harbour Control,0,0,0,0,0,0,0,0,Thursday
2022-11-03,Kai Tak Cruise Terminal,0,0,0,0,0,0,0,0,Thursday
2022-11-03,Macau Ferry Terminal,0,0,0,0,0,0,0,0,Thursday
2022-11-03,Total,9197,1780,1519,12496,10671,1533,1262,13466,Thursday
2022-11-02,Airport,7745,1315,1368,10428,8142,704,1022,9868,Wednesday
2022-11-02,Express Rail Link West Kowloon,0,0,0,0,0,0,0,0,Wednesday
2022-11-02,Hung Hom,0,0,0,0,0,0,0,0,Wednesday
2022-11-02,Lo Wu,0,0,0,0,0,0,0,0,Wednesday
2022-11-02,Lok Ma Chau Spur Line,0,0,0,0,0,0,0,0,Wednesday
2022-11-02,Heung Yuen Wai,0,0,0,0,0,0,0,0,Wednesday
2022-11-02,Hong Kong-Zhuhai-Macao Bridge,29,14,0,43,79,75,12,166,Wednesday
2022-11-02,Lok Ma Chau,0,0,0,0,0,0,0,0,Wednesday
2022-11-02,Man Kam To,0,0,0,0,0,0,0,0,Wednesday
2022-11-02,Sha Tau Kok,0,0,0,0,0,0,0,0,Wednesday
2022-11-02,Shenzhen Bay,648,221,34,903,972,306,44,1322,Wednesday
2022-11-02,China Ferry Terminal,0,0,0,0,0,0,0,0,Wednesday
2022-11-02,Harbour Control,0,0,0,0,0,0,0,0,Wednesday
2022-11-02,Kai Tak Cruise Terminal,0,0,0,0,0,0,0,0,Wednesday
2022-11-02,Macau Ferry Terminal,0,0,0,0,0,0,0,0,Wednesday
2022-11-02,Total,8422,1550,1402,11374,9193,1085,1078,11356,Wednesday
2022-11-04,Airport,8003,1384,1429,10816,9998,1315,1260,12573,Friday
2022-11-04,Express Rail Link West Kowloon,0,0,0,0,0,0,0,0,Friday
2022-11-04,Hung Hom,0,0,0,0,0,0,0,0,Friday
2022-11-04,Lo Wu,0,0,0,0,0,0,0,0,Friday
2022-11-04,Lok Ma Chau Spur Line,0,0,0,0,0,0,0,0,Friday
2022-11-04,Heung Yuen Wai,0,0,0,0,0,0,0,0,Friday
2022-11-04,Hong Kong-Zhuhai-Macao Bridge,180,26,40,246,256,190,34,480,Friday
2022-11-04,Lok Ma Chau,0,0,0,0,0,0,0,0,Friday
2022-11-04,Man Kam To,0,0,0,0,0,0,0,0,Friday
2022-11-04,Sha Tau Kok,0,0,0,0,0,0,0,0,Friday
2022-11-04,Shenzhen Bay,1071,255,44,1370,1046,318,34,1398,Friday
2022-11-04,China Ferry Terminal,0,0,0,0,0,0,0,0,Friday
2022-11-04,Harbour Control,0,0,0,0,0,0,0,0,Friday
2022-11-04,Kai Tak Cruise Terminal,0,0,0,0,0,0,0,0,Friday
2022-11-04,Macau Ferry Terminal,0,0,0,0,0,0,0,0,Friday
2022-11-04,Total,9254,1665,1513,12432,11300,1823,1328,14451,Friday
2022-11-05,Express Rail Link West Kowloon,0,0,0,0,0,0,0,0,Saturday
2022-11-05,Hung Hom,0,0,0,0,0,0,0,0,Saturday
2022-11-05,Lo Wu,0,0,0,0,0,0,0,0,Saturday
2022-11-05,Lok Ma Chau Spur Line,0,0,0,0,0,0,0,0,Saturday
2022-11-05,Heung Yuen Wai,0,0,0,0,0,0,0,0,Saturday
2022-11-05,Hong Kong-Zhuhai-Macao Bridge,154,36,58,248,223,172,14,409,Saturday
2022-11-05,Lok Ma Chau,0,0,0,0,0,0,0,0,Saturday
2022-11-05,Man Kam To,0,0,0,0,0,0,0,0,Saturday
2022-11-05,Sha Tau Kok,0,0,0,0,0,0,0,0,Saturday
2022-11-05,Shenzhen Bay,1355,319,31,1705,1012,324,35,1371,Saturday
2022-11-05,China Ferry Terminal,0,0,0,0,0,0,0,0,Saturday
2022-11-05,Harbour Control,0,0,0,0,0,0,0,0,Saturday
2022-11-05,Kai Tak Cruise Terminal,0,0,0,0,0,0,0,0,Saturday
2022-11-05,Macau Ferry Terminal,0,0,0,0,0,0,0,0,Saturday
2022-11-05,Total,10193,1825,1499,13517,11562,1553,1447,14562,Saturday
2022-11-06,Airport,12195,1717,1602,15514,10648,1460,1497,13605,Sunday
2022-11-06,Express Rail Link West Kowloon,0,0,0,0,0,0,0,0,Sunday
2022-11-06,Hung Hom,0,0,0,0,0,0,0,0,Sunday
2022-11-06,Lo Wu,0,0,0,0,0,0,0,0,Sunday
2022-11-06,Lok Ma Chau Spur Line,0,0,0,0,0,0,0,0,Sunday
2022-11-06,Heung Yuen Wai,0,0,0,0,0,0,0,0,Sunday
2022-11-06,Hong Kong-Zhuhai-Macao Bridge,199,50,42,291,236,161,34,431,Sunday
2022-11-06,Lok Ma Chau,0,0,0,0,0,0,0,0,Sunday
2022-11-06,Man Kam To,0,0,0,0,0,0,0,0,Sunday
2022-11-06,Sha Tau Kok,0,0,0,0,0,0,0,0,Sunday
2022-11-06,Shenzhen Bay,1333,313,33,1679,1030,300,35,1365,Sunday
2022-11-06,China Ferry Terminal,0,0,0,0,0,0,0,0,Sunday
2022-11-06,Harbour Control,0,0,0,0,0,0,0,0,Sunday
2022-11-06,Kai Tak Cruise Terminal,0,0,0,0,0,0,0,0,Sunday
2022-11-06,Macau Ferry Terminal,0,0,0,0,0,0,0,0,Sunday
2022-11-06,Total,13727,2080,1677,17484,11914,1921,1566,15401,Sunday
2022-11-07,Airport,9578,1625,1564,12767,7943,707,1486,10136,Monday
2022-11-07,Express Rail Link West Kowloon,0,0,0,0,0,0,0,0,Monday
2022-11-07,Hung Hom,0,0,0,0,0,0,0,0,Monday
2022-11-07,Lo Wu,0,0,0,0,0,0,0,0,Monday
2022-11-07,Lok Ma Chau Spur Line,0,0,0,0,0,0,0,0,Monday
2022-11-07,Heung Yuen Wai,0,0,0,0,0,0,0,0,Monday
2022-11-07,Hong Kong-Zhuhai-Macao Bridge,162,27,36,225,155,149,28,332,Monday
2022-11-07,Lok Ma Chau,0,0,0,0,0,0,0,0,Monday
2022-11-07,Man Kam To,0,0,0,0,0,0,0,0,Monday
2022-11-07,Sha Tau Kok,0,0,0,0,0,0,0,0,Monday
2022-11-07,Shenzhen Bay,1268,261,32,1561,1027,333,15,1375,Monday
2022-11-07,China Ferry Terminal,0,0,0,0,0,0,0,0,Monday
2022-11-07,Harbour Control,0,0,0,0,0,0,0,0,Monday
2022-11-07,Kai Tak Cruise Terminal,0,0,0,0,0,0,0,0,Monday
2022-11-07,Macau Ferry Terminal,0,0,0,0,0,0,0,0,Monday
2022-11-07,Total,11008,1913,1632,14553,9125,1189,1529,11843,Monday
2022-11-08,Airport,10344,1623,1618,13585,9191,1561,1392,12144,Tuesday
2022-11-08,Express Rail Link West Kowloon,0,0,0,0,0,0,0,0,Tuesday
2022-11-08,Hung Hom,0,0,0,0,0,0,0,0,Tuesday
2022-11-08,Lo Wu,0,0,0,0,0,0,0,0,Tuesday
2022-11-08,Lok Ma Chau Spur Line,0,0,0,0,0,0,0,0,Tuesday
2022-11-08,Heung Yuen Wai,0,0,0,0,0,0,0,0,Tuesday
2022-11-08,Hong Kong-Zhuhai-Macao Bridge,133,26,32,191,216,213,43,472,Tuesday
2022-11-08,Lok Ma Chau,0,0,0,0,0,0,0,0,Tuesday
2022-11-08,Man Kam To,0,0,0,0,0,0,0,0,Tuesday
2022-11-08,Sha Tau Kok,0,0,0,0,0,0,0,0,Tuesday
2022-11-08,Shenzhen Bay,1146,250,39,1435,1077,265,25,1367,Tuesday
2022-11-08,China Ferry Terminal,0,0,0,0,0,0,0,0,Tuesday
2022-11-08,Harbour Control,0,0,0,0,0,0,0,0,Tuesday
2022-11-08,Kai Tak Cruise Terminal,0,0,0,0,0,0,0,0,Tuesday
2022-11-08,Macau Ferry Terminal,0,0,0,0,0,0,0,0,Tuesday
2022-11-08,Total,11623,1899,1689,15211,10484,2039,1460,13983,Tuesday
2022-11-09,Airport,8458,1355,1511,11324,9195,1033,1257,11485,Wednesday
2022-11-09,Express Rail Link West Kowloon,0,0,0,0,0,0,0,0,Wednesday
2022-11-09,Hung Hom,0,0,0,0,0,0,0,0,Wednesday
2022-11-09,Lo Wu,0,0,0,0,0,0,0,0,Wednesday
2022-11-09,Lok Ma Chau Spur Line,0,0,0,0,0,0,0,0,Wednesday
2022-11-09,Heung Yuen Wai,0,0,0,0,0,0,0,0,Wednesday
2022-11-09,Hong Kong-Zhuhai-Macao Bridge,137,40,35,212,158,213,35,406,Wednesday
2022-11-09,Lok Ma Chau,0,0,0,0,0,0,0,0,Wednesday
2022-11-09,Man Kam To,0,0,0,0,0,0,0,0,Wednesday
2022-11-09,Sha Tau Kok,0,0,0,0,0,0,0,0,Wednesday
2022-11-09,Shenzhen Bay,1184,255,40,1479,1016,310,38,1364,Wednesday
2022-11-09,China Ferry Terminal,0,0,0,0,0,0,0,0,Wednesday
2022-11-09,Harbour Control,0,0,0,0,0,0,0,0,Wednesday
2022-11-09,Kai Tak Cruise Terminal,0,0,0,0,0,0,0,0,Wednesday
2022-11-09,Macau Ferry Terminal,0,0,0,0,0,0,0,0,Wednesday
2022-11-09,Total,9779,1650,1586,13015,10369,1556,1330,13255,Wednesday
2022-11-10,Airport,8298,1560,1452,11310,9884,1183,1348,12415,Thursday
2022-11-10,Express Rail Link West Kowloon,0,0,0,0,0,0,0,0,Thursday
2022-11-10,Hung Hom,0,0,0,0,0,0,0,0,Thursday
2022-11-10,Lo Wu,0,0,0,0,0,0,0,0,Thursday
2022-11-10,Lok Ma Chau Spur Line,0,0,0,0,0,0,0,0,Thursday
2022-11-10,Heung Yuen Wai,0,0,0,0,0,0,0,0,Thursday
2022-11-10,Hong Kong-Zhuhai-Macao Bridge,148,53,55,256,246,189,47,482,Thursday
2022-11-10,Lok Ma Chau,0,0,0,0,0,0,0,0,Thursday
2022-11-10,Man Kam To,0,0,0,0,0,0,0,0,Thursday
2022-11-10,Sha Tau Kok,0,0,0,0,0,0,0,0,Thursday
2022-11-10,Shenzhen Bay,1282,248,44,1574,739,204,27,970,Thursday
2022-11-10,China Ferry Terminal,0,0,0,0,0,0,0,0,Thursday
2022-11-10,Harbour Control,0,0,0,0,0,0,0,0,Thursday
2022-11-10,Kai Tak Cruise Terminal,0,0,0,0,0,0,0,0,Thursday
2022-12-27,Total,22593,1937,3206,27736,19617,2704,3499,25820,Tuesday
2022-11-10,Macau Ferry Terminal,0,0,0,0,0,0,0,0,Thursday
2022-11-10,Total,9728,1861,1551,13140,10869,1576,1422,13867,Thursday
2022-11-11,Airport,9493,1743,1736,12972,10549,2031,1496,14076,Friday
2022-11-11,Express Rail Link West Kowloon,0,0,0,0,0,0,0,0,Friday
2022-11-11,Hung Hom,0,0,0,0,0,0,0,0,Friday
2022-11-11,Lo Wu,0,0,0,0,0,0,0,0,Friday
2022-11-11,Lok Ma Chau Spur Line,0,0,0,0,0,0,0,0,Friday
2022-11-11,Heung Yuen Wai,0,0,0,0,0,0,0,0,Friday
2022-11-11,Hong Kong-Zhuhai-Macao Bridge,173,53,39,265,240,212,44,496,Friday
2022-11-11,Lok Ma Chau,0,0,0,0,0,0,0,0,Friday
2022-11-11,Man Kam To,0,0,0,0,0,0,0,0,Friday
2022-11-11,Sha Tau Kok,0,0,0,0,0,0,0,0,Friday
2022-11-11,Shenzhen Bay,1106,344,47,1497,719,198,19,936,Friday
2022-11-11,China Ferry Terminal,0,0,0,0,0,0,0,0,Friday
2022-11-11,Harbour Control,0,0,0,0,0,0,0,0,Friday
2022-11-11,Kai Tak Cruise Terminal,0,0,0,0,0,0,0,0,Friday
2022-11-11,Macau Ferry Terminal,0,0,0,0,0,0,0,0,Friday
2022-11-11,Total,10772,2140,1822,14734,11508,2441,1559,15508,Friday
2022-11-12,Airport,9824,1540,1559,12923,10945,1255,1650,13850,Saturday
2022-11-12,Express Rail Link West Kowloon,0,0,0,0,0,0,0,0,Saturday
2022-11-12,Hung Hom,0,0,0,0,0,0,0,0,Saturday
2022-11-12,Lo Wu,0,0,0,0,0,0,0,0,Saturday
2022-11-12,Lok Ma Chau Spur Line,0,0,0,0,0,0,0,0,Saturday
2022-11-12,Heung Yuen Wai,0,0,0,0,0,0,0,0,Saturday
2022-11-12,Hong Kong-Zhuhai-Macao Bridge,165,50,45,260,217,148,18,383,Saturday
2022-11-12,Lok Ma Chau,0,0,0,0,0,0,0,0,Saturday
2022-11-12,Man Kam To,0,0,0,0,0,0,0,0,Saturday
2022-11-12,Sha Tau Kok,0,0,0,0,0,0,0,0,Saturday
2022-11-12,Shenzhen Bay,1114,296,31,1441,708,215,28,951,Saturday
2022-11-12,China Ferry Terminal,0,0,0,0,0,0,0,0,Saturday
2022-11-12,Harbour Control,0,0,0,0,0,0,0,0,Saturday
2022-11-12,Kai Tak Cruise Terminal,0,0,0,0,0,0,0,0,Saturday
2022-11-12,Macau Ferry Terminal,0,0,0,0,0,0,0,0,Saturday
2022-11-12,Total,11103,1886,1635,14624,11870,1618,1696,15184,Saturday
2022-11-13,Airport,13043,1883,1941,16867,11348,1548,1567,14463,Sunday
2022-11-13,Express Rail Link West Kowloon,0,0,0,0,0,0,0,0,Sunday
2022-11-13,Hung Hom,0,0,0,0,0,0,0,0,Sunday
2022-11-13,Lo Wu,0,0,0,0,0,0,0,0,Sunday
2022-11-13,Lok Ma Chau Spur Line,0,0,0,0,0,0,0,0,Sunday
2022-11-13,Heung Yuen Wai,0,0,0,0,0,0,0,0,Sunday
2022-11-13,Hong Kong-Zhuhai-Macao Bridge,174,34,45,253,240,178,43,461,Sunday
2022-11-13,Lok Ma Chau,0,0,0,0,0,0,0,0,Sunday
2022-11-13,Man Kam To,0,0,0,0,0,0,0,0,Sunday
2022-11-13,Sha Tau Kok,0,0,0,0,0,0,0,0,Sunday
2022-11-13,Shenzhen Bay,1321,397,39,1757,760,237,26,1023,Sunday
2022-11-13,China Ferry Terminal,0,0,0,0,0,0,0,0,Sunday
2022-11-13,Harbour Control,0,0,0,0,0,0,0,0,Sunday
2022-11-13,Kai Tak Cruise Terminal,0,0,0,0,0,0,0,0,Sunday
2022-11-13,Macau Ferry Terminal,0,0,0,0,0,0,0,0,Sunday
2022-11-13,Total,14538,2314,2025,18877,12348,1963,1636,15947,Sunday
2022-11-14,Airport,10007,1758,1886,13651,8602,789,1160,10551,Monday
2022-11-14,Express Rail Link West Kowloon,0,0,0,0,0,0,0,0,Monday
2022-11-14,Hung Hom,0,0,0,0,0,0,0,0,Monday
2022-11-14,Lo Wu,0,0,0,0,0,0,0,0,Monday
2022-11-14,Lok Ma Chau Spur Line,0,0,0,0,0,0,0,0,Monday
2022-11-14,Heung Yuen Wai,0,0,0,0,0,0,0,0,Monday
2022-11-14,Hong Kong-Zhuhai-Macao Bridge,169,38,54,261,181,197,42,420,Monday
2022-11-14,Lok Ma Chau,0,0,0,0,0,0,0,0,Monday
2022-11-14,Man Kam To,0,0,0,0,0,0,0,0,Monday
2022-11-14,Sha Tau Kok,0,0,0,0,0,0,0,0,Monday
2022-11-14,Shenzhen Bay,1184,285,40,1509,723,206,25,954,Monday
2022-11-14,China Ferry Terminal,0,0,0,0,0,0,0,0,Monday
2022-11-14,Harbour Control,0,0,0,0,0,0,0,0,Monday
2022-11-14,Kai Tak Cruise Terminal,0,0,0,0,0,0,0,0,Monday
2022-11-14,Macau Ferry Terminal,0,0,0,0,0,0,0,0,Monday
2022-11-14,Total,11360,2081,1980,15421,9506,1192,1227,11925,Monday
2022-11-15,Airport,10338,1770,1799,13907,10065,2043,1640,13748,Tuesday
2022-11-15,Express Rail Link West Kowloon,0,0,0,0,0,0,0,0,Tuesday
2022-11-15,Hung Hom,0,0,0,0,0,0,0,0,Tuesday
2022-11-15,Lo Wu,0,0,0,0,0,0,0,0,Tuesday
2022-11-15,Lok Ma Chau Spur Line,0,0,0,0,0,0,0,0,Tuesday
2022-11-15,Heung Yuen Wai,0,0,0,0,0,0,0,0,Tuesday
2022-11-15,Hong Kong-Zhuhai-Macao Bridge,177,36,66,279,210,97,38,345,Tuesday
2022-11-15,Lok Ma Chau,0,0,0,0,0,0,0,0,Tuesday
2022-11-15,Man Kam To,0,0,0,0,0,0,0,0,Tuesday
2022-11-15,Sha Tau Kok,0,0,0,0,0,0,0,0,Tuesday
2022-11-15,Shenzhen Bay,1304,256,43,1603,784,204,23,1011,Tuesday
2022-11-15,China Ferry Terminal,0,0,0,0,0,0,0,0,Tuesday
2022-11-15,Harbour Control,0,0,0,0,0,0,0,0,Tuesday
2022-11-15,Kai Tak Cruise Terminal,0,0,0,0,0,0,0,0,Tuesday
2022-11-15,Macau Ferry Terminal,0,0,0,0,0,0,0,0,Tuesday
2022-11-15,Total,11819,2062,1908,15789,11059,2344,1701,15104,Tuesday
2022-11-16,Airport,9732,1693,1774,13199,9829,1299,1486,12614,Wednesday
2022-11-16,Express Rail Link West Kowloon,0,0,0,0,0,0,0,0,Wednesday
2022-11-16,Hung Hom,0,0,0,0,0,0,0,0,Wednesday
2022-11-16,Lo Wu,0,0,0,0,0,0,0,0,Wednesday
2022-11-16,Lok Ma Chau Spur Line,0,0,0,0,0,0,0,0,Wednesday
2022-11-16,Heung Yuen Wai,0,0,0,0,0,0,0,0,Wednesday
2022-11-16,Hong Kong-Zhuhai-Macao Bridge,193,35,57,285,152,93,13,258,Wednesday
2022-11-16,Lok Ma Chau,0,0,0,0,0,0,0,0,Wednesday
2022-11-16,Man Kam To,0,0,0,0,0,0,0,0,Wednesday
2022-11-16,Sha Tau Kok,0,0,0,0,0,0,0,0,Wednesday
2022-11-16,Shenzhen Bay,1258,218,45,1521,747,198,18,963,Wednesday
2022-11-16,China Ferry Terminal,0,0,0,0,0,0,0,0,Wednesday
2023-01-02,Total,33611,2169,2389,38169,14977,1779,7538,24294,Monday
2022-11-16,Harbour Control,0,0,0,0,0,0,0,0,Wednesday
2022-11-16,Kai Tak Cruise Terminal,0,0,0,0,0,0,0,0,Wednesday
2022-11-16,Macau Ferry Terminal,0,0,0,0,0,0,0,0,Wednesday
2022-11-16,Total,11183,1946,1876,15005,10728,1590,1517,13835,Wednesday
2022-11-17,Airport,8573,1607,1708,11888,9716,1322,1608,12646,Thursday
2022-11-17,Express Rail Link West Kowloon,0,0,0,0,0,0,0,0,Thursday
2022-11-17,Hung Hom,0,0,0,0,0,0,0,0,Thursday
2022-11-17,Lo Wu,0,0,0,0,0,0,0,0,Thursday
2022-11-17,Lok Ma Chau Spur Line,0,0,0,0,0,0,0,0,Thursday
2022-11-17,Heung Yuen Wai,0,0,0,0,0,0,0,0,Thursday
2022-11-17,Hong Kong-Zhuhai-Macao Bridge,186,24,58,268,184,101,39,324,Thursday
2022-11-17,Lok Ma Chau,0,0,0,0,0,0,0,0,Thursday
2022-11-17,Man Kam To,0,0,0,0,0,0,0,0,Thursday
2022-11-17,Sha Tau Kok,0,0,0,0,0,0,0,0,Thursday
2022-11-17,Shenzhen Bay,1195,212,29,1436,785,186,21,992,Thursday
2022-11-17,China Ferry Terminal,0,0,0,0,0,0,0,0,Thursday
2022-11-17,Harbour Control,0,0,0,0,0,0,0,0,Thursday
2022-11-17,Kai Tak Cruise Terminal,0,0,0,0,0,0,0,0,Thursday
2022-11-17,Macau Ferry Terminal,0,0,0,0,0,0,0,0,Thursday
2022-11-17,Total,9954,1843,1795,13592,10685,1609,1668,13962,Thursday
2022-11-18,Airport,9486,1491,1527,12504,11623,2142,1834,15599,Friday
2022-11-18,Express Rail Link West Kowloon,0,0,0,0,0,0,0,0,Friday
2022-11-18,Hung Hom,0,0,0,0,0,0,0,0,Friday
2022-11-18,Lo Wu,0,0,0,0,0,0,0,0,Friday
2022-11-18,Lok Ma Chau Spur Line,0,0,0,0,0,0,0,0,Friday
2022-11-18,Heung Yuen Wai,0,0,0,0,0,0,0,0,Friday
2022-11-18,Hong Kong-Zhuhai-Macao Bridge,185,42,42,269,204,104,23,331,Friday
2022-11-18,Lok Ma Chau,0,0,0,0,0,0,0,0,Friday
2022-11-18,Man Kam To,0,0,0,0,0,0,0,0,Friday
2022-11-18,Sha Tau Kok,0,0,0,0,0,0,0,0,Friday
2022-11-18,Shenzhen Bay,1240,255,36,1531,814,195,33,1042,Friday
2022-11-18,China Ferry Terminal,0,0,0,0,0,0,0,0,Friday
2022-11-18,Harbour Control,0,0,0,0,0,0,0,0,Friday
2022-11-18,Kai Tak Cruise Terminal,0,0,0,0,0,0,0,0,Friday
2022-11-18,Macau Ferry Terminal,0,0,0,0,0,0,0,0,Friday
2022-11-18,Total,10911,1788,1605,14304,12641,2441,1890,16972,Friday
2022-11-19,Airport,10866,1614,1813,14293,11424,1608,1751,14783,Saturday
2022-11-19,Express Rail Link West Kowloon,0,0,0,0,0,0,0,0,Saturday
2022-11-19,Hung Hom,0,0,0,0,0,0,0,0,Saturday
2022-11-19,Lo Wu,0,0,0,0,0,0,0,0,Saturday
2022-11-19,Lok Ma Chau Spur Line,0,0,0,0,0,0,0,0,Saturday
2022-11-19,Heung Yuen Wai,0,0,0,0,0,0,0,0,Saturday
2022-11-19,Hong Kong-Zhuhai-Macao Bridge,157,112,54,323,141,103,21,265,Saturday
2022-11-19,Lok Ma Chau,0,0,0,0,0,0,0,0,Saturday
2022-11-19,Man Kam To,0,0,0,0,0,0,0,0,Saturday
2022-11-19,Sha Tau Kok,0,0,0,0,0,0,0,0,Saturday
2022-11-19,Shenzhen Bay,1199,259,31,1489,806,231,31,1068,Saturday
2022-11-19,China Ferry Terminal,0,0,0,0,0,0,0,0,Saturday
2022-11-19,Harbour Control,0,0,0,0,0,0,0,0,Saturday
2022-11-19,Kai Tak Cruise Terminal,0,0,0,0,0,0,0,0,Saturday
2022-11-19,Macau Ferry Terminal,0,0,0,0,0,0,0,0,Saturday
2022-11-19,Total,12222,1985,1898,16105,12371,1942,1803,16116,Saturday
2022-11-21,Airport,11141,1853,1931,14925,8926,853,1438,11217,Monday
2022-11-21,Express Rail Link West Kowloon,0,0,0,0,0,0,0,0,Monday
2022-11-21,Hung Hom,0,0,0,0,0,0,0,0,Monday
2022-11-21,Lo Wu,0,0,0,0,0,0,0,0,Monday
2022-11-21,Lok Ma Chau Spur Line,0,0,0,0,0,0,0,0,Monday
2022-11-21,Heung Yuen Wai,0,0,0,0,0,0,0,0,Monday
2022-11-21,Hong Kong-Zhuhai-Macao Bridge,168,42,48,258,146,96,29,271,Monday
2022-11-21,Lok Ma Chau,0,0,0,0,0,0,0,0,Monday
2022-11-21,Man Kam To,0,0,0,0,0,0,0,0,Monday
2022-11-21,Sha Tau Kok,0,0,0,0,0,0,0,0,Monday
2022-11-21,Shenzhen Bay,1297,265,45,1607,787,214,15,1016,Monday
2022-11-21,China Ferry Terminal,0,0,0,0,0,0,0,0,Monday
2022-11-21,Harbour Control,0,0,0,0,0,0,0,0,Monday
2022-11-21,Kai Tak Cruise Terminal,0,0,0,0,0,0,0,0,Monday
2022-11-21,Macau Ferry Terminal,0,0,0,0,0,0,0,0,Monday
2022-11-21,Total,12606,2160,2024,16790,9859,1163,1482,12504,Monday
2022-11-20,Airport,13519,1540,1841,16900,12182,1953,1883,16018,Sunday
2022-11-20,Express Rail Link West Kowloon,0,0,0,0,0,0,0,0,Sunday
2022-11-20,Hung Hom,0,0,0,0,0,0,0,0,Sunday
2022-11-20,Lo Wu,0,0,0,0,0,0,0,0,Sunday
2022-11-20,Lok Ma Chau Spur Line,0,0,0,0,0,0,0,0,Sunday
2022-11-20,Heung Yuen Wai,0,0,0,0,0,0,0,0,Sunday
2022-11-20,Hong Kong-Zhuhai-Macao Bridge,209,55,50,314,202,101,36,339,Sunday
2022-11-20,Lok Ma Chau,0,0,0,0,0,0,0,0,Sunday
2022-11-20,Man Kam To,0,0,0,0,0,0,0,0,Sunday
2022-11-20,Sha Tau Kok,0,0,0,0,0,0,0,0,Sunday
2022-11-20,Shenzhen Bay,1448,307,22,1777,803,176,26,1005,Sunday
2022-11-20,China Ferry Terminal,0,0,0,0,0,0,0,0,Sunday
2022-11-20,Harbour Control,0,0,0,0,0,0,0,0,Sunday
2022-11-20,Kai Tak Cruise Terminal,0,0,0,0,0,0,0,0,Sunday
2022-11-20,Macau Ferry Terminal,0,0,0,0,0,0,0,0,Sunday
2022-11-20,Total,15176,1902,1913,18991,13187,2230,1945,17362,Sunday
2022-11-22,Airport,10615,1749,1821,14185,10187,1992,1706,13885,Tuesday
2022-11-22,Express Rail Link West Kowloon,0,0,0,0,0,0,0,0,Tuesday
2022-11-22,Hung Hom,0,0,0,0,0,0,0,0,Tuesday
2022-11-22,Lo Wu,0,0,0,0,0,0,0,0,Tuesday
2022-11-22,Lok Ma Chau Spur Line,0,0,0,0,0,0,0,0,Tuesday
2022-11-22,Heung Yuen Wai,0,0,0,0,0,0,0,0,Tuesday
2022-11-22,Hong Kong-Zhuhai-Macao Bridge,184,51,65,300,193,51,26,270,Tuesday
2022-11-22,Lok Ma Chau,0,0,0,0,0,0,0,0,Tuesday
2022-11-22,Man Kam To,0,0,0,0,0,0,0,0,Tuesday
2022-11-22,Sha Tau Kok,0,0,0,0,0,0,0,0,Tuesday
2023-01-03,Airport,22993,1663,2459,27115,14179,1652,4621,20452,Tuesday
2022-11-22,Shenzhen Bay,1322,232,45,1599,815,238,27,1080,Tuesday
2022-11-22,China Ferry Terminal,0,0,0,0,0,0,0,0,Tuesday
2022-11-22,Harbour Control,0,0,0,0,0,0,0,0,Tuesday
2022-11-22,Kai Tak Cruise Terminal,0,0,0,0,0,0,0,0,Tuesday
2022-11-22,Macau Ferry Terminal,0,0,0,0,0,0,0,0,Tuesday
2022-11-22,Total,12121,2032,1931,16084,11195,2281,1759,15235,Tuesday
2022-11-23,Airport,10487,1828,2093,14408,10281,1243,1491,13015,Wednesday
2022-11-23,Express Rail Link West Kowloon,0,0,0,0,0,0,0,0,Wednesday
2022-11-23,Hung Hom,0,0,0,0,0,0,0,0,Wednesday
2022-11-23,Lo Wu,0,0,0,0,0,0,0,0,Wednesday
2022-11-23,Lok Ma Chau Spur Line,0,0,0,0,0,0,0,0,Wednesday
2022-11-23,Heung Yuen Wai,0,0,0,0,0,0,0,0,Wednesday
2022-11-23,Hong Kong-Zhuhai-Macao Bridge,166,24,48,238,137,65,17,219,Wednesday
2022-11-23,Lok Ma Chau,0,0,0,0,0,0,0,0,Wednesday
2022-11-23,Man Kam To,0,0,0,0,0,0,0,0,Wednesday
2022-11-23,Sha Tau Kok,0,0,0,0,0,0,0,0,Wednesday
2022-11-23,Shenzhen Bay,1286,300,36,1622,813,243,16,1072,Wednesday
2022-11-23,China Ferry Terminal,0,0,0,0,0,0,0,0,Wednesday
2022-11-23,Harbour Control,0,0,0,0,0,0,0,0,Wednesday
2022-11-23,Kai Tak Cruise Terminal,0,0,0,0,0,0,0,0,Wednesday
2022-11-23,Macau Ferry Terminal,0,0,0,0,0,0,0,0,Wednesday
2022-11-23,Total,11939,2152,2177,16268,11231,1551,1524,14306,Wednesday
2022-11-25,Airport,9552,1508,1742,12802,11962,2122,1817,15901,Friday
2022-11-25,Express Rail Link West Kowloon,0,0,0,0,0,0,0,0,Friday
2022-11-25,Hung Hom,0,0,0,0,0,0,0,0,Friday
2022-11-25,Lo Wu,0,0,0,0,0,0,0,0,Friday
2022-11-25,Lok Ma Chau Spur Line,0,0,0,0,0,0,0,0,Friday
2022-11-25,Heung Yuen Wai,0,0,0,0,0,0,0,0,Friday
2022-11-25,Hong Kong-Zhuhai-Macao Bridge,194,30,42,266,228,59,43,330,Friday
2022-11-25,Lok Ma Chau,0,0,0,0,0,0,0,0,Friday
2022-11-25,Man Kam To,0,0,0,0,0,0,0,0,Friday
2022-11-25,Sha Tau Kok,0,0,0,0,0,0,0,0,Friday
2022-11-25,Shenzhen Bay,1366,266,46,1678,927,258,20,1205,Friday
2022-11-25,China Ferry Terminal,0,0,0,0,0,0,0,0,Friday
2022-11-25,Harbour Control,0,0,0,0,0,0,0,0,Friday
2022-11-25,Kai Tak Cruise Terminal,0,0,0,0,0,0,0,0,Friday
2022-11-25,Macau Ferry Terminal,0,0,0,0,0,0,0,0,Friday
2022-11-25,Total,11112,1804,1830,14746,13117,2439,1880,17436,Friday
2022-11-24,Airport,9100,1679,1876,12655,10825,1511,1660,13996,Thursday
2022-11-24,Express Rail Link West Kowloon,0,0,0,0,0,0,0,0,Thursday
2022-11-24,Hung Hom,0,0,0,0,0,0,0,0,Thursday
2022-11-24,Lo Wu,0,0,0,0,0,0,0,0,Thursday
2022-11-24,Lok Ma Chau Spur Line,0,0,0,0,0,0,0,0,Thursday
2022-11-24,Heung Yuen Wai,0,0,0,0,0,0,0,0,Thursday
2022-11-24,Hong Kong-Zhuhai-Macao Bridge,162,34,49,245,200,68,35,303,Thursday
2022-11-24,Lok Ma Chau,0,0,0,0,0,0,0,0,Thursday
2022-11-24,Man Kam To,0,0,0,0,0,0,0,0,Thursday
2022-11-24,Sha Tau Kok,0,0,0,0,0,0,0,0,Thursday
2022-11-24,Shenzhen Bay,1107,186,41,1334,884,258,24,1166,Thursday
2022-11-24,China Ferry Terminal,0,0,0,0,0,0,0,0,Thursday
2022-11-24,Harbour Control,0,0,0,0,0,0,0,0,Thursday
2022-11-24,Kai Tak Cruise Terminal,0,0,0,0,0,0,0,0,Thursday
2022-11-24,Macau Ferry Terminal,0,0,0,0,0,0,0,0,Thursday
2022-11-24,Total,10369,1899,1966,14234,11909,1837,1719,15465,Thursday
2022-11-27,Airport,14036,1654,2046,17736,12441,1864,2299,16604,Sunday
2022-11-27,Express Rail Link West Kowloon,0,0,0,0,0,0,0,0,Sunday
2022-11-27,Hung Hom,0,0,0,0,0,0,0,0,Sunday
2022-11-27,Lo Wu,0,0,0,0,0,0,0,0,Sunday
2022-11-27,Lok Ma Chau Spur Line,0,0,0,0,0,0,0,0,Sunday
2022-11-27,Heung Yuen Wai,0,0,0,0,0,0,0,0,Sunday
2022-11-27,Hong Kong-Zhuhai-Macao Bridge,184,28,68,280,208,65,30,303,Sunday
2022-11-27,Lok Ma Chau,0,0,0,0,0,0,0,0,Sunday
2022-11-27,Man Kam To,0,0,0,0,0,0,0,0,Sunday
2022-11-27,Sha Tau Kok,0,0,0,0,0,0,0,0,Sunday
2022-11-27,Shenzhen Bay,1406,246,33,1685,880,221,30,1131,Sunday
2022-11-27,China Ferry Terminal,0,0,0,0,0,0,0,0,Sunday
2022-11-27,Harbour Control,0,0,0,0,0,0,0,0,Sunday
2022-11-27,Kai Tak Cruise Terminal,0,0,0,0,0,0,0,0,Sunday
2022-11-27,Macau Ferry Terminal,0,0,0,0,0,0,0,0,Sunday
2022-11-27,Total,15626,1928,2147,19701,13529,2150,2359,18038,Sunday
2022-11-26,Airport,11434,1539,1876,14849,11791,1375,2142,15308,Saturday
2022-11-26,Express Rail Link West Kowloon,0,0,0,0,0,0,0,0,Saturday
2022-11-26,Hung Hom,0,0,0,0,0,0,0,0,Saturday
2022-11-26,Lo Wu,0,0,0,0,0,0,0,0,Saturday
2022-11-26,Lok Ma Chau Spur Line,0,0,0,0,0,0,0,0,Saturday
2022-11-26,Heung Yuen Wai,0,0,0,0,0,0,0,0,Saturday
2022-11-26,Hong Kong-Zhuhai-Macao Bridge,194,34,57,285,175,46,16,237,Saturday
2022-11-26,Lok Ma Chau,0,0,0,0,0,0,0,0,Saturday
2022-11-26,Man Kam To,0,0,0,0,0,0,0,0,Saturday
2022-11-26,Sha Tau Kok,0,0,0,0,0,0,0,0,Saturday
2022-11-26,Shenzhen Bay,1317,298,53,1668,863,280,24,1167,Saturday
2022-11-26,China Ferry Terminal,0,0,0,0,0,0,0,0,Saturday
2022-11-26,Harbour Control,0,0,0,0,0,0,0,0,Saturday
2022-11-26,Kai Tak Cruise Terminal,0,0,0,0,0,0,0,0,Saturday
2022-11-26,Macau Ferry Terminal,0,0,0,0,0,0,0,0,Saturday
2022-11-26,Total,12945,1871,1986,16802,12829,1701,2182,16712,Saturday
2022-11-28,Airport,11650,1672,1851,15173,9346,959,1838,12143,Monday
2022-11-28,Express Rail Link West Kowloon,0,0,0,0,0,0,0,0,Monday
2022-11-28,Hung Hom,0,0,0,0,0,0,0,0,Monday
2022-11-28,Lo Wu,0,0,0,0,0,0,0,0,Monday
2022-11-28,Lok Ma Chau Spur Line,0,0,0,0,0,0,0,0,Monday
2022-11-28,Heung Yuen Wai,0,0,0,0,0,0,0,0,Monday
2022-11-28,Hong Kong-Zhuhai-Macao Bridge,173,53,49,275,159,72,23,254,Monday
2022-11-28,Lok Ma Chau,0,0,0,0,0,0,0,0,Monday
2022-11-28,Man Kam To,0,0,0,0,0,0,0,0,Monday
2022-11-28,Sha Tau Kok,0,0,0,0,0,0,0,0,Monday
2022-11-28,Shenzhen Bay,1412,288,49,1749,886,258,18,1162,Monday
2022-11-28,China Ferry Terminal,0,0,0,0,0,0,0,0,Monday
2022-11-28,Harbour Control,0,0,0,0,0,0,0,0,Monday
2022-11-28,Kai Tak Cruise Terminal,0,0,0,0,0,0,0,0,Monday
2022-11-28,Macau Ferry Terminal,0,0,0,0,0,0,0,0,Monday
2022-11-28,Total,13235,2013,1949,17197,10391,1289,1879,13559,Monday
2022-11-29,Airport,11643,1667,1775,15085,10763,1763,2009,14535,Tuesday
2022-11-29,Express Rail Link West Kowloon,0,0,0,0,0,0,0,0,Tuesday
2022-11-29,Hung Hom,0,0,0,0,0,0,0,0,Tuesday
2022-11-29,Lo Wu,0,0,0,0,0,0,0,0,Tuesday
2022-11-29,Lok Ma Chau Spur Line,0,0,0,0,0,0,0,0,Tuesday
2022-11-29,Heung Yuen Wai,0,0,0,0,0,0,0,0,Tuesday
2022-11-29,Hong Kong-Zhuhai-Macao Bridge,181,56,65,302,234,68,58,360,Tuesday
2022-11-29,Lok Ma Chau,0,0,0,0,0,0,0,0,Tuesday
2022-11-29,Man Kam To,0,0,0,0,0,0,0,0,Tuesday
2022-11-29,Sha Tau Kok,0,0,0,0,0,0,0,0,Tuesday
2022-11-29,Shenzhen Bay,1381,244,53,1678,952,255,27,1234,Tuesday
2022-11-29,China Ferry Terminal,0,0,0,0,0,0,0,0,Tuesday
2022-11-29,Harbour Control,0,0,0,0,0,0,0,0,Tuesday
2022-11-29,Kai Tak Cruise Terminal,0,0,0,0,0,0,0,0,Tuesday
2022-11-29,Macau Ferry Terminal,0,0,0,0,0,0,0,0,Tuesday
2022-11-29,Total,13205,1967,1893,17065,11949,2086,2094,16129,Tuesday
2022-11-30,Airport,11598,1773,2051,15422,11573,1381,1902,14856,Wednesday
2022-11-30,Express Rail Link West Kowloon,0,0,0,0,0,0,0,0,Wednesday
2022-11-30,Hung Hom,0,0,0,0,0,0,0,0,Wednesday
2022-11-30,Lo Wu,0,0,0,0,0,0,0,0,Wednesday
2022-11-30,Lok Ma Chau Spur Line,0,0,0,0,0,0,0,0,Wednesday
2022-11-30,Heung Yuen Wai,0,0,0,0,0,0,0,0,Wednesday
2022-11-30,Hong Kong-Zhuhai-Macao Bridge,233,27,71,331,172,63,16,251,Wednesday
2022-11-30,Lok Ma Chau,0,0,0,0,0,0,0,0,Wednesday
2022-11-30,Man Kam To,0,0,0,0,0,0,0,0,Wednesday
2022-11-30,Sha Tau Kok,0,0,0,0,0,0,0,0,Wednesday
2022-11-30,Shenzhen Bay,2606,253,58,2917,958,211,24,1193,Wednesday
2022-11-30,China Ferry Terminal,0,0,0,0,0,0,0,0,Wednesday
2022-11-30,Harbour Control,0,0,0,0,0,0,0,0,Wednesday
2022-11-30,Kai Tak Cruise Terminal,0,0,0,0,0,0,0,0,Wednesday
2022-11-30,Macau Ferry Terminal,0,0,0,0,0,0,0,0,Wednesday
2022-11-30,Total,14437,2053,2180,18670,12703,1655,1942,16300,Wednesday
2022-12-01,Airport,10160,1461,2068,13689,14536,1598,2021,18155,Thursday
2022-12-01,Express Rail Link West Kowloon,0,0,0,0,0,0,0,0,Thursday
2022-12-01,Hung Hom,0,0,0,0,0,0,0,0,Thursday
2022-12-01,Lo Wu,0,0,0,0,0,0,0,0,Thursday
2022-12-01,Lok Ma Chau Spur Line,0,0,0,0,0,0,0,0,Thursday
2022-12-01,Heung Yuen Wai,0,0,0,0,0,0,0,0,Thursday
2022-12-01,Hong Kong-Zhuhai-Macao Bridge,228,45,83,356,217,95,51,363,Thursday
2022-12-01,Lok Ma Chau,0,0,0,0,0,0,0,0,Thursday
2022-12-01,Man Kam To,0,0,0,0,0,0,0,0,Thursday
2022-12-01,Sha Tau Kok,0,0,0,0,0,0,0,0,Thursday
2022-12-01,Shenzhen Bay,1302,269,43,1614,1061,228,14,1303,Thursday
2022-12-01,China Ferry Terminal,0,0,0,0,0,0,0,0,Thursday
2022-12-01,Harbour Control,0,0,0,0,0,0,0,0,Thursday
2022-12-01,Kai Tak Cruise Terminal,0,0,0,0,0,0,0,0,Thursday
2022-12-01,Macau Ferry Terminal,0,0,0,0,0,0,0,0,Thursday
2022-12-01,Total,11690,1775,2194,15659,15814,1921,2086,19821,Thursday
2022-12-02,Airport,9671,1609,1841,13121,13934,2068,1951,17953,Friday
2022-12-02,Express Rail Link West Kowloon,0,0,0,0,0,0,0,0,Friday
2022-12-02,Hung Hom,0,0,0,0,0,0,0,0,Friday
2022-12-02,Lo Wu,0,0,0,0,0,0,0,0,Friday
2022-12-02,Lok Ma Chau Spur Line,0,0,0,0,0,0,0,0,Friday
2022-12-02,Heung Yuen Wai,0,0,0,0,0,0,0,0,Friday
2022-12-02,Hong Kong-Zhuhai-Macao Bridge,213,54,60,327,244,73,35,352,Friday
2022-12-02,Lok Ma Chau,0,0,0,0,0,0,0,0,Friday
2022-12-02,Man Kam To,0,0,0,0,0,0,0,0,Friday
2022-12-02,Sha Tau Kok,0,0,0,0,0,0,0,0,Friday
2022-12-02,Shenzhen Bay,1078,212,48,1338,949,247,15,1211,Friday
2022-12-02,China Ferry Terminal,0,0,0,0,0,0,0,0,Friday
2022-12-02,Harbour Control,0,0,0,0,0,0,0,0,Friday
2022-12-02,Kai Tak Cruise Terminal,0,0,0,0,0,0,0,0,Friday
2022-12-02,Macau Ferry Terminal,0,0,0,0,0,0,0,0,Friday
2022-12-02,Total,10962,1875,1949,14786,15127,2388,2001,19516,Friday
2022-12-03,Airport,12634,1683,2285,16602,14484,1384,2076,17944,Saturday
2022-12-03,Express Rail Link West Kowloon,0,0,0,0,0,0,0,0,Saturday
2022-12-03,Hung Hom,0,0,0,0,0,0,0,0,Saturday
2022-12-03,Lo Wu,0,0,0,0,0,0,0,0,Saturday
2022-12-03,Lok Ma Chau Spur Line,0,0,0,0,0,0,0,0,Saturday
2022-12-03,Heung Yuen Wai,0,0,0,0,0,0,0,0,Saturday
2022-12-03,Hong Kong-Zhuhai-Macao Bridge,208,52,73,333,202,79,34,315,Saturday
2022-12-03,Lok Ma Chau,0,0,0,0,0,0,0,0,Saturday
2022-12-03,Man Kam To,0,0,0,0,0,0,0,0,Saturday
2022-12-03,Sha Tau Kok,0,0,0,0,0,0,0,0,Saturday
2022-12-03,Shenzhen Bay,1214,291,37,1542,991,248,28,1267,Saturday
2022-12-03,China Ferry Terminal,0,0,0,0,0,0,0,0,Saturday
2022-12-03,Harbour Control,0,0,0,0,0,0,0,0,Saturday
2022-12-03,Kai Tak Cruise Terminal,0,0,0,0,0,0,0,0,Saturday
2022-12-03,Macau Ferry Terminal,0,0,0,0,0,0,0,0,Saturday
2022-12-03,Total,14056,2026,2395,18477,15677,1711,2138,19526,Saturday
2022-12-04,Airport,15422,1822,2298,19542,14774,1780,2220,18774,Sunday
2022-12-04,Express Rail Link West Kowloon,0,0,0,0,0,0,0,0,Sunday
2022-12-04,Hung Hom,0,0,0,0,0,0,0,0,Sunday
2022-12-04,Lo Wu,0,0,0,0,0,0,0,0,Sunday
2022-12-04,Lok Ma Chau Spur Line,0,0,0,0,0,0,0,0,Sunday
2022-12-04,Heung Yuen Wai,0,0,0,0,0,0,0,0,Sunday
2022-12-04,Hong Kong-Zhuhai-Macao Bridge,247,42,92,381,232,74,43,349,Sunday
2022-12-04,Lok Ma Chau,0,0,0,0,0,0,0,0,Sunday
2022-12-04,Man Kam To,0,0,0,0,0,0,0,0,Sunday
2022-12-04,Sha Tau Kok,0,0,0,0,0,0,0,0,Sunday
2022-12-04,Shenzhen Bay,1220,287,54,1561,892,244,19,1155,Sunday
2022-12-04,China Ferry Terminal,0,0,0,0,0,0,0,0,Sunday
2022-12-04,Harbour Control,0,0,0,0,0,0,0,0,Sunday
2022-12-04,Kai Tak Cruise Terminal,0,0,0,0,0,0,0,0,Sunday
2022-12-04,Macau Ferry Terminal,0,0,0,0,0,0,0,0,Sunday
2022-12-04,Total,16889,2151,2444,21484,15898,2098,2282,20278,Sunday
2022-12-05,Airport,12263,2153,2355,16771,12015,1052,1998,15065,Monday
2022-12-05,Express Rail Link West Kowloon,0,0,0,0,0,0,0,0,Monday
2022-12-05,Hung Hom,0,0,0,0,0,0,0,0,Monday
2022-12-05,Lo Wu,0,0,0,0,0,0,0,0,Monday
2022-12-05,Lok Ma Chau Spur Line,0,0,0,0,0,0,0,0,Monday
2022-12-05,Heung Yuen Wai,0,0,0,0,0,0,0,0,Monday
2022-12-05,Hong Kong-Zhuhai-Macao Bridge,202,45,90,337,262,110,29,401,Monday
2022-12-05,Lok Ma Chau,0,0,0,0,0,0,0,0,Monday
2022-12-05,Man Kam To,0,0,0,0,0,0,0,0,Monday
2022-12-05,Sha Tau Kok,0,0,0,0,0,0,0,0,Monday
2022-12-05,Shenzhen Bay,1238,309,55,1602,1011,267,18,1296,Monday
2022-12-05,China Ferry Terminal,0,0,0,0,0,0,0,0,Monday
2022-12-05,Harbour Control,0,0,0,0,0,0,0,0,Monday
2022-12-05,Kai Tak Cruise Terminal,0,0,0,0,0,0,0,0,Monday
2022-12-05,Macau Ferry Terminal,0,0,0,0,0,0,0,0,Monday
2022-12-05,Total,13703,2507,2500,18710,13288,1429,2045,16762,Monday
2022-12-06,Airport,12881,1824,2245,16950,13100,1811,2072,16983,Tuesday
2022-12-06,Express Rail Link West Kowloon,0,0,0,0,0,0,0,0,Tuesday
2022-12-06,Hung Hom,0,0,0,0,0,0,0,0,Tuesday
2022-12-06,Lo Wu,0,0,0,0,0,0,0,0,Tuesday
2022-12-06,Lok Ma Chau Spur Line,0,0,0,0,0,0,0,0,Tuesday
2022-12-06,Heung Yuen Wai,0,0,0,0,0,0,0,0,Tuesday
2022-12-06,Hong Kong-Zhuhai-Macao Bridge,231,64,95,390,296,105,43,444,Tuesday
2022-12-06,Lok Ma Chau,0,0,0,0,0,0,0,0,Tuesday
2022-12-06,Man Kam To,0,0,0,0,0,0,0,0,Tuesday
2022-12-06,Sha Tau Kok,0,0,0,0,0,0,0,0,Tuesday
2022-12-06,Shenzhen Bay,1271,277,51,1599,1107,298,30,1435,Tuesday
2022-12-06,China Ferry Terminal,0,0,0,0,0,0,0,0,Tuesday
2022-12-06,Harbour Control,0,0,0,0,0,0,0,0,Tuesday
2022-12-06,Kai Tak Cruise Terminal,0,0,0,0,0,0,0,0,Tuesday
2022-12-06,Macau Ferry Terminal,0,0,0,0,0,0,0,0,Tuesday
2022-12-06,Total,14383,2165,2391,18939,14503,2214,2145,18862,Tuesday
2022-12-07,Airport,11288,1805,2231,15324,13426,1484,1954,16864,Wednesday
2022-12-07,Express Rail Link West Kowloon,0,0,0,0,0,0,0,0,Wednesday
2022-12-07,Hung Hom,0,0,0,0,0,0,0,0,Wednesday
2022-12-07,Lo Wu,0,0,0,0,0,0,0,0,Wednesday
2022-12-07,Lok Ma Chau Spur Line,0,0,0,0,0,0,0,0,Wednesday
2022-12-07,Heung Yuen Wai,0,0,0,0,0,0,0,0,Wednesday
2022-12-07,Hong Kong-Zhuhai-Macao Bridge,196,45,91,332,214,117,24,355,Wednesday
2022-12-07,Lok Ma Chau,0,0,0,0,0,0,0,0,Wednesday
2022-12-07,Man Kam To,0,0,0,0,0,0,0,0,Wednesday
2022-12-07,Sha Tau Kok,0,0,0,0,0,0,0,0,Wednesday
2022-12-07,Shenzhen Bay,1175,226,49,1450,1248,318,18,1584,Wednesday
2022-12-07,China Ferry Terminal,0,0,0,0,0,0,0,0,Wednesday
2022-12-07,Harbour Control,0,0,0,0,0,0,0,0,Wednesday
2022-12-07,Kai Tak Cruise Terminal,0,0,0,0,0,0,0,0,Wednesday
2022-12-07,Macau Ferry Terminal,0,0,0,0,0,0,0,0,Wednesday
2022-12-07,Total,12659,2076,2371,17106,14888,1919,1996,18803,Wednesday
2022-12-08,Airport,12594,1970,2439,17003,15881,1779,2230,19890,Thursday
2022-12-08,Express Rail Link West Kowloon,0,0,0,0,0,0,0,0,Thursday
2022-12-08,Hung Hom,0,0,0,0,0,0,0,0,Thursday
2022-12-08,Lo Wu,0,0,0,0,0,0,0,0,Thursday
2022-12-08,Lok Ma Chau Spur Line,0,0,0,0,0,0,0,0,Thursday
2022-12-08,Heung Yuen Wai,0,0,0,0,0,0,0,0,Thursday
2022-12-08,Hong Kong-Zhuhai-Macao Bridge,252,78,96,426,285,130,38,453,Thursday
2022-12-08,Lok Ma Chau,0,0,0,0,0,0,0,0,Thursday
2022-12-08,Man Kam To,0,0,0,0,0,0,0,0,Thursday
2022-12-08,Sha Tau Kok,0,0,0,0,0,0,0,0,Thursday
2022-12-08,Shenzhen Bay,1189,239,61,1489,1437,349,36,1822,Thursday
2022-12-08,China Ferry Terminal,0,0,0,0,0,0,0,0,Thursday
2022-12-08,Harbour Control,0,0,0,0,0,0,0,0,Thursday
2022-12-08,Kai Tak Cruise Terminal,0,0,0,0,0,0,0,0,Thursday
2022-12-08,Macau Ferry Terminal,0,0,0,0,0,0,0,0,Thursday
2022-12-08,Total,14035,2287,2596,18918,17603,2258,2304,22165,Thursday
2022-12-09,Airport,11923,1558,1926,15407,17345,2099,2445,21889,Friday
2022-12-09,Express Rail Link West Kowloon,0,0,0,0,0,0,0,0,Friday
2022-12-09,Hung Hom,0,0,0,0,0,0,0,0,Friday
2022-12-09,Lo Wu,0,0,0,0,0,0,0,0,Friday
2022-12-09,Lok Ma Chau Spur Line,0,0,0,0,0,0,0,0,Friday
2022-12-09,Heung Yuen Wai,0,0,0,0,0,0,0,0,Friday
2022-12-09,Hong Kong-Zhuhai-Macao Bridge,202,41,82,325,276,126,46,448,Friday
2022-12-09,Lok Ma Chau,0,0,0,0,0,0,0,0,Friday
2022-12-09,Man Kam To,0,0,0,0,0,0,0,0,Friday
2022-12-09,Sha Tau Kok,0,0,0,0,0,0,0,0,Friday
2022-12-09,Shenzhen Bay,1274,240,48,1562,1471,355,33,1859,Friday
2022-12-09,China Ferry Terminal,0,0,0,0,0,0,0,0,Friday
2022-12-09,Harbour Control,0,0,0,0,0,0,0,0,Friday
2022-12-09,Kai Tak Cruise Terminal,0,0,0,0,0,0,0,0,Friday
2022-12-09,Macau Ferry Terminal,0,0,0,0,0,0,0,0,Friday
2022-12-09,Total,13399,1839,2056,17294,19092,2580,2524,24196,Friday
2022-12-10,Airport,14662,1650,2289,18601,17157,1381,2428,20966,Saturday
2022-12-10,Express Rail Link West Kowloon,0,0,0,0,0,0,0,0,Saturday
2022-12-10,Hung Hom,0,0,0,0,0,0,0,0,Saturday
2022-12-10,Lo Wu,0,0,0,0,0,0,0,0,Saturday
2022-12-10,Lok Ma Chau Spur Line,0,0,0,0,0,0,0,0,Saturday
2022-12-10,Heung Yuen Wai,0,0,0,0,0,0,0,0,Saturday
2022-12-10,Hong Kong-Zhuhai-Macao Bridge,214,42,74,330,303,152,33,488,Saturday
2022-12-10,Lok Ma Chau,0,0,0,0,0,0,0,0,Saturday
2022-12-10,Man Kam To,0,0,0,0,0,0,0,0,Saturday
2022-12-10,Sha Tau Kok,0,0,0,0,0,0,0,0,Saturday
2022-12-10,Shenzhen Bay,1358,334,56,1748,1440,305,24,1769,Saturday
2022-12-10,China Ferry Terminal,0,0,0,0,0,0,0,0,Saturday
2022-12-10,Harbour Control,0,0,0,0,0,0,0,0,Saturday
2022-12-10,Kai Tak Cruise Terminal,0,0,0,0,0,0,0,0,Saturday
2022-12-10,Macau Ferry Terminal,0,0,0,0,0,0,0,0,Saturday
2022-12-10,Total,16234,2026,2419,20679,18900,1838,2485,23223,Saturday
2022-12-11,Airport,16886,1747,2232,20865,16632,1785,2473,20890,Sunday
2022-12-11,Express Rail Link West Kowloon,0,0,0,0,0,0,0,0,Sunday
2022-12-11,Hung Hom,0,0,0,0,0,0,0,0,Sunday
2022-12-11,Lo Wu,0,0,0,0,0,0,0,0,Sunday
2022-12-11,Lok Ma Chau Spur Line,0,0,0,0,0,0,0,0,Sunday
2022-12-11,Heung Yuen Wai,0,0,0,0,0,0,0,0,Sunday
2022-12-11,Hong Kong-Zhuhai-Macao Bridge,238,74,102,414,326,182,51,559,Sunday
2022-12-11,Lok Ma Chau,0,0,0,0,0,0,0,0,Sunday
2022-12-11,Man Kam To,0,0,0,0,0,0,0,0,Sunday
2022-12-11,Sha Tau Kok,0,0,0,0,0,0,0,0,Sunday
2022-12-11,Shenzhen Bay,1394,289,52,1735,1409,377,24,1810,Sunday
2022-12-11,China Ferry Terminal,0,0,0,0,0,0,0,0,Sunday
2022-12-11,Harbour Control,0,0,0,0,0,0,0,0,Sunday
2022-12-11,Kai Tak Cruise Terminal,0,0,0,0,0,0,0,0,Sunday
2022-12-11,Macau Ferry Terminal,0,0,0,0,0,0,0,0,Sunday
2022-12-11,Total,18518,2110,2386,23014,18367,2344,2548,23259,Sunday
2022-12-12,Airport,13944,1992,2220,18156,13291,1276,2359,16926,Monday
2022-12-12,Express Rail Link West Kowloon,0,0,0,0,0,0,0,0,Monday
2022-12-12,Hung Hom,0,0,0,0,0,0,0,0,Monday
2022-12-12,Lo Wu,0,0,0,0,0,0,0,0,Monday
2022-12-12,Lok Ma Chau Spur Line,0,0,0,0,0,0,0,0,Monday
2022-12-12,Heung Yuen Wai,0,0,0,0,0,0,0,0,Monday
2022-12-12,Hong Kong-Zhuhai-Macao Bridge,170,122,70,362,314,127,46,487,Monday
2022-12-12,Lok Ma Chau,0,0,0,0,0,0,0,0,Monday
2022-12-12,Man Kam To,0,0,0,0,0,0,0,0,Monday
2022-12-12,Sha Tau Kok,0,0,0,0,0,0,0,0,Monday
2022-12-12,Shenzhen Bay,1193,283,67,1543,1422,311,28,1761,Monday
2022-12-12,China Ferry Terminal,0,0,0,0,0,0,0,0,Monday
2022-12-12,Harbour Control,0,0,0,0,0,0,0,0,Monday
2022-12-12,Kai Tak Cruise Terminal,0,0,0,0,0,0,0,0,Monday
2022-12-12,Macau Ferry Terminal,0,0,0,0,0,0,0,0,Monday
2022-12-12,Total,15307,2397,2357,20061,15027,1714,2433,19174,Monday
2022-12-13,Airport,14009,1631,2217,17857,16260,1764,2294,20318,Tuesday
2022-12-13,Express Rail Link West Kowloon,0,0,0,0,0,0,0,0,Tuesday
2022-12-13,Hung Hom,0,0,0,0,0,0,0,0,Tuesday
2022-12-13,Lo Wu,0,0,0,0,0,0,0,0,Tuesday
2022-12-13,Lok Ma Chau Spur Line,0,0,0,0,0,0,0,0,Tuesday
2022-12-13,Heung Yuen Wai,0,0,0,0,0,0,0,0,Tuesday
2022-12-13,Hong Kong-Zhuhai-Macao Bridge,201,40,106,347,364,158,43,565,Tuesday
2022-12-13,Lok Ma Chau,0,0,0,0,0,0,0,0,Tuesday
2022-12-13,Man Kam To,0,0,0,0,0,0,0,0,Tuesday
2022-12-13,Sha Tau Kok,0,0,0,0,0,0,0,0,Tuesday
2022-12-13,Shenzhen Bay,1304,289,56,1649,1452,334,29,1815,Tuesday
2022-12-13,China Ferry Terminal,0,0,0,0,0,0,0,0,Tuesday
2022-12-13,Harbour Control,0,0,0,0,0,0,0,0,Tuesday
2022-12-13,Kai Tak Cruise Terminal,0,0,0,0,0,0,0,0,Tuesday
2022-12-13,Macau Ferry Terminal,0,0,0,0,0,0,0,0,Tuesday
2022-12-13,Total,15514,1960,2379,19853,18076,2256,2366,22698,Tuesday
2022-12-14,Airport,12465,1611,2138,16214,17645,1674,1977,21296,Wednesday
2022-12-14,Express Rail Link West Kowloon,0,0,0,0,0,0,0,0,Wednesday
2022-12-14,Hung Hom,0,0,0,0,0,0,0,0,Wednesday
2022-12-14,Lo Wu,0,0,0,0,0,0,0,0,Wednesday
2022-12-14,Lok Ma Chau Spur Line,0,0,0,0,0,0,0,0,Wednesday
2022-12-14,Heung Yuen Wai,0,0,0,0,0,0,0,0,Wednesday
2022-12-14,Hong Kong-Zhuhai-Macao Bridge,203,48,103,354,295,160,22,477,Wednesday
2022-12-14,Lok Ma Chau,0,0,0,0,0,0,0,0,Wednesday
2022-12-14,Man Kam To,0,0,0,0,0,0,0,0,Wednesday
2022-12-14,Sha Tau Kok,0,0,0,0,0,0,0,0,Wednesday
2022-12-14,Shenzhen Bay,1337,272,63,1672,1487,359,27,1873,Wednesday
2022-12-14,China Ferry Terminal,0,0,0,0,0,0,0,0,Wednesday
2022-12-14,Harbour Control,0,0,0,0,0,0,0,0,Wednesday
2022-12-14,Kai Tak Cruise Terminal,0,0,0,0,0,0,0,0,Wednesday
2022-12-14,Macau Ferry Terminal,0,0,0,0,0,0,0,0,Wednesday
2022-12-14,Total,14005,1931,2304,18240,19427,2193,2026,23646,Wednesday
2022-12-15,Airport,13640,1804,2637,18081,20820,1949,2177,24946,Thursday
2022-12-15,Express Rail Link West Kowloon,0,0,0,0,0,0,0,0,Thursday
2022-12-15,Hung Hom,0,0,0,0,0,0,0,0,Thursday
2022-12-15,Lo Wu,0,0,0,0,0,0,0,0,Thursday
2022-12-15,Lok Ma Chau Spur Line,0,0,0,0,0,0,0,0,Thursday
2022-12-15,Heung Yuen Wai,0,0,0,0,0,0,0,0,Thursday
2022-12-15,Hong Kong-Zhuhai-Macao Bridge,255,53,119,427,398,145,55,598,Thursday
2022-12-15,Lok Ma Chau,0,0,0,0,0,0,0,0,Thursday
2022-12-15,Man Kam To,0,0,0,0,0,0,0,0,Thursday
2022-12-15,Sha Tau Kok,0,0,0,0,0,0,0,0,Thursday
2022-12-15,Shenzhen Bay,1485,289,118,1892,1612,404,35,2051,Thursday
2022-12-15,China Ferry Terminal,0,0,0,0,0,0,0,0,Thursday
2022-12-15,Harbour Control,0,0,0,0,0,0,0,0,Thursday
2022-12-15,Kai Tak Cruise Terminal,0,0,0,0,0,0,0,0,Thursday
2022-12-15,Macau Ferry Terminal,0,0,0,0,0,0,0,0,Thursday
2022-12-15,Total,15380,2146,2874,20400,22830,2498,2267,27595,Thursday
2022-12-16,Airport,13427,1513,2506,17446,25521,2229,2142,29892,Friday
2022-12-28,Airport,19281,1627,3328,24236,14489,1592,3410,19491,Wednesday
2022-12-16,Express Rail Link West Kowloon,0,0,0,0,0,0,0,0,Friday
2022-12-16,Hung Hom,0,0,0,0,0,0,0,0,Friday
2022-12-16,Lo Wu,0,0,0,0,0,0,0,0,Friday
2022-12-16,Lok Ma Chau Spur Line,0,0,0,0,0,0,0,0,Friday
2022-12-16,Heung Yuen Wai,0,0,0,0,0,0,0,0,Friday
2022-12-16,Hong Kong-Zhuhai-Macao Bridge,284,45,140,469,445,142,36,623,Friday
2022-12-16,Lok Ma Chau,0,0,0,0,0,0,0,0,Friday
2022-12-16,Man Kam To,0,0,0,0,0,0,0,0,Friday
2022-12-16,Sha Tau Kok,0,0,0,0,0,0,0,0,Friday
2022-12-16,Shenzhen Bay,1565,258,80,1903,1819,431,29,2279,Friday
2022-12-16,China Ferry Terminal,0,0,0,0,0,0,0,0,Friday
2022-12-16,Harbour Control,0,0,0,0,0,0,0,0,Friday
2022-12-16,Kai Tak Cruise Terminal,0,0,0,0,0,0,0,0,Friday
2022-12-16,Macau Ferry Terminal,0,0,0,0,0,0,0,0,Friday
2022-12-16,Total,15276,1816,2726,19818,27785,2802,2207,32794,Friday
2022-12-17,Airport,15728,1409,2790,19927,25515,1436,1934,28885,Saturday
2022-12-17,Express Rail Link West Kowloon,0,0,0,0,0,0,0,0,Saturday
2022-12-17,Hung Hom,0,0,0,0,0,0,0,0,Saturday
2022-12-17,Lo Wu,0,0,0,0,0,0,0,0,Saturday
2022-12-17,Lok Ma Chau Spur Line,0,0,0,0,0,0,0,0,Saturday
2022-12-17,Heung Yuen Wai,0,0,0,0,0,0,0,0,Saturday
2022-12-17,Hong Kong-Zhuhai-Macao Bridge,309,25,158,492,474,134,39,647,Saturday
2022-12-17,Lok Ma Chau,0,0,0,0,0,0,0,0,Saturday
2022-12-17,Man Kam To,0,0,0,0,0,0,0,0,Saturday
2022-12-17,Sha Tau Kok,0,0,0,0,0,0,0,0,Saturday
2022-12-17,Shenzhen Bay,1502,300,80,1882,1846,432,34,2312,Saturday
2022-12-17,China Ferry Terminal,0,0,0,0,0,0,0,0,Saturday
2022-12-17,Harbour Control,0,0,0,0,0,0,0,0,Saturday
2022-12-17,Kai Tak Cruise Terminal,0,0,0,0,0,0,0,0,Saturday
2022-12-17,Macau Ferry Terminal,0,0,0,0,0,0,0,0,Saturday
2022-12-17,Total,17539,1734,3028,22301,27835,2002,2007,31844,Saturday
2022-12-18,Airport,17460,1449,2679,21588,23555,1650,2216,27421,Sunday
2022-12-18,Express Rail Link West Kowloon,0,0,0,0,0,0,0,0,Sunday
2022-12-18,Hung Hom,0,0,0,0,0,0,0,0,Sunday
2022-12-18,Lo Wu,0,0,0,0,0,0,0,0,Sunday
2022-12-18,Lok Ma Chau Spur Line,0,0,0,0,0,0,0,0,Sunday
2022-12-18,Heung Yuen Wai,0,0,0,0,0,0,0,0,Sunday
2022-12-18,Hong Kong-Zhuhai-Macao Bridge,337,63,176,576,544,155,72,771,Sunday
2022-12-18,Lok Ma Chau,0,0,0,0,0,0,0,0,Sunday
2022-12-18,Man Kam To,0,0,0,0,0,0,0,0,Sunday
2022-12-18,Sha Tau Kok,0,0,0,0,0,0,0,0,Sunday
2022-12-18,Shenzhen Bay,1473,336,96,1905,1784,467,41,2292,Sunday
2022-12-18,China Ferry Terminal,0,0,0,0,0,0,0,0,Sunday
2022-12-18,Harbour Control,0,0,0,0,0,0,0,0,Sunday
2022-12-18,Kai Tak Cruise Terminal,0,0,0,0,0,0,0,0,Sunday
2022-12-18,Macau Ferry Terminal,0,0,0,0,0,0,0,0,Sunday
2022-12-18,Total,19270,1848,2951,24069,25883,2272,2329,30484,Sunday
2022-12-19,Airport,13854,1716,2689,18259,19548,1320,2205,23073,Monday
2022-12-19,Express Rail Link West Kowloon,0,0,0,0,0,0,0,0,Monday
2022-12-19,Hung Hom,0,0,0,0,0,0,0,0,Monday
2022-12-19,Lo Wu,0,0,0,0,0,0,0,0,Monday
2022-12-19,Lok Ma Chau Spur Line,0,0,0,0,0,0,0,0,Monday
2022-12-19,Heung Yuen Wai,0,0,0,0,0,0,0,0,Monday
2022-12-19,Hong Kong-Zhuhai-Macao Bridge,311,38,215,564,487,147,91,725,Monday
2022-12-19,Lok Ma Chau,0,0,0,0,0,0,0,0,Monday
2022-12-19,Man Kam To,0,0,0,0,0,0,0,0,Monday
2022-12-19,Sha Tau Kok,0,0,0,0,0,0,0,0,Monday
2022-12-19,Shenzhen Bay,1305,254,80,1639,1772,402,41,2215,Monday
2022-12-19,China Ferry Terminal,0,0,0,0,0,0,0,0,Monday
2022-12-19,Harbour Control,0,0,0,0,0,0,0,0,Monday
2022-12-19,Kai Tak Cruise Terminal,0,0,0,0,0,0,0,0,Monday
2022-12-19,Macau Ferry Terminal,0,0,0,0,0,0,0,0,Monday
2022-12-19,Total,15470,2008,2984,20462,21807,1869,2337,26013,Monday
2022-12-20,Airport,14355,1922,3231,19508,22099,1793,2184,26076,Tuesday
2022-12-20,Express Rail Link West Kowloon,0,0,0,0,0,0,0,0,Tuesday
2022-12-20,Hung Hom,0,0,0,0,0,0,0,0,Tuesday
2022-12-20,Lo Wu,0,0,0,0,0,0,0,0,Tuesday
2022-12-20,Lok Ma Chau Spur Line,0,0,0,0,0,0,0,0,Tuesday
2022-12-20,Heung Yuen Wai,0,0,0,0,0,0,0,0,Tuesday
2022-12-20,Hong Kong-Zhuhai-Macao Bridge,361,32,194,587,551,131,101,783,Tuesday
2022-12-20,Lok Ma Chau,0,0,0,0,0,0,0,0,Tuesday
2022-12-20,Man Kam To,0,0,0,0,0,0,0,0,Tuesday
2022-12-20,Sha Tau Kok,0,0,0,0,0,0,0,0,Tuesday
2022-12-20,Shenzhen Bay,1717,278,108,2103,1792,407,28,2227,Tuesday
2022-12-20,China Ferry Terminal,0,0,0,0,0,0,0,0,Tuesday
2022-12-20,Harbour Control,0,0,0,0,0,0,0,0,Tuesday
2022-12-20,Kai Tak Cruise Terminal,0,0,0,0,0,0,0,0,Tuesday
2022-12-20,Macau Ferry Terminal,0,0,0,0,0,0,0,0,Tuesday
2022-12-20,Total,16433,2232,3533,22198,24442,2331,2313,29086,Tuesday
2022-12-21,Airport,12618,1766,3363,17747,22683,1381,2050,26114,Wednesday
2022-12-21,Express Rail Link West Kowloon,0,0,0,0,0,0,0,0,Wednesday
2022-12-21,Hung Hom,0,0,0,0,0,0,0,0,Wednesday
2022-12-21,Lo Wu,0,0,0,0,0,0,0,0,Wednesday
2022-12-21,Lok Ma Chau Spur Line,0,0,0,0,0,0,0,0,Wednesday
2022-12-21,Heung Yuen Wai,0,0,0,0,0,0,0,0,Wednesday
2022-12-21,Hong Kong-Zhuhai-Macao Bridge,339,47,127,513,555,137,108,800,Wednesday
2022-12-21,Lok Ma Chau,0,0,0,0,0,0,0,0,Wednesday
2022-12-21,Man Kam To,0,0,0,0,0,0,0,0,Wednesday
2022-12-21,Sha Tau Kok,0,0,0,0,0,0,0,0,Wednesday
2022-12-21,Shenzhen Bay,1553,256,93,1902,1708,392,24,2124,Wednesday
2022-12-21,China Ferry Terminal,0,0,0,0,0,0,0,0,Wednesday
2022-12-21,Harbour Control,0,0,0,0,0,0,0,0,Wednesday
2022-12-21,Kai Tak Cruise Terminal,0,0,0,0,0,0,0,0,Wednesday
2022-12-21,Macau Ferry Terminal,0,0,0,0,0,0,0,0,Wednesday
2022-12-22,Express Rail Link West Kowloon,0,0,0,0,0,0,0,0,Thursday
2022-12-22,Hung Hom,0,0,0,0,0,0,0,0,Thursday
2022-12-22,Lo Wu,0,0,0,0,0,0,0,0,Thursday
2022-12-22,Lok Ma Chau Spur Line,0,0,0,0,0,0,0,0,Thursday
2022-12-22,Heung Yuen Wai,0,0,0,0,0,0,0,0,Thursday
2022-12-22,Hong Kong-Zhuhai-Macao Bridge,326,36,139,501,574,137,92,803,Thursday
2022-12-22,Lok Ma Chau,0,0,0,0,0,0,0,0,Thursday
2022-12-22,Man Kam To,0,0,0,0,0,0,0,0,Thursday
2022-12-22,Sha Tau Kok,0,0,0,0,0,0,0,0,Thursday
2022-12-22,Shenzhen Bay,1326,279,93,1698,1712,419,36,2167,Thursday
2022-12-22,China Ferry Terminal,0,0,0,0,0,0,0,0,Thursday
2022-12-22,Harbour Control,0,0,0,0,0,0,0,0,Thursday
2022-12-22,Kai Tak Cruise Terminal,0,0,0,0,0,0,0,0,Thursday
2022-12-22,Macau Ferry Terminal,0,0,0,0,0,0,0,0,Thursday
2022-12-22,Total,14976,2532,3905,21413,27607,2109,2081,31797,Thursday
2022-12-23,Airport,12280,1922,3800,18002,25484,1924,1776,29184,Friday
2022-12-23,Express Rail Link West Kowloon,0,0,0,0,0,0,0,0,Friday
2022-12-23,Hung Hom,0,0,0,0,0,0,0,0,Friday
2022-12-23,Lo Wu,0,0,0,0,0,0,0,0,Friday
2022-12-23,Lok Ma Chau Spur Line,0,0,0,0,0,0,0,0,Friday
2022-12-23,Heung Yuen Wai,0,0,0,0,0,0,0,0,Friday
2022-12-23,Hong Kong-Zhuhai-Macao Bridge,338,47,128,513,612,109,84,805,Friday
2022-12-23,Lok Ma Chau,0,0,0,0,0,0,0,0,Friday
2022-12-23,Man Kam To,0,0,0,0,0,0,0,0,Friday
2022-12-23,Sha Tau Kok,0,0,0,0,0,0,0,0,Friday
2022-12-23,Shenzhen Bay,1463,299,80,1842,1674,396,32,2102,Friday
2022-12-23,China Ferry Terminal,0,0,0,0,0,0,0,0,Friday
2022-12-23,Harbour Control,0,0,0,0,0,0,0,0,Friday
2022-12-23,Kai Tak Cruise Terminal,0,0,0,0,0,0,0,0,Friday
2022-12-23,Macau Ferry Terminal,0,0,0,0,0,0,0,0,Friday
2022-12-23,Total,14081,2268,4008,20357,27770,2429,1892,32091,Friday
2022-12-24,Airport,12545,1894,4034,18473,22479,1599,1751,25829,Saturday
2022-12-24,Express Rail Link West Kowloon,0,0,0,0,0,0,0,0,Saturday
2022-12-24,Hung Hom,0,0,0,0,0,0,0,0,Saturday
2022-12-24,Lo Wu,0,0,0,0,0,0,0,0,Saturday
2022-12-24,Lok Ma Chau Spur Line,0,0,0,0,0,0,0,0,Saturday
2022-12-24,Heung Yuen Wai,0,0,0,0,0,0,0,0,Saturday
2022-12-24,Hong Kong-Zhuhai-Macao Bridge,430,66,143,639,904,96,123,1123,Saturday
2022-12-24,Lok Ma Chau,0,0,0,0,0,0,0,0,Saturday
2022-12-24,Man Kam To,0,0,0,0,0,0,0,0,Saturday
2022-12-24,Sha Tau Kok,0,0,0,0,0,0,0,0,Saturday
2022-12-24,Shenzhen Bay,1298,308,114,1720,1593,441,27,2061,Saturday
2022-12-24,China Ferry Terminal,0,0,0,0,0,0,0,0,Saturday
2022-12-24,Harbour Control,0,0,0,0,0,0,0,0,Saturday
2022-12-24,Kai Tak Cruise Terminal,0,0,0,0,0,0,0,0,Saturday
2022-12-24,Macau Ferry Terminal,0,0,0,0,0,0,0,0,Saturday
2022-12-24,Total,14273,2268,4291,20832,24976,2136,1901,29013,Saturday
2022-12-25,Airport,13394,2463,3231,19088,20048,1967,2069,24084,Sunday
2022-12-25,Express Rail Link West Kowloon,0,0,0,0,0,0,0,0,Sunday
2022-12-25,Hung Hom,0,0,0,0,0,0,0,0,Sunday
2022-12-25,Lo Wu,0,0,0,0,0,0,0,0,Sunday
2022-12-25,Lok Ma Chau Spur Line,0,0,0,0,0,0,0,0,Sunday
2022-12-25,Heung Yuen Wai,0,0,0,0,0,0,0,0,Sunday
2022-12-25,Hong Kong-Zhuhai-Macao Bridge,506,78,149,733,1115,112,93,1320,Sunday
2022-12-25,Lok Ma Chau,0,0,0,0,0,0,0,0,Sunday
2022-12-25,Man Kam To,0,0,0,0,0,0,0,0,Sunday
2022-12-25,Sha Tau Kok,0,0,0,0,0,0,0,0,Sunday
2022-12-25,Shenzhen Bay,1099,251,112,1462,1572,520,25,2117,Sunday
2022-12-25,China Ferry Terminal,0,0,0,0,0,0,0,0,Sunday
2022-12-25,Harbour Control,0,0,0,0,0,0,0,0,Sunday
2022-12-25,Kai Tak Cruise Terminal,0,0,0,0,0,0,0,0,Sunday
2022-12-25,Macau Ferry Terminal,0,0,0,0,0,0,0,0,Sunday
2022-12-25,Total,14999,2792,3492,21283,22735,2599,2187,27521,Sunday
2022-12-26,Airport,14586,2247,3158,19991,16146,1869,2649,20664,Monday
2022-12-26,Express Rail Link West Kowloon,0,0,0,0,0,0,0,0,Monday
2022-12-26,Hung Hom,0,0,0,0,0,0,0,0,Monday
2022-12-26,Lo Wu,0,0,0,0,0,0,0,0,Monday
2022-12-26,Lok Ma Chau Spur Line,0,0,0,0,0,0,0,0,Monday
2022-12-26,Heung Yuen Wai,0,0,0,0,0,0,0,0,Monday
2022-12-26,Hong Kong-Zhuhai-Macao Bridge,743,47,168,958,1064,177,163,1404,Monday
2022-12-26,Lok Ma Chau,0,0,0,0,0,0,0,0,Monday
2022-12-26,Man Kam To,0,0,0,0,0,0,0,0,Monday
2022-12-26,Sha Tau Kok,0,0,0,0,0,0,0,0,Monday
2022-12-26,Shenzhen Bay,1282,251,66,1599,1905,542,20,2467,Monday
2022-12-26,China Ferry Terminal,0,0,0,0,0,0,0,0,Monday
2022-12-26,Harbour Control,0,0,0,0,0,0,0,0,Monday
2022-12-26,Kai Tak Cruise Terminal,0,0,0,0,0,0,0,0,Monday
2022-12-26,Macau Ferry Terminal,0,0,0,0,0,0,0,0,Monday
2022-12-26,Total,16611,2545,3392,22548,19115,2588,2832,24535,Monday
2022-12-27,Airport,20051,1595,2912,24558,17268,2007,3308,22583,Tuesday
2022-12-27,Express Rail Link West Kowloon,0,0,0,0,0,0,0,0,Tuesday
2022-12-27,Hung Hom,0,0,0,0,0,0,0,0,Tuesday
2022-12-27,Lo Wu,0,0,0,0,0,0,0,0,Tuesday
2022-12-27,Lok Ma Chau Spur Line,0,0,0,0,0,0,0,0,Tuesday
2022-12-27,Heung Yuen Wai,0,0,0,0,0,0,0,0,Tuesday
2022-12-27,Hong Kong-Zhuhai-Macao Bridge,1019,54,154,1227,922,170,139,1231,Tuesday
2022-12-27,Lok Ma Chau,0,0,0,0,0,0,0,0,Tuesday
2022-12-27,Man Kam To,0,0,0,0,0,0,0,0,Tuesday
2022-12-27,Sha Tau Kok,0,0,0,0,0,0,0,0,Tuesday
2022-12-27,Shenzhen Bay,1523,288,140,1951,1427,527,52,2006,Tuesday
2022-12-27,China Ferry Terminal,0,0,0,0,0,0,0,0,Tuesday
2022-12-27,Harbour Control,0,0,0,0,0,0,0,0,Tuesday
2022-12-27,Kai Tak Cruise Terminal,0,0,0,0,0,0,0,0,Tuesday
2022-12-27,Macau Ferry Terminal,0,0,0,0,0,0,0,0,Tuesday
2022-12-28,Express Rail Link West Kowloon,0,0,0,0,0,0,0,0,Wednesday
2022-12-28,Hung Hom,0,0,0,0,0,0,0,0,Wednesday
2022-12-28,Lo Wu,0,0,0,0,0,0,0,0,Wednesday
2022-12-28,Lok Ma Chau Spur Line,0,0,0,0,0,0,0,0,Wednesday
2022-12-28,Heung Yuen Wai,0,0,0,0,0,0,0,0,Wednesday
2022-12-28,Hong Kong-Zhuhai-Macao Bridge,1047,90,284,1421,980,123,194,1297,Wednesday
2022-12-28,Lok Ma Chau,0,0,0,0,0,0,0,0,Wednesday
2022-12-28,Man Kam To,0,0,0,0,0,0,0,0,Wednesday
2022-12-28,Sha Tau Kok,0,0,0,0,0,0,0,0,Wednesday
2022-12-28,Shenzhen Bay,1675,346,160,2181,1372,483,41,1896,Wednesday
2022-12-28,China Ferry Terminal,0,0,0,0,0,0,0,0,Wednesday
2022-12-28,Harbour Control,0,0,0,0,0,0,0,0,Wednesday
2022-12-28,Kai Tak Cruise Terminal,0,0,0,0,0,0,0,0,Wednesday
2022-12-28,Macau Ferry Terminal,0,0,0,0,0,0,0,0,Wednesday
2022-12-28,Total,22003,2063,3772,27838,16841,2198,3645,22684,Wednesday
2022-12-29,Airport,19251,2035,3625,24911,14954,1657,3478,20089,Thursday
2022-12-29,Express Rail Link West Kowloon,0,0,0,0,0,0,0,0,Thursday
2022-12-29,Hung Hom,0,0,0,0,0,0,0,0,Thursday
2022-12-29,Lo Wu,0,0,0,0,0,0,0,0,Thursday
2022-12-29,Lok Ma Chau Spur Line,0,0,0,0,0,0,0,0,Thursday
2022-12-29,Heung Yuen Wai,0,0,0,0,0,0,0,0,Thursday
2022-12-29,Hong Kong-Zhuhai-Macao Bridge,1073,72,390,1535,1027,92,237,1356,Thursday
2022-12-29,Lok Ma Chau,0,0,0,0,0,0,0,0,Thursday
2022-12-29,Man Kam To,0,0,0,0,0,0,0,0,Thursday
2022-12-29,Sha Tau Kok,0,0,0,0,0,0,0,0,Thursday
2022-12-29,Shenzhen Bay,1580,364,172,2116,1245,527,44,1816,Thursday
2022-12-29,China Ferry Terminal,0,0,0,0,0,0,0,0,Thursday
2022-12-29,Harbour Control,0,0,0,0,0,0,0,0,Thursday
2022-12-29,Kai Tak Cruise Terminal,0,0,0,0,0,0,0,0,Thursday
2022-12-29,Macau Ferry Terminal,0,0,0,0,0,0,0,0,Thursday
2022-12-29,Total,21904,2471,4187,28562,17226,2276,3759,23261,Thursday
2022-12-30,Airport,19571,1784,3585,24940,14655,1849,4052,20556,Friday
2022-12-30,Express Rail Link West Kowloon,0,0,0,0,0,0,0,0,Friday
2022-12-30,Hung Hom,0,0,0,0,0,0,0,0,Friday
2022-12-30,Lo Wu,0,0,0,0,0,0,0,0,Friday
2022-12-30,Lok Ma Chau Spur Line,0,0,0,0,0,0,0,0,Friday
2022-12-30,Heung Yuen Wai,0,0,0,0,0,0,0,0,Friday
2022-12-30,Hong Kong-Zhuhai-Macao Bridge,1291,71,484,1846,1338,88,264,1690,Friday
2022-12-30,Lok Ma Chau,0,0,0,0,0,0,0,0,Friday
2022-12-30,Man Kam To,0,0,0,0,0,0,0,0,Friday
2022-12-30,Sha Tau Kok,0,0,0,0,0,0,0,0,Friday
2022-12-30,Shenzhen Bay,1896,445,116,2457,572,312,41,925,Friday
2022-12-30,China Ferry Terminal,0,0,0,0,0,0,0,0,Friday
2022-12-30,Harbour Control,0,0,0,0,0,0,0,0,Friday
2022-12-30,Kai Tak Cruise Terminal,0,0,0,0,0,0,0,0,Friday
2022-12-30,Macau Ferry Terminal,0,0,0,0,0,0,0,0,Friday
2022-12-30,Total,22758,2300,4185,29243,16565,2249,4357,23171,Friday
2022-12-31,Airport,21316,1618,2512,25446,13335,1558,3255,18148,Saturday
2022-12-31,Express Rail Link West Kowloon,0,0,0,0,0,0,0,0,Saturday
2022-12-31,Hung Hom,0,0,0,0,0,0,0,0,Saturday
2022-12-31,Lo Wu,0,0,0,0,0,0,0,0,Saturday
2022-12-31,Lok Ma Chau Spur Line,0,0,0,0,0,0,0,0,Saturday
2022-12-31,Heung Yuen Wai,0,0,0,0,0,0,0,0,Saturday
2022-12-31,Hong Kong-Zhuhai-Macao Bridge,1240,91,769,2100,2091,91,299,2481,Saturday
2022-12-31,Lok Ma Chau,0,0,0,0,0,0,0,0,Saturday
2022-12-31,Man Kam To,0,0,0,0,0,0,0,0,Saturday
2022-12-31,Sha Tau Kok,0,0,0,0,0,0,0,0,Saturday
2022-12-31,Shenzhen Bay,1893,443,191,2527,604,290,22,916,Saturday
2022-12-31,China Ferry Terminal,0,0,0,0,0,0,0,0,Saturday
2022-12-31,Harbour Control,0,0,0,0,0,0,0,0,Saturday
2022-12-31,Kai Tak Cruise Terminal,0,0,0,0,0,0,0,0,Saturday
2022-12-31,Macau Ferry Terminal,0,0,0,0,0,0,0,0,Saturday
2022-12-31,Total,24449,2152,3472,30073,16030,1939,3576,21545,Saturday
2023-01-01,Airport,24925,1687,2456,29068,14591,1648,4644,20883,Sunday
2023-01-01,Express Rail Link West Kowloon,0,0,0,0,0,0,0,0,Sunday
2023-01-01,Hung Hom,0,0,0,0,0,0,0,0,Sunday
2023-01-01,Lo Wu,0,0,0,0,0,0,0,0,Sunday
2023-01-01,Lok Ma Chau Spur Line,0,0,0,0,0,0,0,0,Sunday
2023-01-01,Heung Yuen Wai,0,0,0,0,0,0,0,0,Sunday
2023-01-01,Hong Kong-Zhuhai-Macao Bridge,1882,90,504,2476,1677,84,549,2310,Sunday
2023-01-01,Lok Ma Chau,0,0,0,0,0,0,0,0,Sunday
2023-01-01,Man Kam To,0,0,0,0,0,0,0,0,Sunday
2023-01-01,Sha Tau Kok,0,0,0,0,0,0,0,0,Sunday
2023-01-01,Shenzhen Bay,1850,416,113,2379,581,381,16,978,Sunday
2023-01-01,China Ferry Terminal,0,0,0,0,0,0,0,0,Sunday
2023-01-01,Harbour Control,0,0,0,0,0,0,0,0,Sunday
2023-01-01,Kai Tak Cruise Terminal,0,0,0,0,0,0,0,0,Sunday
2023-01-01,Macau Ferry Terminal,0,0,0,0,0,0,0,0,Sunday
2023-01-01,Total,28657,2193,3073,33923,16849,2113,5209,24171,Sunday
2023-01-02,Airport,28258,1624,1857,31739,13367,1422,6713,21502,Monday
2023-01-02,Express Rail Link West Kowloon,0,0,0,0,0,0,0,0,Monday
2023-01-02,Hung Hom,0,0,0,0,0,0,0,0,Monday
2023-01-02,Lo Wu,0,0,0,0,0,0,0,0,Monday
2023-01-02,Lok Ma Chau Spur Line,0,0,0,0,0,0,0,0,Monday
2023-01-02,Heung Yuen Wai,0,0,0,0,0,0,0,0,Monday
2023-01-02,Hong Kong-Zhuhai-Macao Bridge,2424,60,402,2886,1188,117,813,2118,Monday
2023-01-02,Lok Ma Chau,0,0,0,0,0,0,0,0,Monday
2023-01-02,Man Kam To,0,0,0,0,0,0,0,0,Monday
2023-01-02,Sha Tau Kok,0,0,0,0,0,0,0,0,Monday
2023-01-02,Shenzhen Bay,2929,485,130,3544,422,240,12,674,Monday
2023-01-02,China Ferry Terminal,0,0,0,0,0,0,0,0,Monday
2023-01-02,Harbour Control,0,0,0,0,0,0,0,0,Monday
2023-01-02,Kai Tak Cruise Terminal,0,0,0,0,0,0,0,0,Monday
2023-01-02,Macau Ferry Terminal,0,0,0,0,0,0,0,0,Monday
2023-01-03,Express Rail Link West Kowloon,0,0,0,0,0,0,0,0,Tuesday
2023-01-03,Hung Hom,0,0,0,0,0,0,0,0,Tuesday
2023-01-03,Lo Wu,0,0,0,0,0,0,0,0,Tuesday
2023-01-03,Lok Ma Chau Spur Line,0,0,0,0,0,0,0,0,Tuesday
2023-01-03,Heung Yuen Wai,0,0,0,0,0,0,0,0,Tuesday
2023-01-03,Hong Kong-Zhuhai-Macao Bridge,1608,84,637,2329,1167,95,483,1745,Tuesday
2023-01-03,Lok Ma Chau,0,0,0,0,0,0,0,0,Tuesday
2023-01-03,Man Kam To,0,0,0,0,0,0,0,0,Tuesday
2023-01-03,Sha Tau Kok,0,0,0,0,0,0,0,0,Tuesday
2023-01-03,Shenzhen Bay,2184,532,184,2900,455,229,19,703,Tuesday
2023-01-03,China Ferry Terminal,0,0,0,0,0,0,0,0,Tuesday
2023-01-03,Harbour Control,0,0,0,0,0,0,0,0,Tuesday
2023-01-03,Kai Tak Cruise Terminal,0,0,0,0,0,0,0,0,Tuesday
2023-01-03,Macau Ferry Terminal,0,0,0,0,0,0,0,0,Tuesday
2023-01-03,Total,26785,2279,3280,32344,15801,1976,5123,22900,Tuesday
2023-01-04,Airport,21850,1886,2833,26569,14230,1533,3740,19503,Wednesday
2023-01-04,Express Rail Link West Kowloon,0,0,0,0,0,0,0,0,Wednesday
2023-01-04,Hung Hom,0,0,0,0,0,0,0,0,Wednesday
2023-01-04,Lo Wu,0,0,0,0,0,0,0,0,Wednesday
2023-01-04,Lok Ma Chau Spur Line,0,0,0,0,0,0,0,0,Wednesday
2023-01-04,Heung Yuen Wai,0,0,0,0,0,0,0,0,Wednesday
2023-01-04,Hong Kong-Zhuhai-Macao Bridge,1397,99,626,2122,1323,88,554,1965,Wednesday
2023-01-04,Lok Ma Chau,0,0,0,0,0,0,0,0,Wednesday
2023-01-04,Man Kam To,0,0,0,0,0,0,0,0,Wednesday
2023-01-04,Sha Tau Kok,0,0,0,0,0,0,0,0,Wednesday
2023-01-04,Shenzhen Bay,2366,550,218,3134,369,160,7,536,Wednesday
2023-01-04,China Ferry Terminal,0,0,0,0,0,0,0,0,Wednesday
2023-01-04,Harbour Control,0,0,0,0,0,0,0,0,Wednesday
2023-01-04,Kai Tak Cruise Terminal,0,0,0,0,0,0,0,0,Wednesday
2023-01-04,Macau Ferry Terminal,0,0,0,0,0,0,0,0,Wednesday
2023-01-04,Total,25613,2535,3677,31825,15922,1781,4301,22004,Wednesday
2023-01-05,Airport,18429,2304,3164,23897,14417,1434,3422,19273,Thursday
2023-01-05,Express Rail Link West Kowloon,0,0,0,0,0,0,0,0,Thursday
2023-01-05,Hung Hom,0,0,0,0,0,0,0,0,Thursday
2023-01-05,Lo Wu,0,0,0,0,0,0,0,0,Thursday
2023-01-05,Lok Ma Chau Spur Line,0,0,0,0,0,0,0,0,Thursday
2023-01-05,Heung Yuen Wai,0,0,0,0,0,0,0,0,Thursday
2023-01-05,Hong Kong-Zhuhai-Macao Bridge,1504,93,615,2212,1504,154,615,2273,Thursday
2023-01-05,Lok Ma Chau,0,0,0,0,0,0,0,0,Thursday
2023-01-05,Man Kam To,0,0,0,0,0,0,0,0,Thursday
2023-01-05,Sha Tau Kok,0,0,0,0,0,0,0,0,Thursday
2023-01-05,Shenzhen Bay,2601,603,318,3522,418,205,9,632,Thursday
2023-01-05,China Ferry Terminal,0,0,0,0,0,0,0,0,Thursday
2023-01-05,Harbour Control,0,0,0,0,0,0,0,0,Thursday
2023-01-05,Kai Tak Cruise Terminal,0,0,0,0,0,0,0,0,Thursday
2023-01-05,Macau Ferry Terminal,0,0,0,0,0,0,0,0,Thursday
2023-01-05,Total,22534,3000,4097,29631,16339,1793,4046,22178,Thursday
2023-01-06,Airport,19307,2468,3391,25166,15155,1684,3308,20147,Friday
2023-01-06,Express Rail Link West Kowloon,0,0,0,0,0,0,0,0,Friday
2023-01-06,Hung Hom,0,0,0,0,0,0,0,0,Friday
2023-01-06,Lo Wu,0,0,0,0,0,0,0,0,Friday
2023-01-06,Lok Ma Chau Spur Line,0,0,0,0,0,0,0,0,Friday
2023-01-06,Heung Yuen Wai,0,0,0,0,0,0,0,0,Friday
2023-01-06,Hong Kong-Zhuhai-Macao Bridge,1870,118,886,2874,1937,121,597,2655,Friday
2023-01-06,Lok Ma Chau,0,0,0,0,0,0,0,0,Friday
2023-01-06,Man Kam To,0,0,0,0,0,0,0,0,Friday
2023-01-06,Sha Tau Kok,0,0,0,0,0,0,0,0,Friday
2023-01-06,Shenzhen Bay,3056,826,200,4082,792,192,21,1005,Friday
2023-01-06,China Ferry Terminal,0,0,0,0,0,0,0,0,Friday
2023-01-06,Harbour Control,0,0,0,0,0,0,0,0,Friday
2023-01-06,Kai Tak Cruise Terminal,0,0,0,0,0,0,0,0,Friday
2023-01-06,Macau Ferry Terminal,0,0,0,0,0,0,0,0,Friday
2023-01-06,Total,24233,3412,4477,32122,17884,1997,3926,23807,Friday
2023-01-07,Airport,19863,2885,3456,26204,15927,1590,3585,21102,Saturday
2023-01-07,Express Rail Link West Kowloon,0,0,0,0,0,0,0,0,Saturday
2023-01-07,Hung Hom,0,0,0,0,0,0,0,0,Saturday
2023-01-07,Lo Wu,0,0,0,0,0,0,0,0,Saturday
2023-01-07,Lok Ma Chau Spur Line,0,0,0,0,0,0,0,0,Saturday
2023-01-07,Heung Yuen Wai,0,0,0,0,0,0,0,0,Saturday
2023-01-07,Hong Kong-Zhuhai-Macao Bridge,2052,165,1224,3441,2113,123,705,2941,Saturday
2023-01-07,Lok Ma Chau,0,0,0,0,0,0,0,0,Saturday
2023-01-07,Man Kam To,0,0,0,0,0,0,0,0,Saturday
2023-01-07,Sha Tau Kok,0,0,0,0,0,0,0,0,Saturday
2023-01-07,Shenzhen Bay,3932,1879,411,6222,1078,355,24,1457,Saturday
2023-01-07,China Ferry Terminal,0,0,0,0,0,0,0,0,Saturday
2023-01-07,Harbour Control,0,0,0,0,0,0,0,0,Saturday
2023-01-07,Kai Tak Cruise Terminal,0,0,0,0,0,0,0,0,Saturday
2023-01-07,Macau Ferry Terminal,0,0,0,0,0,0,0,0,Saturday
2023-01-07,Total,25847,4929,5091,35867,19118,2068,4314,25500,Saturday
2023-01-08,Airport,23121,3019,4135,30275,18344,2949,4410,25703,Sunday
2023-01-08,Express Rail Link West Kowloon,0,0,0,0,0,0,0,0,Sunday
2023-01-08,Hung Hom,0,0,0,0,0,0,0,0,Sunday
2023-01-08,Lo Wu,0,0,0,0,0,0,0,0,Sunday
2023-01-08,Lok Ma Chau Spur Line,4593,934,153,5680,14473,2415,245,17133,Sunday
2023-01-08,Heung Yuen Wai,0,0,0,0,0,0,0,0,Sunday
2023-01-08,Hong Kong-Zhuhai-Macao Bridge,4099,158,1064,5321,5566,560,1988,8114,Sunday
2023-01-08,Lok Ma Chau,0,0,0,0,0,0,0,0,Sunday
2023-01-08,Man Kam To,242,77,7,326,602,72,7,681,Sunday
2023-01-08,Sha Tau Kok,0,0,0,0,0,0,0,0,Sunday
2023-01-08,Shenzhen Bay,2388,825,330,3543,6323,2200,305,8828,Sunday
2023-01-08,China Ferry Terminal,29,12,1,42,38,12,4,54,Sunday
2023-01-08,Harbour Control,0,0,0,0,0,0,0,0,Sunday
2023-01-08,Kai Tak Cruise Terminal,0,0,0,0,0,0,0,0,Sunday
2023-02-19,Airport,19652,5012,7128,31792,16973,5504,8721,31198,Sunday
2023-01-08,Macau Ferry Terminal,691,21,199,911,1538,120,238,1896,Sunday
2023-01-08,Total,35163,5046,5889,46098,46884,8328,7197,62409,Sunday
2023-01-09,Airport,17190,3403,4203,24796,13750,2286,3384,19420,Monday
2023-01-09,Express Rail Link West Kowloon,0,0,0,0,0,0,0,0,Monday
2023-01-09,Hung Hom,0,0,0,0,0,0,0,0,Monday
2023-01-09,Lo Wu,0,0,0,0,0,0,0,0,Monday
2023-01-09,Lok Ma Chau Spur Line,5584,712,159,6455,9165,1332,124,10621,Monday
2023-01-09,Heung Yuen Wai,0,0,0,0,0,0,0,0,Monday
2023-01-09,Hong Kong-Zhuhai-Macao Bridge,3835,186,916,4937,4731,367,1051,6149,Monday
2023-01-09,Lok Ma Chau,0,0,0,0,0,0,0,0,Monday
2023-01-09,Man Kam To,363,53,11,427,417,64,2,483,Monday
2023-01-09,Sha Tau Kok,0,0,0,0,0,0,0,0,Monday
2023-01-09,Shenzhen Bay,2408,561,296,3265,4165,1432,220,5817,Monday
2023-01-09,China Ferry Terminal,3,8,2,13,23,15,1,39,Monday
2023-01-09,Harbour Control,0,0,0,0,0,0,0,0,Monday
2023-01-09,Kai Tak Cruise Terminal,0,0,0,0,0,0,0,0,Monday
2023-01-09,Macau Ferry Terminal,814,27,246,1087,1357,48,218,1623,Monday
2023-01-09,Total,30197,4950,5833,40980,33608,5544,5000,44152,Monday
2023-01-10,Airport,16424,3419,4169,24012,13894,2533,3931,20358,Tuesday
2023-01-10,Express Rail Link West Kowloon,0,0,0,0,0,0,0,0,Tuesday
2023-01-10,Hung Hom,0,0,0,0,0,0,0,0,Tuesday
2023-01-10,Lo Wu,0,0,0,0,0,0,0,0,Tuesday
2023-01-10,Lok Ma Chau Spur Line,6841,893,176,7910,10410,1382,130,11922,Tuesday
2023-01-10,Heung Yuen Wai,0,0,0,0,0,0,0,0,Tuesday
2023-01-10,Hong Kong-Zhuhai-Macao Bridge,4362,202,1053,5617,5047,377,1060,6484,Tuesday
2023-01-10,Lok Ma Chau,0,0,0,0,0,0,0,0,Tuesday
2023-01-10,Man Kam To,416,79,8,503,495,83,2,580,Tuesday
2023-01-10,Sha Tau Kok,0,0,0,0,0,0,0,0,Tuesday
2023-01-10,Shenzhen Bay,2826,723,381,3930,3936,1330,188,5454,Tuesday
2023-01-10,China Ferry Terminal,6,5,4,15,21,8,4,33,Tuesday
2023-01-10,Harbour Control,0,0,0,0,0,0,0,0,Tuesday
2023-01-10,Kai Tak Cruise Terminal,0,0,0,0,0,0,0,0,Tuesday
2023-01-10,Macau Ferry Terminal,1154,49,272,1475,1566,49,165,1780,Tuesday
2023-01-10,Total,32029,5370,6063,43462,35369,5762,5480,46611,Tuesday
2023-01-11,Airport,15408,3777,4088,23273,14288,2732,4596,21616,Wednesday
2023-01-11,Express Rail Link West Kowloon,0,0,0,0,0,0,0,0,Wednesday
2023-01-11,Hung Hom,0,0,0,0,0,0,0,0,Wednesday
2023-01-11,Lo Wu,0,0,0,0,0,0,0,0,Wednesday
2023-01-11,Lok Ma Chau Spur Line,7260,1118,216,8594,10245,1468,124,11837,Wednesday
2023-01-11,Heung Yuen Wai,0,0,0,0,0,0,0,0,Wednesday
2023-01-11,Hong Kong-Zhuhai-Macao Bridge,4849,232,1110,6191,5022,352,1183,6557,Wednesday
2023-01-11,Lok Ma Chau,0,0,0,0,0,0,0,0,Wednesday
2023-01-11,Man Kam To,433,79,18,530,485,65,5,555,Wednesday
2023-01-11,Sha Tau Kok,0,0,0,0,0,0,0,0,Wednesday
2023-01-11,Shenzhen Bay,2890,968,413,4271,3452,1671,171,5294,Wednesday
2023-01-11,China Ferry Terminal,4,5,6,15,35,13,3,51,Wednesday
2023-01-11,Harbour Control,0,0,0,0,0,0,0,0,Wednesday
2023-01-11,Kai Tak Cruise Terminal,0,0,0,0,0,0,0,0,Wednesday
2023-01-11,Macau Ferry Terminal,1220,47,345,1612,1661,40,248,1949,Wednesday
2023-01-11,Total,32064,6226,6196,44486,35188,6341,6330,47859,Wednesday
2023-01-12,Airport,15014,3769,4270,23053,15030,2686,4797,22513,Thursday
2023-01-12,Express Rail Link West Kowloon,0,0,0,0,0,0,0,0,Thursday
2023-01-12,Hung Hom,0,0,0,0,0,0,0,0,Thursday
2023-01-12,Lo Wu,0,0,0,0,0,0,0,0,Thursday
2023-01-12,Lok Ma Chau Spur Line,8373,1478,262,10113,11569,2310,137,14016,Thursday
2023-01-12,Heung Yuen Wai,0,0,0,0,0,0,0,0,Thursday
2023-01-12,Hong Kong-Zhuhai-Macao Bridge,5319,201,1179,6699,5857,448,1285,7590,Thursday
2023-01-12,Lok Ma Chau,0,0,0,0,0,0,0,0,Thursday
2023-01-12,Man Kam To,492,127,8,627,528,109,8,645,Thursday
2023-01-12,Sha Tau Kok,0,0,0,0,0,0,0,0,Thursday
2023-01-12,Shenzhen Bay,3355,1183,492,5030,4126,2239,191,6556,Thursday
2023-01-12,China Ferry Terminal,26,51,4,81,64,23,4,91,Thursday
2023-01-12,Harbour Control,0,0,0,0,0,0,0,0,Thursday
2023-01-12,Kai Tak Cruise Terminal,0,0,0,0,0,0,0,0,Thursday
2023-01-12,Macau Ferry Terminal,1351,59,365,1775,1892,53,223,2168,Thursday
2023-01-12,Total,33930,6868,6580,47378,39066,7868,6645,53579,Thursday
2023-01-13,Airport,15451,3834,4362,23647,15924,3286,5093,24303,Friday
2023-01-13,Express Rail Link West Kowloon,0,0,0,0,0,0,0,0,Friday
2023-01-13,Hung Hom,0,0,0,0,0,0,0,0,Friday
2023-01-13,Lo Wu,0,0,0,0,0,0,0,0,Friday
2023-01-13,Lok Ma Chau Spur Line,9517,2545,299,12361,14671,1881,140,16692,Friday
2023-01-13,Heung Yuen Wai,0,0,0,0,0,0,0,0,Friday
2023-01-13,Hong Kong-Zhuhai-Macao Bridge,6150,340,1682,8172,7334,303,1274,8911,Friday
2023-01-13,Lok Ma Chau,0,0,0,0,0,0,0,0,Friday
2023-01-13,Man Kam To,513,185,13,711,712,105,3,820,Friday
2023-01-13,Sha Tau Kok,0,0,0,0,0,0,0,0,Friday
2023-01-13,Shenzhen Bay,3823,1556,586,5965,5181,1833,161,7175,Friday
2023-01-13,China Ferry Terminal,215,74,28,317,174,63,8,245,Friday
2023-01-13,Harbour Control,0,0,0,0,0,0,0,0,Friday
2023-01-13,Kai Tak Cruise Terminal,0,0,0,0,0,0,0,0,Friday
2023-01-13,Macau Ferry Terminal,1537,77,513,2127,2340,39,233,2612,Friday
2023-01-13,Total,37206,8611,7483,53300,46336,7510,6912,60758,Friday
2023-01-14,Airport,17309,3548,3969,24826,17507,3075,5448,26030,Saturday
2023-01-14,Express Rail Link West Kowloon,0,0,0,0,0,0,0,0,Saturday
2023-01-14,Hung Hom,0,0,0,0,0,0,0,0,Saturday
2023-01-14,Lo Wu,0,0,0,0,0,0,0,0,Saturday
2023-01-14,Lok Ma Chau Spur Line,9426,3096,455,12977,15716,2476,141,18333,Saturday
2023-01-14,Heung Yuen Wai,0,0,0,0,0,0,0,0,Saturday
2023-01-14,Hong Kong-Zhuhai-Macao Bridge,6974,379,2838,10191,9203,447,2156,11806,Saturday
2023-01-14,Lok Ma Chau,0,0,0,0,0,0,0,0,Saturday
2023-01-14,Man Kam To,558,248,10,816,736,151,8,895,Saturday
2023-01-14,Sha Tau Kok,0,0,0,0,0,0,0,0,Saturday
2023-01-14,Shenzhen Bay,4006,1800,874,6680,5355,1939,160,7454,Saturday
2023-01-14,China Ferry Terminal,204,100,23,327,269,51,10,330,Saturday
2023-01-14,Harbour Control,0,0,0,0,0,0,0,0,Saturday
2023-01-14,Kai Tak Cruise Terminal,0,0,0,0,0,0,0,0,Saturday
2023-01-14,Macau Ferry Terminal,1711,101,875,2687,2887,69,315,3271,Saturday
2023-01-14,Total,40188,9272,9044,58504,51673,8208,8238,68119,Saturday
2023-01-15,Airport,20690,3469,3799,27958,17647,3631,6205,27483,Sunday
2023-01-15,Express Rail Link West Kowloon,3262,1205,252,4719,2648,1017,64,3729,Sunday
2023-01-15,Hung Hom,0,0,0,0,0,0,0,0,Sunday
2023-01-15,Lo Wu,0,0,0,0,0,0,0,0,Sunday
2023-01-15,Lok Ma Chau Spur Line,11775,2136,290,14201,12714,2900,156,15770,Sunday
2023-01-15,Heung Yuen Wai,0,0,0,0,0,0,0,0,Sunday
2023-01-15,Hong Kong-Zhuhai-Macao Bridge,9318,368,2209,11895,7344,520,3191,11055,Sunday
2023-01-15,Lok Ma Chau,0,0,0,0,0,0,0,0,Sunday
2023-01-15,Man Kam To,724,177,8,909,636,124,3,763,Sunday
2023-01-15,Sha Tau Kok,0,0,0,0,0,0,0,0,Sunday
2023-01-15,Shenzhen Bay,4394,1539,687,6620,4920,1908,189,7017,Sunday
2023-01-15,China Ferry Terminal,292,78,16,386,272,75,12,359,Sunday
2023-01-15,Harbour Control,0,0,0,0,0,0,0,0,Sunday
2023-01-15,Kai Tak Cruise Terminal,0,0,0,0,0,0,0,0,Sunday
2023-01-15,Macau Ferry Terminal,2726,101,407,3234,1912,87,488,2487,Sunday
2023-01-15,Total,53181,9073,7668,69922,48093,10262,10308,68663,Sunday
2023-01-16,Airport,15596,3389,3432,22417,13712,2934,4649,21295,Monday
2023-01-16,Express Rail Link West Kowloon,2822,1115,286,4223,2774,776,63,3613,Monday
2023-01-16,Hung Hom,0,0,0,0,0,0,0,0,Monday
2023-01-16,Lo Wu,0,0,0,0,0,0,0,0,Monday
2023-01-16,Lok Ma Chau Spur Line,9509,1974,244,11727,14264,2447,121,16832,Monday
2023-01-16,Heung Yuen Wai,0,0,0,0,0,0,0,0,Monday
2023-01-16,Hong Kong-Zhuhai-Macao Bridge,6541,342,1701,8584,6606,464,1840,8910,Monday
2023-01-16,Lok Ma Chau,0,0,0,0,0,0,0,0,Monday
2023-01-16,Man Kam To,670,231,20,921,783,192,3,978,Monday
2023-01-16,Sha Tau Kok,0,0,0,0,0,0,0,0,Monday
2023-01-16,Shenzhen Bay,3796,1592,433,5821,6274,1929,166,8369,Monday
2023-01-16,China Ferry Terminal,232,91,28,351,305,90,11,406,Monday
2023-01-16,Harbour Control,0,0,0,0,0,0,0,0,Monday
2023-01-16,Kai Tak Cruise Terminal,0,0,0,0,0,0,0,0,Monday
2023-01-16,Macau Ferry Terminal,1890,96,478,2464,2266,74,303,2643,Monday
2023-01-16,Total,41056,8830,6622,56508,46984,8906,7156,63046,Monday
2023-01-17,Airport,15066,3476,3125,21667,18842,2870,4633,26345,Tuesday
2023-01-17,Express Rail Link West Kowloon,2633,1407,264,4304,3760,1017,90,4867,Tuesday
2023-01-17,Hung Hom,0,0,0,0,0,0,0,0,Tuesday
2023-01-17,Lo Wu,0,0,0,0,0,0,0,0,Tuesday
2023-01-17,Lok Ma Chau Spur Line,8547,2303,236,11086,17334,2599,144,20077,Tuesday
2023-01-17,Heung Yuen Wai,0,0,0,0,0,0,0,0,Tuesday
2023-01-17,Hong Kong-Zhuhai-Macao Bridge,6215,441,1621,8277,6762,467,1568,8797,Tuesday
2023-01-17,Lok Ma Chau,0,0,0,0,0,0,0,0,Tuesday
2023-01-17,Man Kam To,630,270,10,910,938,223,8,1169,Tuesday
2023-01-17,Sha Tau Kok,0,0,0,0,0,0,0,0,Tuesday
2023-01-17,Shenzhen Bay,3551,1704,441,5696,7626,1976,165,9767,Tuesday
2023-01-17,China Ferry Terminal,218,111,20,349,390,89,17,496,Tuesday
2023-01-17,Harbour Control,0,0,0,0,0,0,0,0,Tuesday
2023-01-17,Kai Tak Cruise Terminal,0,0,0,0,0,0,0,0,Tuesday
2023-01-17,Macau Ferry Terminal,1777,101,433,2311,2039,86,333,2458,Tuesday
2023-01-17,Total,38637,9813,6150,54600,57691,9327,6958,73976,Tuesday
2023-01-18,Airport,15805,3984,3744,23533,24707,2837,4046,31590,Wednesday
2023-01-18,Express Rail Link West Kowloon,2835,1964,291,5090,6308,1198,85,7591,Wednesday
2023-01-18,Hung Hom,0,0,0,0,0,0,0,0,Wednesday
2023-01-18,Lo Wu,0,0,0,0,0,0,0,0,Wednesday
2023-01-18,Lok Ma Chau Spur Line,8127,2705,205,11037,29125,3599,150,32874,Wednesday
2023-01-18,Heung Yuen Wai,0,0,0,0,0,0,0,0,Wednesday
2023-01-18,Hong Kong-Zhuhai-Macao Bridge,6364,422,2200,8986,8519,593,1809,10921,Wednesday
2023-01-18,Lok Ma Chau,0,0,0,0,0,0,0,0,Wednesday
2023-01-18,Man Kam To,677,373,9,1059,1960,344,7,2311,Wednesday
2023-01-18,Sha Tau Kok,0,0,0,0,0,0,0,0,Wednesday
2023-01-18,Shenzhen Bay,3521,1830,351,5702,9752,2461,184,12397,Wednesday
2023-01-18,China Ferry Terminal,239,113,15,367,612,124,16,752,Wednesday
2023-01-18,Harbour Control,0,0,0,0,0,0,0,0,Wednesday
2023-01-18,Kai Tak Cruise Terminal,11,0,314,325,0,0,0,0,Wednesday
2023-01-18,Macau Ferry Terminal,1597,102,493,2192,2121,108,290,2519,Wednesday
2023-01-18,Total,39176,11493,7622,58291,83104,11264,6587,100955,Wednesday
2023-01-19,Airport,15193,4444,4389,24026,28640,2393,3684,34717,Thursday
2023-01-19,Express Rail Link West Kowloon,2749,2389,269,5407,7871,1192,99,9162,Thursday
2023-01-19,Hung Hom,0,0,0,0,0,0,0,0,Thursday
2023-01-19,Lo Wu,0,0,0,0,0,0,0,0,Thursday
2023-01-19,Lok Ma Chau Spur Line,7077,3359,164,10600,33878,3781,189,37848,Thursday
2023-01-19,Heung Yuen Wai,0,0,0,0,0,0,0,0,Thursday
2023-01-19,Hong Kong-Zhuhai-Macao Bridge,6393,474,2335,9202,10120,606,1943,12669,Thursday
2023-01-19,Lok Ma Chau,0,0,0,0,0,0,0,0,Thursday
2023-01-19,Man Kam To,592,381,7,980,2964,388,13,3365,Thursday
2023-01-19,Sha Tau Kok,0,0,0,0,0,0,0,0,Thursday
2023-01-19,Shenzhen Bay,3272,1859,291,5422,11156,2564,224,13944,Thursday
2023-01-19,China Ferry Terminal,225,133,23,381,1021,160,19,1200,Thursday
2023-01-19,Harbour Control,0,0,0,0,0,0,0,0,Thursday
2023-01-19,Kai Tak Cruise Terminal,0,0,0,0,32,0,254,286,Thursday
2023-01-19,Macau Ferry Terminal,2328,121,889,3338,3615,170,636,4421,Thursday
2023-01-19,Total,37829,13160,8367,59356,99297,11254,7061,117612,Thursday
2023-01-20,Airport,14481,4068,5256,23805,31647,1913,2809,36369,Friday
2023-01-20,Express Rail Link West Kowloon,2138,3299,330,5767,8696,748,58,9502,Friday
2023-01-20,Hung Hom,0,0,0,0,0,0,0,0,Friday
2023-01-20,Lo Wu,0,0,0,0,0,0,0,0,Friday
2023-01-20,Lok Ma Chau Spur Line,5817,3966,133,9916,39059,3512,184,42755,Friday
2023-01-20,Heung Yuen Wai,0,0,0,0,0,0,0,0,Friday
2023-01-20,Hong Kong-Zhuhai-Macao Bridge,6504,555,2819,9878,11301,453,2302,14056,Friday
2023-01-20,Lok Ma Chau,0,0,0,0,0,0,0,0,Friday
2023-01-20,Man Kam To,482,416,11,909,3483,321,8,3812,Friday
2023-01-20,Sha Tau Kok,0,0,0,0,0,0,0,0,Friday
2023-01-20,Shenzhen Bay,2470,2138,225,4833,12931,2470,206,15607,Friday
2023-01-20,China Ferry Terminal,188,204,23,415,1430,158,33,1621,Friday
2023-01-20,Harbour Control,0,0,0,0,0,0,0,0,Friday
2023-01-20,Kai Tak Cruise Terminal,0,0,0,0,0,0,0,0,Friday
2023-01-20,Macau Ferry Terminal,2992,246,1055,4293,4598,176,793,5567,Friday
2023-01-20,Total,35072,14892,9852,59816,113145,9751,6393,129289,Friday
2023-01-21,Airport,13577,2435,5535,21547,31799,1036,2422,35257,Saturday
2023-01-21,Express Rail Link West Kowloon,1129,2387,458,3974,8438,760,98,9296,Saturday
2023-01-21,Hung Hom,0,0,0,0,0,0,0,0,Saturday
2023-01-21,Lo Wu,0,0,0,0,0,0,0,0,Saturday
2023-01-21,Lok Ma Chau Spur Line,3767,2550,195,6512,33559,1755,143,35457,Saturday
2023-01-21,Heung Yuen Wai,0,0,0,0,0,0,0,0,Saturday
2023-01-21,Hong Kong-Zhuhai-Macao Bridge,5494,408,2739,8641,12532,354,2268,15154,Saturday
2023-01-21,Lok Ma Chau,0,0,0,0,0,0,0,0,Saturday
2023-01-21,Man Kam To,378,264,12,654,3252,163,15,3430,Saturday
2023-01-21,Sha Tau Kok,0,0,0,0,0,0,0,0,Saturday
2023-01-21,Shenzhen Bay,1272,1581,214,3067,11238,1109,154,12501,Saturday
2023-01-21,China Ferry Terminal,93,124,29,246,1688,136,14,1838,Saturday
2023-01-21,Harbour Control,0,0,0,0,0,0,0,0,Saturday
2023-01-21,Kai Tak Cruise Terminal,0,0,0,0,0,0,0,0,Saturday
2023-01-21,Macau Ferry Terminal,3241,204,1121,4566,6256,118,735,7109,Saturday
2023-01-21,Total,28951,9953,10303,49207,108762,5431,5849,120042,Saturday
2023-01-22,Airport,11142,3126,4307,18575,28517,1484,2934,32935,Sunday
2023-01-22,Express Rail Link West Kowloon,1133,2573,340,4046,8218,936,156,9310,Sunday
2023-01-22,Hung Hom,0,0,0,0,0,0,0,0,Sunday
2023-01-22,Lo Wu,0,0,0,0,0,0,0,0,Sunday
2023-01-22,Lok Ma Chau Spur Line,3406,1903,124,5433,21979,1555,114,23648,Sunday
2023-01-22,Heung Yuen Wai,0,0,0,0,0,0,0,0,Sunday
2023-01-22,Hong Kong-Zhuhai-Macao Bridge,10648,712,2838,14198,17912,588,1953,20453,Sunday
2023-01-22,Lok Ma Chau,0,0,0,0,0,0,0,0,Sunday
2023-01-22,Man Kam To,383,172,3,558,2865,150,11,3026,Sunday
2023-01-22,Sha Tau Kok,0,0,0,0,0,0,0,0,Sunday
2023-01-22,Shenzhen Bay,1310,1189,154,2653,7291,914,180,8385,Sunday
2023-01-22,China Ferry Terminal,114,190,10,314,758,37,10,805,Sunday
2023-01-22,Harbour Control,0,0,0,0,0,0,0,0,Sunday
2023-01-22,Kai Tak Cruise Terminal,0,0,0,0,0,0,0,0,Sunday
2023-01-22,Macau Ferry Terminal,3684,217,777,4678,7110,201,548,7859,Sunday
2023-01-22,Total,31820,10082,8553,50455,94650,5865,5906,106421,Sunday
2023-01-23,Airport,12358,4214,4380,20952,21687,1810,2898,26395,Monday
2023-01-23,Express Rail Link West Kowloon,2469,3878,351,6698,7550,1647,232,9429,Monday
2023-01-23,Hung Hom,0,0,0,0,0,0,0,0,Monday
2023-01-23,Lo Wu,0,0,0,0,0,0,0,0,Monday
2023-01-23,Lok Ma Chau Spur Line,6634,2947,127,9708,21171,2449,164,23784,Monday
2023-01-23,Heung Yuen Wai,0,0,0,0,0,0,0,0,Monday
2023-01-23,Hong Kong-Zhuhai-Macao Bridge,20725,992,4167,25884,26249,906,3567,30722,Monday
2023-01-23,Lok Ma Chau,0,0,0,0,0,0,0,0,Monday
2023-01-23,Man Kam To,542,270,2,814,2261,188,13,2462,Monday
2023-01-23,Sha Tau Kok,0,0,0,0,0,0,0,0,Monday
2023-01-23,Shenzhen Bay,2875,1841,178,4894,6639,1418,304,8361,Monday
2023-01-23,China Ferry Terminal,184,290,19,493,679,82,13,774,Monday
2023-01-23,Harbour Control,0,0,0,0,0,0,0,0,Monday
2023-01-23,Kai Tak Cruise Terminal,0,0,0,0,0,0,0,0,Monday
2023-01-23,Macau Ferry Terminal,6003,302,1197,7502,7689,306,715,8710,Monday
2023-01-23,Total,51790,14734,10421,76945,93925,8806,7906,110637,Monday
2023-01-25,Airport,25033,2938,3305,31276,19642,2668,3704,26014,Wednesday
2023-01-25,Express Rail Link West Kowloon,6761,2504,164,9429,4812,3492,437,8741,Wednesday
2023-01-25,Hung Hom,0,0,0,0,0,0,0,0,Wednesday
2023-01-25,Lo Wu,0,0,0,0,0,0,0,0,Wednesday
2023-01-25,Lok Ma Chau Spur Line,26869,4292,175,31336,11014,4087,213,15314,Wednesday
2023-01-25,Heung Yuen Wai,0,0,0,0,0,0,0,0,Wednesday
2023-01-25,Hong Kong-Zhuhai-Macao Bridge,34071,1614,4474,40159,22972,1459,5297,29728,Wednesday
2023-01-25,Lok Ma Chau,0,0,0,0,0,0,0,0,Wednesday
2023-01-25,Man Kam To,1962,367,12,2341,829,265,9,1103,Wednesday
2023-01-25,Sha Tau Kok,0,0,0,0,0,0,0,0,Wednesday
2023-01-25,Shenzhen Bay,11998,2504,195,14697,4590,2189,370,7149,Wednesday
2023-01-25,China Ferry Terminal,1132,449,30,1611,370,242,28,640,Wednesday
2023-01-25,Harbour Control,0,0,0,0,0,0,0,0,Wednesday
2023-01-25,Kai Tak Cruise Terminal,0,0,0,0,0,0,0,0,Wednesday
2023-01-25,Macau Ferry Terminal,7249,392,986,8627,5983,578,1393,7954,Wednesday
2023-01-25,Total,115075,15060,9341,139476,70212,14980,11451,96643,Wednesday
2023-01-24,Airport,16309,3690,4251,24250,19487,2219,4172,25878,Tuesday
2023-01-24,Express Rail Link West Kowloon,5442,4969,405,10816,5952,2695,351,8998,Tuesday
2023-01-24,Hung Hom,0,0,0,0,0,0,0,0,Tuesday
2023-01-24,Lo Wu,0,0,0,0,0,0,0,0,Tuesday
2023-01-24,Lok Ma Chau Spur Line,12513,3319,142,15974,15143,3158,208,18509,Tuesday
2023-01-24,Heung Yuen Wai,0,0,0,0,0,0,0,0,Tuesday
2023-01-24,Hong Kong-Zhuhai-Macao Bridge,26665,1378,4498,32541,29957,1202,4952,36111,Tuesday
2023-01-24,Lok Ma Chau,0,0,0,0,0,0,0,0,Tuesday
2023-01-24,Man Kam To,885,322,8,1215,859,257,8,1124,Tuesday
2023-01-24,Sha Tau Kok,0,0,0,0,0,0,0,0,Tuesday
2023-01-24,Shenzhen Bay,5395,2161,183,7739,5987,1911,330,8228,Tuesday
2023-01-24,China Ferry Terminal,500,285,13,798,469,162,22,653,Tuesday
2023-01-24,Harbour Control,0,0,0,0,0,0,0,0,Tuesday
2023-01-24,Kai Tak Cruise Terminal,0,0,0,0,0,0,0,0,Tuesday
2023-01-24,Macau Ferry Terminal,6911,296,1242,8449,7792,436,1138,9366,Tuesday
2023-01-24,Total,74620,16420,10742,101782,85646,12040,11181,108867,Tuesday
2023-01-26,Airport,24394,3869,4224,32487,17807,3511,3986,25304,Thursday
2023-01-26,Express Rail Link West Kowloon,6498,2978,261,9737,4201,4155,423,8779,Thursday
2023-01-26,Hung Hom,0,0,0,0,0,0,0,0,Thursday
2023-01-26,Lo Wu,0,0,0,0,0,0,0,0,Thursday
2023-01-26,Lok Ma Chau Spur Line,24139,4143,199,28481,10412,5579,327,16318,Thursday
2023-01-26,Heung Yuen Wai,0,0,0,0,0,0,0,0,Thursday
2023-01-26,Hong Kong-Zhuhai-Macao Bridge,23902,1384,3740,29026,20004,1482,3952,25438,Thursday
2023-01-26,Lok Ma Chau,0,0,0,0,0,0,0,0,Thursday
2023-01-26,Man Kam To,1972,357,8,2337,730,341,10,1081,Thursday
2023-01-26,Sha Tau Kok,0,0,0,0,0,0,0,0,Thursday
2023-01-26,Shenzhen Bay,10122,2248,237,12607,4095,3164,509,7768,Thursday
2023-01-26,China Ferry Terminal,784,314,14,1112,406,327,27,760,Thursday
2023-01-26,Harbour Control,0,0,0,0,0,0,0,0,Thursday
2023-01-26,Kai Tak Cruise Terminal,0,0,0,0,0,0,0,0,Thursday
2023-01-26,Macau Ferry Terminal,5893,392,1140,7425,6051,723,1129,7903,Thursday
2023-01-26,Total,97704,15685,9823,123212,63706,19282,10363,93351,Thursday
2023-01-27,Airport,25531,2955,3898,32384,17747,4291,4348,26386,Friday
2023-01-27,Express Rail Link West Kowloon,6314,2405,218,8937,4435,4081,380,8896,Friday
2023-01-27,Hung Hom,0,0,0,0,0,0,0,0,Friday
2023-01-27,Lo Wu,0,0,0,0,0,0,0,0,Friday
2023-01-27,Lok Ma Chau Spur Line,22276,3362,130,25768,11515,6019,334,17868,Friday
2023-01-27,Heung Yuen Wai,0,0,0,0,0,0,0,0,Friday
2023-01-27,Hong Kong-Zhuhai-Macao Bridge,20724,1159,4293,26176,19561,1525,4647,25733,Friday
2023-01-27,Lok Ma Chau,0,0,0,0,0,0,0,0,Friday
2023-01-27,Man Kam To,2067,444,14,2525,835,397,12,1244,Friday
2023-01-27,Sha Tau Kok,0,0,0,0,0,0,0,0,Friday
2023-01-27,Shenzhen Bay,10172,2048,189,12409,4677,3338,700,8715,Friday
2023-01-27,China Ferry Terminal,709,227,28,964,402,480,44,926,Friday
2023-01-27,Harbour Control,0,0,0,0,0,0,0,0,Friday
2023-01-27,Kai Tak Cruise Terminal,0,0,0,0,0,0,0,0,Friday
2023-01-27,Macau Ferry Terminal,5794,346,1149,7289,6079,719,1114,7912,Friday
2023-01-27,Total,93587,12946,9919,116452,65251,20850,11579,97680,Friday
2023-01-28,Airport,30702,2225,3008,35935,18069,3715,4938,26722,Saturday
2023-01-28,Express Rail Link West Kowloon,7473,1246,95,8814,4525,3802,519,8846,Saturday
2023-01-28,Hung Hom,0,0,0,0,0,0,0,0,Saturday
2023-01-28,Lo Wu,0,0,0,0,0,0,0,0,Saturday
2023-01-28,Lok Ma Chau Spur Line,30870,3154,117,34141,10752,4067,282,15101,Saturday
2023-01-28,Heung Yuen Wai,0,0,0,0,0,0,0,0,Saturday
2023-01-28,Hong Kong-Zhuhai-Macao Bridge,21112,988,4856,26956,22540,1334,5146,29020,Saturday
2023-01-28,Lok Ma Chau,0,0,0,0,0,0,0,0,Saturday
2023-01-28,Man Kam To,2697,303,5,3005,729,230,4,963,Saturday
2023-01-28,Sha Tau Kok,0,0,0,0,0,0,0,0,Saturday
2023-01-28,Shenzhen Bay,13836,2047,167,16050,4116,2584,563,7263,Saturday
2023-01-28,China Ferry Terminal,1005,212,17,1234,416,473,38,927,Saturday
2023-01-28,Harbour Control,0,0,0,0,0,0,0,0,Saturday
2023-01-28,Kai Tak Cruise Terminal,0,0,0,0,0,0,0,0,Saturday
2023-01-28,Macau Ferry Terminal,6034,244,1313,7591,7163,479,1268,8910,Saturday
2023-01-28,Total,113729,10419,9578,133726,68310,16684,12758,97752,Saturday
2023-01-29,Airport,37062,1582,2481,41125,17984,4058,5617,27659,Sunday
2023-01-29,Express Rail Link West Kowloon,8007,1002,62,9071,4041,3420,371,7832,Sunday
2023-01-29,Hung Hom,0,0,0,0,0,0,0,0,Sunday
2023-01-29,Lo Wu,0,0,0,0,0,0,0,0,Sunday
2023-01-29,Lok Ma Chau Spur Line,50300,4057,129,54486,8061,2969,182,11212,Sunday
2023-01-29,Heung Yuen Wai,0,0,0,0,0,0,0,0,Sunday
2023-01-29,Hong Kong-Zhuhai-Macao Bridge,28820,1057,3143,33020,16434,893,4951,22278,Sunday
2023-01-29,Lok Ma Chau,0,0,0,0,0,0,0,0,Sunday
2023-01-29,Man Kam To,7957,530,19,8506,555,213,6,774,Sunday
2023-01-29,Sha Tau Kok,0,0,0,0,0,0,0,0,Sunday
2023-01-29,Shenzhen Bay,24196,3138,158,27492,3671,1977,423,6071,Sunday
2023-01-29,China Ferry Terminal,1723,323,30,2076,339,232,18,589,Sunday
2023-01-29,Harbour Control,0,0,0,0,0,0,0,0,Sunday
2023-01-29,Kai Tak Cruise Terminal,0,0,0,0,0,0,0,0,Sunday
2023-01-29,Macau Ferry Terminal,7199,269,699,8167,5719,405,1203,7327,Sunday
2023-01-29,Total,165264,11958,6721,183943,56804,14167,12771,83742,Sunday
2023-01-30,Airport,28849,2883,3382,35114,13318,3244,3733,20295,Monday
2023-01-30,Express Rail Link West Kowloon,8858,1648,105,10611,4123,2644,299,7066,Monday
2023-01-30,Hung Hom,0,0,0,0,0,0,0,0,Monday
2023-01-30,Lo Wu,0,0,0,0,0,0,0,0,Monday
2023-01-30,Lok Ma Chau Spur Line,33156,4339,163,37658,9946,3169,151,13266,Monday
2023-01-30,Heung Yuen Wai,0,0,0,0,0,0,0,0,Monday
2023-01-30,Hong Kong-Zhuhai-Macao Bridge,17977,958,2399,21334,13198,734,2903,16835,Monday
2023-01-30,Lok Ma Chau,0,0,0,0,0,0,0,0,Monday
2023-01-30,Man Kam To,3673,718,11,4402,870,336,5,1211,Monday
2023-01-30,Sha Tau Kok,0,0,0,0,0,0,0,0,Monday
2023-01-30,Shenzhen Bay,15003,2908,132,18043,3946,2162,496,6604,Monday
2023-01-30,China Ferry Terminal,882,316,22,1220,367,278,22,667,Monday
2023-01-30,Harbour Control,0,0,0,0,0,0,0,0,Monday
2023-01-30,Kai Tak Cruise Terminal,0,0,0,0,0,0,0,0,Monday
2023-01-30,Macau Ferry Terminal,5497,241,775,6513,5008,342,845,6195,Monday
2023-01-30,Total,113895,14011,6989,134895,50776,12909,8454,72139,Monday
2023-01-31,Airport,25658,2933,3577,32168,13285,3203,3547,20035,Tuesday
2023-01-31,Express Rail Link West Kowloon,10136,2985,179,13300,4386,2497,304,7187,Tuesday
2023-01-31,Hung Hom,0,0,0,0,0,0,0,0,Tuesday
2023-01-31,Lo Wu,0,0,0,0,0,0,0,0,Tuesday
2023-01-31,Lok Ma Chau Spur Line,25526,3838,92,29456,9186,3335,160,12681,Tuesday
2023-01-31,Heung Yuen Wai,0,0,0,0,0,0,0,0,Tuesday
2023-01-31,Hong Kong-Zhuhai-Macao Bridge,15832,1006,1677,18515,10576,721,2183,13480,Tuesday
2023-01-31,Lok Ma Chau,0,0,0,0,0,0,0,0,Tuesday
2023-01-31,Man Kam To,2837,619,5,3461,815,309,9,1133,Tuesday
2023-01-31,Sha Tau Kok,0,0,0,0,0,0,0,0,Tuesday
2023-01-31,Shenzhen Bay,11539,2543,98,14180,3879,2304,456,6639,Tuesday
2023-01-31,China Ferry Terminal,750,274,17,1041,395,336,13,744,Tuesday
2023-01-31,Harbour Control,0,0,0,0,0,0,0,0,Tuesday
2023-01-31,Kai Tak Cruise Terminal,0,0,0,0,0,0,0,0,Tuesday
2023-01-31,Macau Ferry Terminal,5165,255,575,5995,3723,303,655,4681,Tuesday
2023-01-31,Total,97443,14453,6220,118116,46245,13008,7327,66580,Tuesday
2023-02-01,Airport,22962,3951,4675,31588,16309,3230,3012,22551,Wednesday
2023-02-01,Express Rail Link West Kowloon,7583,3877,216,11676,4999,2825,341,8165,Wednesday
2023-02-01,Hung Hom,0,0,0,0,0,0,0,0,Wednesday
2023-02-01,Lo Wu,0,0,0,0,0,0,0,0,Wednesday
2023-02-01,Lok Ma Chau Spur Line,14931,3514,96,18541,10098,3193,212,13503,Wednesday
2023-02-01,Heung Yuen Wai,0,0,0,0,0,0,0,0,Wednesday
2023-02-24,Total,145252,56213,16335,217800,186080,50940,12605,249625,Friday
2023-02-01,Hong Kong-Zhuhai-Macao Bridge,10975,918,1734,13627,9715,729,1701,12145,Wednesday
2023-02-01,Lok Ma Chau,0,0,0,0,0,0,0,0,Wednesday
2023-02-01,Man Kam To,1523,483,9,2015,911,346,5,1262,Wednesday
2023-02-01,Sha Tau Kok,0,0,0,0,0,0,0,0,Wednesday
2023-02-01,Shenzhen Bay,6564,2301,110,8975,4257,2361,478,7096,Wednesday
2023-02-01,China Ferry Terminal,389,255,13,657,364,197,11,572,Wednesday
2023-02-01,Harbour Control,0,0,0,0,0,0,0,0,Wednesday
2023-02-01,Kai Tak Cruise Terminal,0,0,0,0,0,0,0,0,Wednesday
2023-02-01,Macau Ferry Terminal,4082,221,661,4964,4035,219,583,4837,Wednesday
2023-02-01,Total,69009,15520,7514,92043,50688,13100,6343,70131,Wednesday
2023-02-02,Airport,18327,5118,5619,29064,14632,3203,3180,21015,Thursday
2023-02-02,Express Rail Link West Kowloon,5355,3407,167,8929,4689,3171,335,8195,Thursday
2023-02-02,Hung Hom,0,0,0,0,0,0,0,0,Thursday
2023-02-02,Lo Wu,0,0,0,0,0,0,0,0,Thursday
2023-02-02,Lok Ma Chau Spur Line,12100,3553,115,15768,9711,3659,213,13583,Thursday
2023-02-02,Heung Yuen Wai,0,0,0,0,0,0,0,0,Thursday
2023-02-02,Hong Kong-Zhuhai-Macao Bridge,10748,770,1543,13061,10214,900,1683,12797,Thursday
2023-02-02,Lok Ma Chau,0,0,0,0,0,0,0,0,Thursday
2023-02-02,Man Kam To,1275,475,8,1758,937,396,8,1341,Thursday
2023-02-02,Sha Tau Kok,0,0,0,0,0,0,0,0,Thursday
2023-02-02,Shenzhen Bay,5492,2310,117,7919,4226,2505,522,7253,Thursday
2023-02-02,China Ferry Terminal,340,186,19,545,355,210,26,591,Thursday
2023-02-02,Harbour Control,0,0,0,0,0,0,0,0,Thursday
2023-02-02,Kai Tak Cruise Terminal,0,0,0,0,0,0,0,0,Thursday
2023-02-02,Macau Ferry Terminal,3670,169,673,4512,4102,282,623,5007,Thursday
2023-02-02,Total,57307,15988,8261,81556,48866,14326,6590,69782,Thursday
2023-02-03,Airport,15487,4576,6473,26536,16961,3651,3724,24336,Friday
2023-02-03,Express Rail Link West Kowloon,5523,3749,193,9465,6898,3256,285,10439,Friday
2023-02-03,Hung Hom,0,0,0,0,0,0,0,0,Friday
2023-02-03,Lo Wu,0,0,0,0,0,0,0,0,Friday
2023-02-03,Lok Ma Chau Spur Line,12363,3682,114,16159,14783,4233,227,19243,Friday
2023-02-03,Heung Yuen Wai,0,0,0,0,0,0,0,0,Friday
2023-02-03,Hong Kong-Zhuhai-Macao Bridge,11223,924,2258,14405,12955,965,1898,15818,Friday
2023-02-03,Lok Ma Chau,0,0,0,0,0,0,0,0,Friday
2023-02-03,Man Kam To,1185,565,6,1756,1238,515,6,1759,Friday
2023-02-03,Sha Tau Kok,0,0,0,0,0,0,0,0,Friday
2023-02-03,Shenzhen Bay,5464,2353,135,7952,5585,3121,536,9242,Friday
2023-02-03,China Ferry Terminal,341,231,25,597,470,281,22,773,Friday
2023-02-03,Harbour Control,0,0,0,0,0,0,0,0,Friday
2023-02-03,Kai Tak Cruise Terminal,0,0,0,0,0,0,0,0,Friday
2023-02-03,Macau Ferry Terminal,4098,235,905,5238,5468,328,676,6472,Friday
2023-02-03,Total,55684,16315,10109,82108,64358,16350,7374,88082,Friday
2023-02-04,Airport,17592,4583,5697,27872,15644,3405,3957,23006,Saturday
2023-02-04,Express Rail Link West Kowloon,5075,3926,260,9261,6627,4283,464,11374,Saturday
2023-02-04,Hung Hom,0,0,0,0,0,0,0,0,Saturday
2023-02-04,Lo Wu,0,0,0,0,0,0,0,0,Saturday
2023-02-04,Lok Ma Chau Spur Line,10927,3981,132,15040,12690,4117,221,17028,Saturday
2023-02-04,Heung Yuen Wai,0,0,0,0,0,0,0,0,Saturday
2023-02-04,Hong Kong-Zhuhai-Macao Bridge,13996,775,4686,19457,20302,916,3818,25036,Saturday
2023-02-04,Lok Ma Chau,0,0,0,0,0,0,0,0,Saturday
2023-02-04,Man Kam To,1128,588,16,1732,1074,397,12,1483,Saturday
2023-02-04,Sha Tau Kok,0,0,0,0,0,0,0,0,Saturday
2023-02-04,Shenzhen Bay,4550,2251,190,6991,4492,2996,556,8044,Saturday
2023-02-04,China Ferry Terminal,283,202,10,495,395,250,11,656,Saturday
2023-02-04,Harbour Control,0,0,0,0,0,0,0,0,Saturday
2023-02-04,Kai Tak Cruise Terminal,0,0,0,0,0,0,0,0,Saturday
2023-02-04,Macau Ferry Terminal,4250,224,1256,5730,6737,319,915,7971,Saturday
2023-02-04,Total,57801,16530,12247,86578,67961,16683,9954,94598,Saturday
2023-02-05,Airport,21913,3859,5410,31182,16539,3598,5739,25876,Sunday
2023-02-05,Express Rail Link West Kowloon,7184,2550,173,9907,3288,3744,450,7482,Sunday
2023-02-05,Hung Hom,0,0,0,0,0,0,0,0,Sunday
2023-02-05,Lo Wu,0,0,0,0,0,0,0,0,Sunday
2023-02-05,Lok Ma Chau Spur Line,12753,2484,74,15311,5043,2991,204,8238,Sunday
2023-02-05,Heung Yuen Wai,0,0,0,0,0,0,0,0,Sunday
2023-02-05,Hong Kong-Zhuhai-Macao Bridge,23156,783,3055,26994,14936,757,4585,20278,Sunday
2023-02-05,Lok Ma Chau,0,0,0,0,0,0,0,0,Sunday
2023-02-05,Man Kam To,1137,332,8,1477,358,234,8,600,Sunday
2023-02-05,Sha Tau Kok,0,0,0,0,0,0,0,0,Sunday
2023-02-05,Shenzhen Bay,5666,1795,131,7592,2156,2211,517,4884,Sunday
2023-02-05,China Ferry Terminal,411,107,19,537,209,210,32,451,Sunday
2023-02-05,Harbour Control,0,0,0,0,0,0,0,0,Sunday
2023-02-05,Kai Tak Cruise Terminal,0,0,0,0,0,0,0,0,Sunday
2023-02-05,Macau Ferry Terminal,6015,113,633,6761,4037,274,1076,5387,Sunday
2023-02-05,Total,78235,12023,9503,99761,46566,14019,12611,73196,Sunday
2023-02-06,Airport,17408,4946,6154,28508,14145,3686,4586,22417,Monday
2023-02-06,Express Rail Link West Kowloon,8179,3994,227,12400,7532,3837,378,11747,Monday
2023-02-06,Hung Hom,0,0,0,0,0,0,0,0,Monday
2023-02-06,Lo Wu,26392,3865,62,30319,29686,3828,142,33656,Monday
2023-02-06,Lok Ma Chau Spur Line,21464,4269,80,25813,23312,4419,155,27886,Monday
2023-02-06,Heung Yuen Wai,2170,402,3,2575,2813,363,6,3182,Monday
2023-02-06,Hong Kong-Zhuhai-Macao Bridge,13709,1087,2113,16909,12584,901,2310,15795,Monday
2023-02-06,Lok Ma Chau,2876,532,24,3432,3899,476,62,4437,Monday
2023-02-06,Man Kam To,1148,370,7,1525,1029,270,2,1301,Monday
2023-02-06,Sha Tau Kok,0,0,0,0,0,0,0,0,Monday
2023-02-06,Shenzhen Bay,10622,3605,159,14386,11203,3640,524,15367,Monday
2023-02-06,China Ferry Terminal,537,252,16,805,631,187,24,842,Monday
2023-02-06,Harbour Control,0,0,0,0,0,0,0,0,Monday
2023-02-06,Kai Tak Cruise Terminal,0,0,0,0,0,0,0,0,Monday
2023-02-06,Macau Ferry Terminal,4394,265,755,5414,4440,273,762,5475,Monday
2023-02-06,Total,108899,23587,9600,142086,111274,21880,8951,142105,Monday
2023-02-07,Airport,14729,4539,5653,24921,13399,3598,4811,21808,Tuesday
2023-02-07,Express Rail Link West Kowloon,6251,4349,184,10784,6111,3368,333,9812,Tuesday
2023-02-07,Hung Hom,0,0,0,0,0,0,0,0,Tuesday
2023-02-07,Lo Wu,28657,4175,122,32954,28787,3838,210,32835,Tuesday
2023-02-07,Lok Ma Chau Spur Line,21265,4334,101,25700,21572,3937,146,25655,Tuesday
2023-02-07,Heung Yuen Wai,3015,518,8,3541,3316,409,9,3734,Tuesday
2023-02-07,Hong Kong-Zhuhai-Macao Bridge,12158,1159,1962,15279,11821,929,2187,14937,Tuesday
2023-02-07,Lok Ma Chau,4583,691,38,5312,3404,583,47,4034,Tuesday
2023-02-07,Man Kam To,947,328,5,1280,814,247,6,1067,Tuesday
2023-02-07,Sha Tau Kok,0,0,0,0,0,0,0,0,Tuesday
2023-02-07,Shenzhen Bay,9849,3688,141,13678,9876,3314,439,13629,Tuesday
2023-02-07,China Ferry Terminal,390,258,26,674,510,191,22,723,Tuesday
2023-02-07,Harbour Control,0,0,0,0,0,0,0,0,Tuesday
2023-02-07,Kai Tak Cruise Terminal,0,0,0,0,0,0,0,0,Tuesday
2023-02-07,Macau Ferry Terminal,4338,244,866,5448,4304,337,806,5447,Tuesday
2023-02-07,Total,106182,24283,9106,139571,103914,20751,9016,133681,Tuesday
2023-02-08,Airport,14464,4953,6021,25438,14257,3978,4614,22849,Wednesday
2023-02-08,Express Rail Link West Kowloon,5908,5049,259,11216,6346,3873,325,10544,Wednesday
2023-02-08,Hung Hom,0,0,0,0,0,0,0,0,Wednesday
2023-02-08,Lo Wu,29873,4991,158,35022,29914,4546,238,34698,Wednesday
2023-02-08,Lok Ma Chau Spur Line,22491,4946,95,27532,22402,4572,133,27107,Wednesday
2023-02-08,Heung Yuen Wai,3358,649,5,4012,3768,513,6,4287,Wednesday
2023-02-08,Hong Kong-Zhuhai-Macao Bridge,11819,1088,2123,15030,11629,1148,2166,14943,Wednesday
2023-02-08,Lok Ma Chau,4346,842,29,5217,3471,663,67,4201,Wednesday
2023-02-08,Man Kam To,1119,382,2,1503,923,227,10,1160,Wednesday
2023-02-08,Sha Tau Kok,0,0,0,0,0,0,0,0,Wednesday
2023-02-08,Shenzhen Bay,10381,4288,189,14858,10585,3708,456,14749,Wednesday
2023-02-08,China Ferry Terminal,419,278,23,720,497,254,18,769,Wednesday
2023-02-08,Harbour Control,0,0,0,0,0,0,0,0,Wednesday
2023-02-08,Kai Tak Cruise Terminal,0,0,0,0,0,0,0,0,Wednesday
2023-02-08,Macau Ferry Terminal,3999,326,770,5095,4256,382,770,5408,Wednesday
2023-02-08,Total,108177,27792,9674,145643,108048,23864,8803,140715,Wednesday
2023-02-09,Airport,13494,5226,7014,25734,15208,3904,4593,23705,Thursday
2023-02-09,Express Rail Link West Kowloon,5609,5639,300,11548,6621,4793,337,11751,Thursday
2023-02-09,Hung Hom,0,0,0,0,0,0,0,0,Thursday
2023-02-09,Lo Wu,29434,5165,165,34764,31759,5188,229,37176,Thursday
2023-02-09,Lok Ma Chau Spur Line,22922,5198,111,28231,23350,4884,156,28390,Thursday
2023-02-09,Heung Yuen Wai,3792,729,11,4532,4086,555,7,4648,Thursday
2023-02-09,Hong Kong-Zhuhai-Macao Bridge,12321,1182,2179,15682,13072,1222,2105,16399,Thursday
2023-02-09,Lok Ma Chau,4322,804,40,5166,3487,868,78,4433,Thursday
2023-02-09,Man Kam To,1183,374,7,1564,923,240,2,1165,Thursday
2023-02-09,Sha Tau Kok,0,0,0,0,0,0,0,0,Thursday
2023-02-09,Shenzhen Bay,10257,4541,195,14993,11363,4178,398,15939,Thursday
2023-02-09,China Ferry Terminal,491,335,23,849,610,253,32,895,Thursday
2023-02-09,Harbour Control,0,0,0,0,0,0,0,0,Thursday
2023-02-09,Kai Tak Cruise Terminal,0,0,0,0,0,0,0,0,Thursday
2023-02-09,Macau Ferry Terminal,3676,415,974,5065,4551,544,972,6067,Thursday
2023-02-09,Total,107501,29608,11019,148128,115030,26629,8909,150568,Thursday
2023-02-10,Airport,14019,4865,7265,26149,17789,4472,5570,27831,Friday
2023-02-10,Express Rail Link West Kowloon,6284,8134,408,14826,10528,4207,309,15044,Friday
2023-02-10,Hung Hom,0,0,0,0,0,0,0,0,Friday
2023-02-10,Lo Wu,31738,7300,197,39235,43034,6967,251,50252,Friday
2023-02-10,Lok Ma Chau Spur Line,24623,7124,135,31882,33876,6493,146,40515,Friday
2023-02-10,Heung Yuen Wai,4139,1119,5,5263,5872,835,10,6717,Friday
2023-02-10,Hong Kong-Zhuhai-Macao Bridge,13913,1834,3192,18939,18440,1604,2596,22640,Friday
2023-02-10,Lok Ma Chau,4798,1224,51,6073,4745,1165,81,5991,Friday
2023-02-10,Man Kam To,1110,453,7,1570,1257,303,8,1568,Friday
2023-02-10,Sha Tau Kok,0,0,0,0,0,0,0,0,Friday
2023-02-10,Shenzhen Bay,11657,6124,260,18041,16962,5181,392,22535,Friday
2023-02-10,China Ferry Terminal,556,404,26,986,862,329,23,1214,Friday
2023-02-10,Harbour Control,0,0,0,0,0,0,0,0,Friday
2023-02-10,Kai Tak Cruise Terminal,0,0,0,0,0,0,0,0,Friday
2023-02-10,Macau Ferry Terminal,3941,449,1104,5494,5774,514,709,6997,Friday
2023-02-10,Total,116778,39030,12650,168458,159139,32070,10095,201304,Friday
2023-02-11,Airport,15727,4650,6667,27044,16394,4234,5723,26351,Saturday
2023-02-11,Express Rail Link West Kowloon,6555,10819,560,17934,11252,6111,365,17728,Saturday
2023-02-11,Hung Hom,0,0,0,0,0,0,0,0,Saturday
2023-02-11,Lo Wu,35701,9099,240,45040,54035,10444,327,64806,Saturday
2023-02-11,Lok Ma Chau Spur Line,25950,10521,203,36674,41702,9971,253,51926,Saturday
2023-02-11,Heung Yuen Wai,5480,2364,32,7876,8230,1351,22,9603,Saturday
2023-02-11,Hong Kong-Zhuhai-Macao Bridge,17731,1692,6389,25812,28900,1612,5064,35576,Saturday
2023-02-11,Lok Ma Chau,6045,1171,44,7260,6759,1438,98,8295,Saturday
2023-02-11,Man Kam To,779,609,13,1401,1207,386,14,1607,Saturday
2023-02-11,Sha Tau Kok,0,0,0,0,0,0,0,0,Saturday
2023-02-11,Shenzhen Bay,11734,7579,444,19757,17224,7039,568,24831,Saturday
2023-02-11,China Ferry Terminal,473,356,35,864,761,274,21,1056,Saturday
2023-02-11,Harbour Control,0,0,0,0,0,0,0,0,Saturday
2023-02-11,Kai Tak Cruise Terminal,2,0,356,358,0,0,0,0,Saturday
2023-02-11,Macau Ferry Terminal,4811,478,1483,6772,7119,452,973,8544,Saturday
2023-02-11,Total,130988,49338,16466,196792,193583,43312,13428,250323,Saturday
2023-02-12,Airport,17921,4288,6717,28926,16926,4720,7800,29446,Sunday
2023-02-12,Express Rail Link West Kowloon,10396,8442,343,19181,6831,8241,527,15599,Sunday
2023-02-12,Hung Hom,0,0,0,0,0,0,0,0,Sunday
2023-02-12,Lo Wu,64259,8373,149,72781,35650,11054,296,47000,Sunday
2023-02-12,Lok Ma Chau Spur Line,45070,8374,163,53607,25999,10585,295,36879,Sunday
2023-02-12,Heung Yuen Wai,9036,1813,30,10879,6222,1300,21,7543,Sunday
2023-02-12,Hong Kong-Zhuhai-Macao Bridge,33711,1580,4675,39966,19729,1795,6654,28178,Sunday
2023-02-12,Lok Ma Chau,11257,1129,45,12431,4611,1431,86,6128,Sunday
2023-02-12,Man Kam To,1422,461,2,1885,670,316,15,1001,Sunday
2023-02-12,Sha Tau Kok,0,0,0,0,0,0,0,0,Sunday
2023-02-12,Shenzhen Bay,23773,6477,309,30559,12708,7125,615,20448,Sunday
2023-02-12,China Ferry Terminal,949,316,22,1287,481,390,41,912,Sunday
2023-02-12,Harbour Control,0,0,0,0,0,0,0,0,Sunday
2023-02-12,Kai Tak Cruise Terminal,0,0,0,0,92,0,260,352,Sunday
2023-02-12,Macau Ferry Terminal,6289,395,794,7478,4934,619,1288,6841,Sunday
2023-02-12,Total,224083,41648,13249,278980,134853,47576,17898,200327,Sunday
2023-02-13,Airport,15957,5122,6676,27755,13582,4093,6160,23835,Monday
2023-02-18,Macau Ferry Terminal,5214,698,1761,7673,8269,780,1333,10382,Saturday
2023-02-13,Express Rail Link West Kowloon,7736,7028,246,15010,7004,5959,447,13410,Monday
2023-02-13,Hung Hom,0,0,0,0,0,0,0,0,Monday
2023-02-13,Lo Wu,38603,7942,168,46713,36034,8509,200,44743,Monday
2023-02-13,Lok Ma Chau Spur Line,27926,6600,104,34630,26154,6246,130,32530,Monday
2023-02-13,Heung Yuen Wai,5204,1372,20,6596,5366,912,9,6287,Monday
2023-02-13,Hong Kong-Zhuhai-Macao Bridge,16079,1490,2314,19883,14727,1570,2739,19036,Monday
2023-02-13,Lok Ma Chau,6282,1319,55,7656,4018,1175,98,5291,Monday
2023-02-13,Man Kam To,1313,473,8,1794,1044,323,8,1375,Monday
2023-02-13,Sha Tau Kok,0,0,0,0,0,0,0,0,Monday
2023-02-13,Shenzhen Bay,13328,5684,178,19190,12763,5476,469,18708,Monday
2023-02-13,China Ferry Terminal,597,389,19,1005,646,284,26,956,Monday
2023-02-13,Harbour Control,0,0,0,0,0,0,0,0,Monday
2023-02-13,Kai Tak Cruise Terminal,0,0,0,0,0,0,0,0,Monday
2023-02-13,Macau Ferry Terminal,5106,398,973,6477,5044,542,928,6514,Monday
2023-02-13,Total,138131,37817,10761,186709,126382,35089,11214,172685,Monday
2023-02-14,Airport,12967,4309,6452,23728,12803,3926,5614,22343,Tuesday
2023-02-14,Express Rail Link West Kowloon,5696,6277,280,12253,6119,5983,395,12497,Tuesday
2023-02-14,Hung Hom,0,0,0,0,0,0,0,0,Tuesday
2023-02-14,Lo Wu,35054,7060,169,42283,34842,8975,246,44063,Tuesday
2023-02-14,Lok Ma Chau Spur Line,24389,6639,136,31164,25687,6281,168,32136,Tuesday
2023-02-14,Heung Yuen Wai,4911,1520,12,6443,5562,990,6,6558,Tuesday
2023-02-14,Hong Kong-Zhuhai-Macao Bridge,14499,1377,2129,18005,13948,1553,2233,17734,Tuesday
2023-02-14,Lok Ma Chau,4676,1053,58,5787,3893,1123,100,5116,Tuesday
2023-02-14,Man Kam To,1162,469,11,1642,969,302,12,1283,Tuesday
2023-02-14,Sha Tau Kok,0,0,0,0,0,0,0,0,Tuesday
2023-02-14,Shenzhen Bay,11702,5425,212,17339,11554,5656,499,17709,Tuesday
2023-02-14,China Ferry Terminal,481,308,15,804,465,348,29,842,Tuesday
2023-02-14,Harbour Control,0,0,0,0,0,0,0,0,Tuesday
2023-02-14,Kai Tak Cruise Terminal,0,0,0,0,0,0,0,0,Tuesday
2023-02-14,Macau Ferry Terminal,4254,422,828,5504,4760,607,941,6308,Tuesday
2023-02-14,Total,119791,34859,10302,164952,120602,35744,10243,166589,Tuesday
2023-02-15,Airport,14140,4821,7383,26344,15365,4397,5550,25312,Wednesday
2023-02-15,Express Rail Link West Kowloon,6336,7453,331,14120,7152,5835,418,13405,Wednesday
2023-02-15,Hung Hom,0,0,0,0,0,0,0,0,Wednesday
2023-02-15,Lo Wu,36779,8236,198,45213,35430,9462,283,45175,Wednesday
2023-02-15,Lok Ma Chau Spur Line,26549,7139,129,33817,25290,6527,155,31972,Wednesday
2023-02-15,Heung Yuen Wai,5188,1548,13,6749,5536,1050,14,6600,Wednesday
2023-02-15,Hong Kong-Zhuhai-Macao Bridge,14527,1833,2479,18839,13021,1602,2534,17157,Wednesday
2023-02-15,Lok Ma Chau,5236,1281,40,6557,3920,1346,118,5384,Wednesday
2023-02-15,Man Kam To,1138,491,11,1640,970,285,11,1266,Wednesday
2023-02-15,Sha Tau Kok,0,0,0,0,0,0,0,0,Wednesday
2023-02-15,Shenzhen Bay,12238,6169,255,18662,12065,5458,554,18077,Wednesday
2023-02-15,China Ferry Terminal,480,436,39,955,562,323,40,925,Wednesday
2023-02-15,Harbour Control,0,0,0,0,0,0,0,0,Wednesday
2023-02-15,Kai Tak Cruise Terminal,0,0,0,0,0,0,0,0,Wednesday
2023-02-15,Macau Ferry Terminal,4850,534,908,6292,4493,621,887,6001,Wednesday
2023-02-15,Total,127461,39941,11786,179188,123804,36906,10564,171274,Wednesday
2023-02-16,Airport,13690,5449,7430,26569,15655,4072,5573,25300,Thursday
2023-02-16,Express Rail Link West Kowloon,5923,7993,294,14210,7327,6469,363,14159,Thursday
2023-02-16,Hung Hom,0,0,0,0,0,0,0,0,Thursday
2023-02-16,Lo Wu,36583,8664,202,45449,37562,10355,281,48198,Thursday
2023-02-16,Lok Ma Chau Spur Line,25363,7531,160,33054,26417,7002,151,33570,Thursday
2023-02-16,Heung Yuen Wai,5087,1737,6,6830,5808,1020,6,6834,Thursday
2023-02-16,Hong Kong-Zhuhai-Macao Bridge,13974,1683,2277,17934,14399,1747,2293,18439,Thursday
2023-02-16,Lok Ma Chau,4734,1149,89,5972,3872,1410,105,5387,Thursday
2023-02-16,Man Kam To,1156,454,4,1614,968,320,7,1295,Thursday
2023-02-16,Sha Tau Kok,0,0,0,0,0,0,0,0,Thursday
2023-02-16,Shenzhen Bay,11896,7397,273,19566,12705,6438,414,19557,Thursday
2023-02-16,China Ferry Terminal,521,455,23,999,639,335,12,986,Thursday
2023-02-16,Harbour Control,0,0,0,0,0,0,0,0,Thursday
2023-02-16,Kai Tak Cruise Terminal,4,0,273,277,0,0,0,0,Thursday
2023-02-16,Macau Ferry Terminal,4278,592,960,5830,4968,720,1023,6711,Thursday
2023-02-16,Total,123209,43104,11991,178304,130320,39888,10228,180436,Thursday
2023-02-17,Airport,15179,5341,7799,28319,17401,4603,6906,28910,Friday
2023-02-17,Express Rail Link West Kowloon,6220,10566,470,17256,10676,5155,271,16102,Friday
2023-02-17,Hung Hom,0,0,0,0,0,0,0,0,Friday
2023-02-17,Lo Wu,38031,11213,265,49509,49102,12860,335,62297,Friday
2023-02-17,Lok Ma Chau Spur Line,27200,9529,183,36912,35559,8580,168,44307,Friday
2023-02-17,Heung Yuen Wai,5078,2019,25,7122,6878,1151,8,8037,Friday
2023-02-17,Hong Kong-Zhuhai-Macao Bridge,14944,2232,3255,20431,19770,2253,2740,24763,Friday
2023-02-17,Lok Ma Chau,5467,1726,86,7279,5053,1442,104,6599,Friday
2023-02-17,Man Kam To,1117,519,6,1642,1185,370,9,1564,Friday
2023-02-17,Sha Tau Kok,0,0,0,0,0,0,0,0,Friday
2023-02-17,Shenzhen Bay,13686,7626,418,21730,18726,7109,412,26247,Friday
2023-02-17,China Ferry Terminal,734,557,25,1316,778,390,16,1184,Friday
2023-02-17,Harbour Control,0,0,0,0,0,0,0,0,Friday
2023-02-17,Kai Tak Cruise Terminal,0,0,0,0,0,0,0,0,Friday
2023-02-17,Macau Ferry Terminal,5016,708,1377,7101,7126,673,1030,8829,Friday
2023-02-17,Total,132672,52036,13909,198617,172254,44586,11999,228839,Friday
2023-02-18,Airport,15655,4827,6912,27394,16800,4320,6808,27928,Saturday
2023-02-18,Express Rail Link West Kowloon,6262,12172,528,18962,11183,6750,319,18252,Saturday
2023-02-18,Hung Hom,0,0,0,0,0,0,0,0,Saturday
2023-02-18,Lo Wu,42022,15191,317,57530,61487,18910,407,80804,Saturday
2023-02-18,Lok Ma Chau Spur Line,28270,16758,312,45340,43566,14598,304,58468,Saturday
2023-02-18,Heung Yuen Wai,5965,3749,20,9734,8962,1882,17,10861,Saturday
2023-02-18,Hong Kong-Zhuhai-Macao Bridge,18628,2548,7023,28199,30189,2836,5408,38433,Saturday
2023-02-18,Lok Ma Chau,6546,1803,123,8472,7074,2538,125,9737,Saturday
2023-02-18,Man Kam To,824,814,9,1647,1026,503,3,1532,Saturday
2023-02-18,Sha Tau Kok,0,0,0,0,0,0,0,0,Saturday
2023-02-18,Shenzhen Bay,13473,10728,489,24690,19536,9542,453,29531,Saturday
2023-02-18,China Ferry Terminal,485,704,47,1236,896,400,26,1322,Saturday
2023-02-18,Harbour Control,0,0,0,0,0,0,0,0,Saturday
2023-02-18,Kai Tak Cruise Terminal,0,0,0,0,3,0,282,285,Saturday
2023-02-18,Total,143344,69992,17541,230877,208991,63059,15485,287535,Saturday
2023-02-19,Express Rail Link West Kowloon,10383,8873,335,19591,6776,10231,486,17493,Sunday
2023-02-19,Hung Hom,0,0,0,0,0,0,0,0,Sunday
2023-02-19,Lo Wu,67635,10851,221,78707,40110,17485,345,57940,Sunday
2023-02-19,Lok Ma Chau Spur Line,46051,10873,208,57132,28419,13954,326,42699,Sunday
2023-02-19,Heung Yuen Wai,10224,2565,14,12803,7212,1930,11,9153,Sunday
2023-02-19,Hong Kong-Zhuhai-Macao Bridge,35265,1904,4665,41834,21169,3075,6752,30996,Sunday
2023-02-19,Lok Ma Chau,11266,1567,81,12914,5079,2650,217,7946,Sunday
2023-02-19,Man Kam To,1182,471,1,1654,580,347,2,929,Sunday
2023-02-19,Sha Tau Kok,0,0,0,0,0,0,0,0,Sunday
2023-02-19,Shenzhen Bay,24919,6606,378,31903,13918,9439,723,24080,Sunday
2023-02-19,China Ferry Terminal,1048,493,27,1568,505,544,39,1088,Sunday
2023-02-19,Harbour Control,0,0,0,0,0,0,0,0,Sunday
2023-02-19,Kai Tak Cruise Terminal,0,0,0,0,0,0,0,0,Sunday
2023-02-19,Macau Ferry Terminal,8194,527,932,9653,5322,857,1527,7706,Sunday
2023-02-19,Total,235819,49742,13990,299551,146063,66016,19149,231228,Sunday
2023-02-20,Airport,17015,5555,7588,30158,15120,4602,6803,26525,Monday
2023-02-20,Express Rail Link West Kowloon,7926,7573,254,15753,7109,7060,376,14545,Monday
2023-02-20,Hung Hom,0,0,0,0,0,0,0,0,Monday
2023-02-20,Lo Wu,41962,9326,219,51507,38115,10694,249,49058,Monday
2023-02-20,Lok Ma Chau Spur Line,30166,7802,132,38100,27066,7261,159,34486,Monday
2023-02-20,Heung Yuen Wai,6132,1707,20,7859,6187,1210,13,7410,Monday
2023-02-20,Hong Kong-Zhuhai-Macao Bridge,17402,1628,2336,21366,15053,2155,2532,19740,Monday
2023-02-20,Lok Ma Chau,6784,1683,80,8547,4353,1624,127,6104,Monday
2023-02-20,Man Kam To,1212,492,9,1713,843,340,7,1190,Monday
2023-02-20,Sha Tau Kok,0,0,0,0,0,0,0,0,Monday
2023-02-20,Shenzhen Bay,14570,6188,256,21014,13324,6033,471,19828,Monday
2023-02-20,China Ferry Terminal,731,567,38,1336,714,366,20,1100,Monday
2023-02-20,Harbour Control,0,0,0,0,0,0,0,0,Monday
2023-02-20,Kai Tak Cruise Terminal,0,0,0,0,0,0,0,0,Monday
2023-02-20,Macau Ferry Terminal,6337,523,880,7740,5241,719,1021,6981,Monday
2023-02-20,Total,150237,43044,11812,205093,133125,42064,11778,186967,Monday
2023-02-21,Airport,14958,4814,6700,26472,13592,4612,6128,24332,Tuesday
2023-02-21,Express Rail Link West Kowloon,6094,7503,327,13924,6632,6571,331,13534,Tuesday
2023-02-21,Hung Hom,0,0,0,0,0,0,0,0,Tuesday
2023-02-21,Lo Wu,37911,9846,226,47983,37764,11262,298,49324,Tuesday
2023-02-21,Lok Ma Chau Spur Line,26732,7850,138,34720,27020,7440,132,34592,Tuesday
2023-02-21,Heung Yuen Wai,6125,2073,10,8208,6509,1250,7,7766,Tuesday
2023-02-21,Hong Kong-Zhuhai-Macao Bridge,14407,1560,2261,18228,14016,1901,2408,18325,Tuesday
2023-02-21,Lok Ma Chau,4974,1295,74,6343,4239,1368,128,5735,Tuesday
2023-02-21,Man Kam To,1168,555,9,1732,855,308,7,1170,Tuesday
2023-02-21,Sha Tau Kok,0,0,0,0,0,0,0,0,Tuesday
2023-02-21,Shenzhen Bay,12939,6383,273,19595,13089,5971,472,19532,Tuesday
2023-02-21,China Ferry Terminal,543,599,29,1171,613,354,21,988,Tuesday
2023-02-21,Harbour Control,0,0,0,0,0,0,0,0,Tuesday
2023-02-21,Kai Tak Cruise Terminal,0,0,0,0,0,0,0,0,Tuesday
2023-02-21,Macau Ferry Terminal,5036,515,1008,6559,4870,801,1051,6722,Tuesday
2023-02-21,Total,130887,42993,11055,184935,129199,41838,10983,182020,Tuesday
2023-02-22,Airport,14788,5418,7954,28160,14849,4808,6600,26257,Wednesday
2023-02-22,Express Rail Link West Kowloon,5940,7648,322,13910,6902,6470,369,13741,Wednesday
2023-02-22,Hung Hom,0,0,0,0,0,0,0,0,Wednesday
2023-02-22,Lo Wu,38129,10367,230,48726,37638,12218,286,50142,Wednesday
2023-02-22,Lok Ma Chau Spur Line,27399,8419,156,35974,27568,7911,146,35625,Wednesday
2023-02-22,Heung Yuen Wai,6031,2644,18,8693,6663,1175,18,7856,Wednesday
2023-02-22,Hong Kong-Zhuhai-Macao Bridge,13541,1931,2387,17859,13816,2758,2480,19054,Wednesday
2023-02-22,Lok Ma Chau,5536,1442,106,7084,4614,1528,135,6277,Wednesday
2023-02-22,Man Kam To,1496,416,6,1918,1369,316,2,1687,Wednesday
2023-02-22,Sha Tau Kok,0,0,0,0,0,0,0,0,Wednesday
2023-02-22,Shenzhen Bay,12888,6773,291,19952,12966,6385,442,19793,Wednesday
2023-02-22,China Ferry Terminal,558,529,30,1117,545,388,23,956,Wednesday
2023-02-22,Harbour Control,0,0,0,0,0,0,0,0,Wednesday
2023-02-22,Kai Tak Cruise Terminal,0,0,0,0,0,0,0,0,Wednesday
2023-02-22,Macau Ferry Terminal,4876,733,1046,6655,4520,962,1002,6484,Wednesday
2023-02-22,Total,131182,46320,12546,190048,131450,44919,11503,187872,Wednesday
2023-02-23,Airport,13891,6026,9170,29087,16221,4799,6212,27232,Thursday
2023-02-23,Express Rail Link West Kowloon,6139,7837,395,14371,7359,6370,361,14090,Thursday
2023-02-23,Hung Hom,0,0,0,0,0,0,0,0,Thursday
2023-02-23,Lo Wu,37840,9934,251,48025,39129,11887,309,51325,Thursday
2023-02-23,Lok Ma Chau Spur Line,27632,8254,160,36046,28535,7873,184,36592,Thursday
2023-02-23,Heung Yuen Wai,6239,2283,16,8538,6919,1359,12,8290,Thursday
2023-02-23,Hong Kong-Zhuhai-Macao Bridge,14646,2023,2611,19280,15724,2435,2705,20864,Thursday
2023-02-23,Lok Ma Chau,5462,1430,99,6991,4459,1482,145,6086,Thursday
2023-02-23,Man Kam To,1439,423,7,1869,1288,268,4,1560,Thursday
2023-02-23,Sha Tau Kok,0,0,0,0,0,0,0,0,Thursday
2023-02-23,Shenzhen Bay,13267,6530,344,20141,14331,6366,461,21158,Thursday
2023-02-23,China Ferry Terminal,526,455,35,1016,591,418,27,1036,Thursday
2023-02-23,Harbour Control,0,0,0,0,0,0,0,0,Thursday
2023-02-23,Kai Tak Cruise Terminal,0,0,0,0,0,0,0,0,Thursday
2023-02-23,Macau Ferry Terminal,4780,678,1101,6559,5177,970,1177,7324,Thursday
2023-02-23,Total,131861,45873,14189,191923,139733,44227,11597,195557,Thursday
2023-02-24,Airport,15912,5544,10054,31510,18644,5311,7216,31171,Friday
2023-02-24,Express Rail Link West Kowloon,6630,10461,514,17605,10395,5540,285,16220,Friday
2023-02-24,Hung Hom,0,0,0,0,0,0,0,0,Friday
2023-02-24,Lo Wu,41018,12453,297,53768,51136,14081,336,65553,Friday
2023-02-24,Lok Ma Chau Spur Line,30382,10787,255,41424,38853,9741,161,48755,Friday
2023-02-24,Heung Yuen Wai,6597,2726,18,9341,8633,1517,12,10162,Friday
2023-02-24,Hong Kong-Zhuhai-Macao Bridge,16169,2476,3210,21855,21916,3686,2900,28502,Friday
2023-02-24,Lok Ma Chau,5987,1650,141,7778,5871,1846,133,7850,Friday
2023-02-24,Man Kam To,1454,547,5,2006,1475,364,4,1843,Friday
2023-02-24,Sha Tau Kok,0,0,0,0,0,0,0,0,Friday
2023-02-24,Shenzhen Bay,15052,8282,490,23824,21009,7598,404,29011,Friday
2023-02-24,China Ferry Terminal,750,547,37,1334,957,442,25,1424,Friday
2023-02-24,Harbour Control,0,0,0,0,0,0,0,0,Friday
2023-02-24,Kai Tak Cruise Terminal,0,0,0,0,0,0,0,0,Friday
2023-02-24,Macau Ferry Terminal,5301,740,1314,7355,7191,814,1129,9134,Friday
2023-02-25,Airport,16842,5346,10473,32661,16784,5137,7588,29509,Saturday
2023-02-25,Express Rail Link West Kowloon,6441,12083,591,19115,11794,7244,291,19329,Saturday
2023-02-25,Hung Hom,0,0,0,0,0,0,0,0,Saturday
2023-02-25,Lo Wu,45166,17253,299,62718,64334,21049,410,85793,Saturday
2023-02-25,Lok Ma Chau Spur Line,32286,20413,365,53064,46988,17714,300,65002,Saturday
2023-02-25,Heung Yuen Wai,7401,4721,43,12165,10668,2830,22,13520,Saturday
2023-02-25,Hong Kong-Zhuhai-Macao Bridge,20407,4222,7392,32021,32288,3841,5963,42092,Saturday
2023-02-25,Lok Ma Chau,7369,2297,131,9797,7521,2849,179,10549,Saturday
2023-02-25,Man Kam To,857,846,7,1710,1216,573,6,1795,Saturday
2023-02-25,Sha Tau Kok,0,0,0,0,0,0,0,0,Saturday
2023-02-25,Shenzhen Bay,14745,11597,629,26971,21847,10732,516,33095,Saturday
2023-02-25,China Ferry Terminal,582,670,35,1287,899,338,26,1263,Saturday
2023-02-25,Harbour Control,0,0,0,0,0,0,0,0,Saturday
2023-02-25,Kai Tak Cruise Terminal,0,0,0,0,0,0,0,0,Saturday
2023-02-25,Macau Ferry Terminal,5501,821,1842,8164,8081,853,1447,10381,Saturday
2023-02-25,Total,157597,80269,21807,259673,222420,73160,16748,312328,Saturday
2023-02-26,Airport,20734,5086,8471,34291,16701,6027,10098,32826,Sunday
2023-02-26,Express Rail Link West Kowloon,10488,9573,489,20550,7050,9899,674,17623,Sunday
2023-02-26,Hung Hom,0,0,0,0,0,0,0,0,Sunday
2023-02-26,Lo Wu,69027,11902,283,81212,42523,18535,410,61468,Sunday
2023-02-26,Lok Ma Chau Spur Line,48061,12851,229,61141,30235,16369,388,46992,Sunday
2023-02-26,Heung Yuen Wai,11642,3593,22,15257,8559,2320,22,10901,Sunday
2023-02-26,Hong Kong-Zhuhai-Macao Bridge,37290,3167,4945,45402,22280,4371,6673,33324,Sunday
2023-02-26,Lok Ma Chau,11802,1554,99,13455,5390,2544,173,8107,Sunday
2023-02-26,Man Kam To,1159,520,6,1685,635,416,1,1052,Sunday
2023-02-26,Sha Tau Kok,0,0,0,0,0,0,0,0,Sunday
2023-02-26,Shenzhen Bay,26795,8098,452,35345,15278,10180,710,26168,Sunday
2023-02-26,China Ferry Terminal,1139,420,36,1595,502,531,40,1073,Sunday
2023-02-26,Harbour Control,0,0,0,0,0,0,0,0,Sunday
2023-02-26,Kai Tak Cruise Terminal,94,0,253,347,31,0,310,341,Sunday
2023-02-26,Macau Ferry Terminal,7798,505,980,9283,5447,862,1692,8001,Sunday
2023-02-26,Total,246029,57269,16265,319563,154631,72054,21191,247876,Sunday
2023-02-27,Airport,17988,5321,9668,32977,14937,5112,9084,29133,Monday
2023-02-27,Express Rail Link West Kowloon,8405,8165,319,16889,7264,7161,444,14869,Monday
2023-02-27,Hung Hom,0,0,0,0,0,0,0,0,Monday
2023-02-27,Lo Wu,44841,10484,275,55600,39561,11557,265,51383,Monday
2023-02-27,Lok Ma Chau Spur Line,32680,8419,171,41270,29728,7880,190,37798,Monday
2023-02-27,Heung Yuen Wai,7028,2883,15,9926,6764,1289,24,8077,Monday
2023-02-27,Hong Kong-Zhuhai-Macao Bridge,19532,2373,2596,24501,15876,3143,2794,21813,Monday
2023-02-27,Lok Ma Chau,7155,2180,95,9430,4961,1693,143,6797,Monday
2023-02-27,Man Kam To,1689,469,7,2165,1372,363,3,1738,Monday
2023-02-27,Sha Tau Kok,0,0,0,0,0,0,0,0,Monday
2023-02-27,Shenzhen Bay,17163,7014,324,24501,14351,6466,470,21287,Monday
2023-02-27,China Ferry Terminal,672,414,28,1114,713,373,45,1131,Monday
2023-02-27,Harbour Control,0,0,0,0,0,0,0,0,Monday
2023-02-27,Kai Tak Cruise Terminal,0,0,0,0,0,0,0,0,Monday
2023-02-27,Macau Ferry Terminal,6187,504,1088,7779,5284,713,1100,7097,Monday
2023-02-27,Total,163340,48226,14586,226152,140811,45750,14562,201123,Monday
2023-02-28,Airport,15694,5373,9930,30997,15016,5381,9603,30000,Tuesday
2023-02-28,Express Rail Link West Kowloon,6597,8382,355,15334,6923,6887,372,14182,Tuesday
2023-02-28,Hung Hom,0,0,0,0,0,0,0,0,Tuesday
2023-02-28,Lo Wu,40938,11089,295,52322,40162,12905,282,53349,Tuesday
2023-02-28,Lok Ma Chau Spur Line,29274,8698,161,38133,29105,7822,157,37084,Tuesday
2023-02-28,Heung Yuen Wai,6534,2679,25,9238,6842,1353,10,8205,Tuesday
2023-02-28,Hong Kong-Zhuhai-Macao Bridge,15286,2283,2554,20123,14195,3007,2580,19782,Tuesday
2023-02-28,Lok Ma Chau,5828,1729,104,7661,4847,1700,144,6691,Tuesday
2023-02-28,Man Kam To,1596,480,5,2081,1414,342,3,1759,Tuesday
2023-02-28,Sha Tau Kok,0,0,0,0,0,0,0,0,Tuesday
2023-02-28,Shenzhen Bay,15281,6957,301,22539,13939,6498,468,20905,Tuesday
2023-02-28,China Ferry Terminal,592,453,28,1073,623,341,34,998,Tuesday
2023-02-28,Harbour Control,0,0,0,0,0,0,0,0,Tuesday
2023-02-28,Kai Tak Cruise Terminal,0,0,0,0,0,0,0,0,Tuesday
2023-02-28,Macau Ferry Terminal,5312,550,1030,6892,4661,836,1148,6645,Tuesday
2023-02-28,Total,142932,48673,14788,206393,137727,47072,14801,199600,Tuesday
2023-03-01,Airport,15504,5536,10681,31721,18657,5106,7668,31431,Wednesday
2023-03-01,Express Rail Link West Kowloon,5953,8362,404,14719,7564,6456,355,14375,Wednesday
2023-03-01,Hung Hom,0,0,0,0,0,0,0,0,Wednesday
2023-03-01,Lo Wu,39691,12129,318,52138,41158,13693,328,55179,Wednesday
2023-03-01,Lok Ma Chau Spur Line,28869,9462,174,38505,29453,8321,147,37921,Wednesday
2023-03-01,Heung Yuen Wai,6217,3915,14,10146,6894,1621,14,8529,Wednesday
2023-03-01,Hong Kong-Zhuhai-Macao Bridge,13821,2979,2438,19238,13615,3893,2389,19897,Wednesday
2023-03-01,Lok Ma Chau,5729,2084,140,7953,4829,1750,156,6735,Wednesday
2023-03-01,Man Kam To,1572,582,10,2164,1439,380,9,1828,Wednesday
2023-03-01,Sha Tau Kok,0,0,0,0,0,0,0,0,Wednesday
2023-03-01,Shenzhen Bay,13310,6986,360,20656,14285,6285,522,21092,Wednesday
2023-03-01,China Ferry Terminal,546,402,38,986,603,341,31,975,Wednesday
2023-03-01,Harbour Control,0,0,0,0,0,0,0,0,Wednesday
2023-03-01,Kai Tak Cruise Terminal,0,0,0,0,0,0,0,0,Wednesday
2023-03-01,Macau Ferry Terminal,5133,707,1053,6893,4805,868,986,6659,Wednesday
2023-03-01,Total,136345,53144,15630,205119,143302,48714,12605,204621,Wednesday
2023-03-02,Airport,14072,6010,9617,29699,19251,5031,6360,30642,Thursday
2023-03-02,Express Rail Link West Kowloon,6103,8461,399,14963,7324,6681,353,14358,Thursday
2023-03-02,Hung Hom,0,0,0,0,0,0,0,0,Thursday
2023-03-02,Lo Wu,41220,12323,300,53843,42227,15510,370,58107,Thursday
2023-03-02,Lok Ma Chau Spur Line,29846,9281,184,39311,30423,8740,153,39316,Thursday
2023-03-02,Heung Yuen Wai,6748,3722,35,10505,7517,1598,20,9135,Thursday
2023-03-02,Hong Kong-Zhuhai-Macao Bridge,13949,2762,2440,19151,15109,4214,2400,21723,Thursday
2023-03-02,Lok Ma Chau,6023,1603,105,7731,4968,1854,150,6972,Thursday
2023-03-02,Man Kam To,1515,543,2,2060,1418,406,1,1825,Thursday
2023-03-02,Sha Tau Kok,0,0,0,0,0,0,0,0,Thursday
2023-03-02,Shenzhen Bay,14189,6782,394,21365,14756,6805,563,22124,Thursday
2023-03-02,China Ferry Terminal,573,417,26,1016,621,307,18,946,Thursday
2023-03-02,Harbour Control,0,0,0,0,0,0,0,0,Thursday
2023-03-02,Kai Tak Cruise Terminal,0,0,0,0,0,0,0,0,Thursday
2023-03-02,Macau Ferry Terminal,4529,604,1115,6248,4786,845,1152,6783,Thursday
2023-03-02,Total,138767,52508,14617,205892,148400,51991,11540,211931,Thursday
2023-03-03,Airport,14834,6097,9665,30596,20844,5456,7568,33868,Friday
2023-03-03,Express Rail Link West Kowloon,6361,11206,654,18221,10935,5841,281,17057,Friday
2023-03-03,Hung Hom,0,0,0,0,0,0,0,0,Friday
2023-03-03,Lo Wu,43718,13939,331,57988,54237,16874,393,71504,Friday
2023-03-03,Lok Ma Chau Spur Line,31662,11152,284,43098,41340,10174,204,51718,Friday
2023-03-03,Heung Yuen Wai,6687,3421,20,10128,8949,1616,29,10594,Friday
2023-03-03,Hong Kong-Zhuhai-Macao Bridge,15915,3334,3246,22495,21705,3898,2829,28432,Friday
2023-03-03,Lok Ma Chau,6415,2017,143,8575,6103,2448,151,8702,Friday
2023-03-03,Man Kam To,1617,607,3,2227,1706,483,4,2193,Friday
2023-03-03,Sha Tau Kok,0,0,0,0,0,0,0,0,Friday
2023-03-03,Shenzhen Bay,15649,8571,476,24696,22186,8097,484,30767,Friday
2023-03-03,China Ferry Terminal,751,544,53,1348,1041,421,35,1497,Friday
2023-03-03,Harbour Control,0,0,0,0,0,0,0,0,Friday
2023-03-03,Kai Tak Cruise Terminal,0,0,0,0,0,0,0,0,Friday
2023-03-03,Macau Ferry Terminal,5120,659,1454,7233,7129,850,1136,9115,Friday
2023-03-03,Total,142932,48673,14788,206393,137727,47072,14801,199600,Friday
2023-03-04,Airport,16002,5326,8161,29489,18792,5066,8719,32577,Saturday
2023-03-04,Express Rail Link West Kowloon,5936,12254,607,18797,11434,7456,362,19252,Saturday
2023-03-04,Hung Hom,0,0,0,0,0,0,0,0,Saturday
2023-03-04,Lo Wu,45797,19202,432,65431,67206,25285,492,92983,Saturday
2023-03-04,Lok Ma Chau Spur Line,32036,22333,391,54760,49021,19871,357,69249,Saturday
2023-03-04,Heung Yuen Wai,8312,6193,32,14537,11754,2649,25,14428,Saturday
2023-03-04,Hong Kong-Zhuhai-Macao Bridge,19816,3993,5742,29551,31217,4683,4897,40797,Saturday
2023-03-04,Lok Ma Chau,7654,2411,180,10245,7941,3254,156,11351,Saturday
2023-03-04,Man Kam To,915,850,8,1773,1256,560,12,1828,Saturday
2023-03-04,Sha Tau Kok,0,0,0,0,0,0,0,0,Saturday
2023-03-04,Shenzhen Bay,14742,12752,655,28149,23134,11696,581,35411,Saturday
2023-03-04,China Ferry Terminal,552,693,69,1314,962,326,34,1322,Saturday
2023-03-04,Harbour Control,0,0,0,0,0,0,0,0,Saturday
2023-03-04,Kai Tak Cruise Terminal,0,0,0,0,0,0,0,0,Saturday
2023-03-04,Macau Ferry Terminal,5181,804,1517,7502,8173,963,1332,10468,Saturday
2023-03-04,Total,156943,86811,17794,261548,230890,81809,16967,329666,Saturday
2023-03-05,Airport,21017,5639,7508,34164,18147,5579,12729,36455,Sunday
2023-03-05,Express Rail Link West Kowloon,10076,9866,400,20342,6853,10204,662,17719,Sunday
2023-03-05,Hung Hom,0,0,0,0,0,0,0,0,Sunday
2023-03-05,Lo Wu,71532,13104,238,84874,44239,20832,476,65547,Sunday
2023-03-05,Lok Ma Chau Spur Line,50472,14106,238,64816,31360,16843,409,48612,Sunday
2023-03-05,Heung Yuen Wai,12580,4360,26,16966,8980,2756,25,11761,Sunday
2023-03-05,Hong Kong-Zhuhai-Macao Bridge,37112,3437,4703,45252,22221,4506,5936,32663,Sunday
2023-03-05,Lok Ma Chau,12858,1646,160,14664,5918,3516,249,9683,Sunday
2023-03-05,Man Kam To,1445,540,9,1994,702,511,8,1221,Sunday
2023-03-05,Sha Tau Kok,0,0,0,0,0,0,0,0,Sunday
2023-03-05,Shenzhen Bay,28547,8516,539,37602,16260,11940,961,29161,Sunday
2023-03-05,China Ferry Terminal,1191,545,19,1755,505,562,57,1124,Sunday
2023-03-05,Harbour Control,0,0,0,0,0,0,0,0,Sunday
2023-03-05,Kai Tak Cruise Terminal,0,0,0,0,0,0,0,0,Sunday
2023-03-05,Macau Ferry Terminal,8640,553,909,10102,5507,859,1564,7930,Sunday
2023-03-05,Total,255470,62312,14749,332531,160692,78108,23076,261876,Sunday
2023-03-06,Airport,17444,5899,7924,31267,15573,5137,11805,32515,Monday
2023-03-06,Express Rail Link West Kowloon,7791,8307,325,16423,7277,7813,520,15610,Monday
2023-03-06,Hung Hom,0,0,0,0,0,0,0,0,Monday
2023-03-06,Lo Wu,45026,10333,204,55563,40669,11790,262,52721,Monday
2023-03-06,Lok Ma Chau Spur Line,32788,8621,145,41554,30300,8142,176,38618,Monday
2023-03-06,Heung Yuen Wai,7383,3303,31,10717,7171,1647,30,8848,Monday
2023-03-06,Hong Kong-Zhuhai-Macao Bridge,17637,2344,2511,22492,15544,3891,2756,22191,Monday
2023-03-06,Lok Ma Chau,7430,1750,102,9282,5090,1939,199,7228,Monday
2023-03-06,Man Kam To,1733,510,12,2255,1486,371,7,1864,Monday
2023-03-06,Sha Tau Kok,0,0,0,0,0,0,0,0,Monday
2023-03-06,Shenzhen Bay,17116,6847,325,24288,14452,6659,704,21815,Monday
2023-03-06,China Ferry Terminal,627,484,26,1137,679,379,33,1091,Monday
2023-03-06,Harbour Control,0,0,0,0,0,0,0,0,Monday
2023-03-06,Kai Tak Cruise Terminal,0,0,0,0,0,0,0,0,Monday
2023-03-06,Macau Ferry Terminal,5908,530,1014,7452,4871,823,1105,6799,Monday
2023-03-06,Total,160883,48928,12619,222430,143112,48591,17597,209300,Monday
2023-03-07,Airport,16023,5490,7296,28809,16045,5253,9613,30911,Tuesday
2023-03-07,Express Rail Link West Kowloon,6092,7292,351,13735,6890,7120,449,14459,Tuesday
2023-03-07,Hung Hom,0,0,0,0,0,0,0,0,Tuesday
2023-03-07,Lo Wu,41658,10133,306,52097,41969,12354,395,54718,Tuesday
2023-03-07,Lok Ma Chau Spur Line,29694,8160,159,38013,30072,7896,185,38153,Tuesday
2023-03-07,Heung Yuen Wai,6855,3095,16,9966,7571,1531,15,9117,Tuesday
2023-03-07,Hong Kong-Zhuhai-Macao Bridge,15355,2444,2461,20260,15076,3002,2495,20573,Tuesday
2023-03-07,Lok Ma Chau,5987,1693,106,7786,5260,1678,181,7119,Tuesday
2023-03-07,Man Kam To,1611,455,7,2073,1517,342,8,1867,Tuesday
2023-03-07,Sha Tau Kok,0,0,0,0,0,0,0,0,Tuesday
2023-03-07,Shenzhen Bay,14596,6478,375,21449,13916,6460,554,20930,Tuesday
2023-03-07,China Ferry Terminal,482,421,44,947,583,382,34,999,Tuesday
2023-03-07,Harbour Control,0,0,0,0,0,0,0,0,Tuesday
2023-03-07,Kai Tak Cruise Terminal,9,1,353,363,45,0,559,604,Tuesday
2023-03-07,Macau Ferry Terminal,4898,668,1133,6699,4888,959,1050,6897,Tuesday
2023-03-07,Total,143260,46330,12607,202197,143832,46977,15538,206347,Tuesday
2023-03-08,Airport,15816,6068,7892,29776,18292,5217,7791,31300,Wednesday
2023-03-08,Express Rail Link West Kowloon,5865,8485,386,14736,7165,6865,404,14434,Wednesday
2023-03-08,Hung Hom,0,0,0,0,0,0,0,0,Wednesday
2023-03-08,Lo Wu,41606,10676,329,52611,42131,13218,413,55762,Wednesday
2023-03-08,Lok Ma Chau Spur Line,29939,9587,189,39715,30032,9059,178,39269,Wednesday
2023-03-08,Heung Yuen Wai,6754,3126,20,9900,7226,1603,12,8841,Wednesday
2023-03-08,Hong Kong-Zhuhai-Macao Bridge,14518,2677,3006,20201,14540,3760,3114,21414,Wednesday
2023-03-08,Lok Ma Chau,6114,1684,120,7918,4987,1732,181,6900,Wednesday
2023-03-08,Man Kam To,1634,481,6,2121,1508,386,12,1906,Wednesday
2023-03-08,Sha Tau Kok,0,0,0,0,0,0,0,0,Wednesday
2023-03-08,Shenzhen Bay,13827,7034,424,21285,13710,6829,547,21086,Wednesday
2023-03-08,China Ferry Terminal,509,401,37,947,550,384,37,971,Wednesday
2023-04-10,Lo Wu,110619,10520,451,121590,37556,8065,290,45911,Monday
2023-03-08,Harbour Control,0,0,0,0,0,0,0,0,Wednesday
2023-03-08,Kai Tak Cruise Terminal,127,15,3360,3502,0,0,0,0,Wednesday
2023-03-08,Macau Ferry Terminal,4955,655,1156,6766,4671,1052,1190,6913,Wednesday
2023-03-08,Total,141664,50889,16925,209478,144812,50105,13879,208796,Wednesday
2023-03-09,Airport,15807,6956,9029,31792,19956,5021,7144,32121,Thursday
2023-03-09,Express Rail Link West Kowloon,6048,8045,445,14538,7022,6539,403,13964,Thursday
2023-03-09,Hung Hom,0,0,0,0,0,0,0,0,Thursday
2023-03-09,Lo Wu,42209,11963,351,54523,42665,14430,411,57506,Thursday
2023-03-09,Lok Ma Chau Spur Line,30641,9342,166,40149,31117,8363,173,39653,Thursday
2023-03-09,Heung Yuen Wai,6909,3793,17,10719,7655,1621,30,9306,Thursday
2023-03-09,Hong Kong-Zhuhai-Macao Bridge,15187,3276,2464,20927,16235,4658,2566,23459,Thursday
2023-03-09,Lok Ma Chau,6489,1487,126,8102,5106,1627,160,6893,Thursday
2023-03-09,Man Kam To,1666,547,2,2215,1504,392,7,1903,Thursday
2023-03-09,Sha Tau Kok,0,0,0,0,0,0,0,0,Thursday
2023-03-09,Shenzhen Bay,14247,6835,483,21565,15136,6885,529,22550,Thursday
2023-03-09,China Ferry Terminal,574,486,53,1113,647,405,36,1088,Thursday
2023-03-09,Harbour Control,0,0,0,0,0,0,0,0,Thursday
2023-03-09,Kai Tak Cruise Terminal,3,2,665,670,2,0,2193,2195,Thursday
2023-03-09,Macau Ferry Terminal,4737,702,1105,6544,5223,978,1140,7341,Thursday
2023-03-09,Total,144517,53434,14906,212857,152268,50919,14792,217979,Thursday
2023-03-11,Airport,18602,6105,8714,33421,19077,5511,7808,32396,Saturday
2023-03-11,Express Rail Link West Kowloon,6973,15529,748,23250,13608,8088,399,22095,Saturday
2023-03-11,Hung Hom,0,0,0,0,0,0,0,0,Saturday
2023-03-11,Lo Wu,46996,19099,403,66498,69230,24517,437,94184,Saturday
2023-03-11,Lok Ma Chau Spur Line,33422,22165,434,56021,49872,19287,344,69503,Saturday
2023-03-11,Heung Yuen Wai,8676,7019,20,15715,12979,3311,12,16302,Saturday
2023-03-11,Hong Kong-Zhuhai-Macao Bridge,19704,5122,5940,30766,32116,6557,4673,43346,Saturday
2023-03-11,Lok Ma Chau,8036,2551,186,10773,8122,3403,162,11687,Saturday
2023-03-11,Man Kam To,962,980,14,1956,1270,552,14,1836,Saturday
2023-03-11,Sha Tau Kok,0,0,0,0,0,0,0,0,Saturday
2023-03-11,Shenzhen Bay,15076,12783,671,28530,24263,11755,585,36603,Saturday
2023-03-11,China Ferry Terminal,473,803,49,1325,845,398,41,1284,Saturday
2023-03-11,Harbour Control,0,0,0,0,0,0,0,0,Saturday
2023-03-11,Kai Tak Cruise Terminal,0,0,539,539,2,0,845,847,Saturday
2023-03-11,Macau Ferry Terminal,5383,821,1714,7918,8231,928,1351,10510,Saturday
2023-03-11,Total,164303,92977,19432,276712,239615,84307,16671,340593,Saturday
2023-03-10,Airport,17275,6780,9504,33559,21097,5884,8074,35055,Friday
2023-03-10,Express Rail Link West Kowloon,6235,10993,670,17898,11436,5826,309,17571,Friday
2023-03-10,Hung Hom,0,0,0,0,0,0,0,0,Friday
2023-03-10,Lo Wu,44096,14166,383,58645,55312,16261,399,71972,Friday
2023-03-10,Lok Ma Chau Spur Line,32025,11283,272,43580,40768,9825,153,50746,Friday
2023-03-10,Heung Yuen Wai,7330,3849,32,11211,9597,2127,25,11749,Friday
2023-03-10,Hong Kong-Zhuhai-Macao Bridge,16294,4122,2914,23330,21964,4511,2637,29112,Friday
2023-03-10,Lok Ma Chau,6772,1837,244,8853,6296,1924,195,8415,Friday
2023-03-10,Man Kam To,1673,615,7,2295,1810,384,10,2204,Friday
2023-03-10,Sha Tau Kok,0,0,0,0,0,0,0,0,Friday
2023-03-10,Shenzhen Bay,15751,8704,693,25148,23028,7209,494,30731,Friday
2023-03-10,China Ferry Terminal,707,572,63,1342,974,394,29,1397,Friday
2023-03-10,Harbour Control,0,0,0,0,0,0,0,0,Friday
2023-03-10,Kai Tak Cruise Terminal,0,0,0,0,1360,51,489,1900,Friday
2023-03-10,Macau Ferry Terminal,5180,992,1263,7435,6945,987,1092,9024,Friday
2023-03-10,Total,153338,63913,16045,233296,200587,55383,13906,269876,Friday
2023-03-12,Airport,22811,5950,8402,37163,19025,6978,10347,36350,Sunday
2023-03-12,Express Rail Link West Kowloon,12030,11381,534,23945,7698,12729,781,21208,Sunday
2023-03-12,Hung Hom,0,0,0,0,0,0,0,0,Sunday
2023-03-12,Lo Wu,76656,11803,260,88719,46134,19179,422,65735,Sunday
2023-03-12,Lok Ma Chau Spur Line,53829,12686,227,66742,33932,16565,403,50900,Sunday
2023-03-12,Heung Yuen Wai,14194,5840,31,20065,10283,3315,20,13618,Sunday
2023-03-12,Hong Kong-Zhuhai-Macao Bridge,40239,4503,4711,49453,24979,6054,6068,37101,Sunday
2023-03-12,Lok Ma Chau,13939,1877,131,15947,6620,3319,263,10202,Sunday
2023-03-12,Man Kam To,1470,493,17,1980,830,460,6,1296,Sunday
2023-03-12,Sha Tau Kok,0,0,0,0,0,0,0,0,Sunday
2023-03-12,Shenzhen Bay,31494,8240,512,40246,17162,10961,774,28897,Sunday
2023-03-12,China Ferry Terminal,1238,469,21,1728,507,723,38,1268,Sunday
2023-03-12,Harbour Control,0,0,0,0,0,0,0,0,Sunday
2023-03-12,Kai Tak Cruise Terminal,1360,46,50,1456,572,14,23,609,Sunday
2023-03-12,Macau Ferry Terminal,8913,861,1073,10847,5748,1140,1435,8323,Sunday
2023-03-12,Total,278173,64149,15969,358291,173490,81437,20580,275507,Sunday
2023-03-13,Airport,20079,6847,8605,35531,17209,5768,8439,31416,Monday
2023-03-13,Express Rail Link West Kowloon,9671,9469,426,19566,7979,8318,496,16793,Monday
2023-03-13,Hung Hom,0,0,0,0,0,0,0,0,Monday
2023-03-13,Lo Wu,45501,10600,241,56342,40850,10567,260,51677,Monday
2023-03-13,Lok Ma Chau Spur Line,33495,8602,154,42251,31437,7953,177,39567,Monday
2023-03-13,Heung Yuen Wai,7556,4269,13,11838,7513,1855,15,9383,Monday
2023-03-13,Hong Kong-Zhuhai-Macao Bridge,18948,3613,2494,25055,15675,5873,2761,24309,Monday
2023-03-13,Lok Ma Chau,7901,2164,126,10191,5228,1950,244,7422,Monday
2023-03-13,Man Kam To,1814,519,10,2343,1564,372,8,1944,Monday
2023-03-13,Sha Tau Kok,0,0,0,0,0,0,0,0,Monday
2023-03-13,Shenzhen Bay,18188,7709,372,26269,15056,6844,775,22675,Monday
2023-03-13,China Ferry Terminal,698,507,28,1233,683,351,35,1069,Monday
2023-03-13,Harbour Control,0,0,0,0,0,0,0,0,Monday
2023-03-13,Kai Tak Cruise Terminal,0,0,0,0,0,0,0,0,Monday
2023-03-13,Macau Ferry Terminal,6068,589,921,7578,4942,864,1072,6878,Monday
2023-03-13,Total,169919,54888,13390,238197,148136,50715,14282,213133,Monday
2023-03-14,Airport,17214,5517,7592,30323,17421,5360,7364,30145,Tuesday
2023-03-14,Express Rail Link West Kowloon,6699,8252,456,15407,7220,7414,469,15103,Tuesday
2023-03-14,Hung Hom,0,0,0,0,0,0,0,0,Tuesday
2023-03-14,Lo Wu,42155,10768,263,53186,41634,12804,334,54772,Tuesday
2023-03-14,Lok Ma Chau Spur Line,30331,8785,163,39279,29892,8069,197,38158,Tuesday
2023-03-14,Heung Yuen Wai,7277,4756,15,12048,7694,2273,16,9983,Tuesday
2023-03-14,Hong Kong-Zhuhai-Macao Bridge,15108,3458,2411,20977,14223,5206,2432,21861,Tuesday
2023-03-14,Lok Ma Chau,6774,1529,121,8424,5606,1706,188,7500,Tuesday
2023-03-14,Man Kam To,1671,484,13,2168,1532,358,8,1898,Tuesday
2023-03-14,Sha Tau Kok,0,0,0,0,0,0,0,0,Tuesday
2023-04-21,Total,154784,76645,23915,255344,194624,78254,20505,293383,Friday
2023-03-14,Shenzhen Bay,15628,6757,389,22774,14343,6571,596,21510,Tuesday
2023-03-14,China Ferry Terminal,570,430,52,1052,549,400,31,980,Tuesday
2023-03-14,Harbour Control,0,0,0,0,0,0,0,0,Tuesday
2023-03-14,Kai Tak Cruise Terminal,0,0,0,0,0,0,0,0,Tuesday
2023-03-14,Macau Ferry Terminal,4921,677,1007,6605,4316,951,1009,6276,Tuesday
2023-03-14,Total,148348,51413,12482,212243,144430,51112,12644,208186,Tuesday
2023-03-15,Airport,17600,6784,8653,33037,18814,5849,7569,32232,Wednesday
2023-03-15,Express Rail Link West Kowloon,6689,8787,480,15956,7569,7834,498,15901,Wednesday
2023-03-15,Hung Hom,0,0,0,0,0,0,0,0,Wednesday
2023-03-15,Lo Wu,40263,10163,230,50656,39878,12481,347,52706,Wednesday
2023-03-15,Lok Ma Chau Spur Line,30139,8786,208,39133,30305,8392,209,38906,Wednesday
2023-03-15,Heung Yuen Wai,6975,3796,21,10792,7694,2111,24,9829,Wednesday
2023-03-15,Hong Kong-Zhuhai-Macao Bridge,14475,3736,2443,20654,14148,5679,2434,22261,Wednesday
2023-03-15,Lok Ma Chau,6414,1646,147,8207,5312,1786,199,7297,Wednesday
2023-03-15,Man Kam To,1632,480,12,2124,1554,370,6,1930,Wednesday
2023-03-15,Sha Tau Kok,0,0,0,0,0,0,0,0,Wednesday
2023-03-15,Shenzhen Bay,14931,7021,411,22363,14128,7057,631,21816,Wednesday
2023-03-15,China Ferry Terminal,527,495,45,1067,628,368,35,1031,Wednesday
2023-03-15,Harbour Control,0,0,0,0,0,0,0,0,Wednesday
2023-03-15,Kai Tak Cruise Terminal,571,14,15,600,690,14,22,726,Wednesday
2023-03-15,Macau Ferry Terminal,4561,722,1082,6365,4447,1079,997,6523,Wednesday
2023-03-15,Total,144777,52430,13747,210954,145167,53020,12971,211158,Wednesday
2023-03-16,Airport,16554,7337,9439,33330,20151,5224,7662,33037,Thursday
2023-03-16,Express Rail Link West Kowloon,6657,9269,480,16406,8892,8081,473,17446,Thursday
2023-03-16,Hung Hom,0,0,0,0,0,0,0,0,Thursday
2023-03-16,Lo Wu,42358,12096,337,54791,43834,15033,400,59267,Thursday
2023-03-16,Lok Ma Chau Spur Line,30594,9522,185,40301,31998,9001,166,41165,Thursday
2023-03-16,Heung Yuen Wai,7415,5519,23,12957,8308,2532,25,10865,Thursday
2023-03-16,Hong Kong-Zhuhai-Macao Bridge,14547,3694,2408,20649,16043,5790,2530,24363,Thursday
2023-03-16,Lok Ma Chau,6417,1573,189,8179,5366,1783,203,7352,Thursday
2023-03-16,Man Kam To,1671,488,4,2163,1585,349,8,1942,Thursday
2023-03-16,Sha Tau Kok,0,0,0,0,0,0,0,0,Thursday
2023-03-16,Shenzhen Bay,14426,7112,472,22010,15428,7890,637,23955,Thursday
2023-03-16,China Ferry Terminal,536,456,53,1045,650,390,38,1078,Thursday
2023-03-16,Harbour Control,0,0,0,0,0,0,0,0,Thursday
2023-03-16,Kai Tak Cruise Terminal,0,0,0,0,0,0,0,0,Thursday
2023-03-16,Macau Ferry Terminal,4603,704,1013,6320,5144,1103,1114,7361,Thursday
2023-03-16,Total,145778,57770,14603,218151,157399,57176,13256,227831,Thursday
2023-03-17,Airport,18219,7706,10661,36586,22119,6150,8679,36948,Friday
2023-03-17,Express Rail Link West Kowloon,7219,14336,691,22246,12753,7079,498,20330,Friday
2023-03-17,Hung Hom,0,0,0,0,0,0,0,0,Friday
2023-03-17,Lo Wu,44771,14379,370,59520,55358,16550,408,72316,Friday
2023-03-17,Lok Ma Chau Spur Line,32396,11758,217,44371,40932,10137,179,51248,Friday
2023-03-17,Heung Yuen Wai,7472,5846,24,13342,9729,2695,15,12439,Friday
2023-03-17,Hong Kong-Zhuhai-Macao Bridge,15993,4740,3028,23761,21898,6551,2658,31107,Friday
2023-03-17,Lok Ma Chau,6962,1972,222,9156,6715,2483,196,9394,Friday
2023-03-17,Man Kam To,1622,592,4,2218,1720,432,2,2154,Friday
2023-03-17,Sha Tau Kok,0,0,0,0,0,0,0,0,Friday
2023-03-17,Shenzhen Bay,16210,9149,696,26055,22319,8361,591,31271,Friday
2023-03-17,China Ferry Terminal,695,631,47,1373,943,505,32,1480,Friday
2023-03-17,Harbour Control,0,0,0,0,0,0,0,0,Friday
2023-03-17,Kai Tak Cruise Terminal,690,14,14,718,1338,37,54,1429,Friday
2023-03-17,Macau Ferry Terminal,5359,854,1320,7533,7594,1111,1160,9865,Friday
2023-03-17,Total,157608,71977,17294,246879,203418,62091,14472,279981,Friday
2023-03-18,Airport,18830,6731,9777,35338,19318,5569,8509,33396,Saturday
2023-03-18,Express Rail Link West Kowloon,7374,17504,677,25555,13097,9569,489,23155,Saturday
2023-03-18,Hung Hom,0,0,0,0,0,0,0,0,Saturday
2023-03-18,Lo Wu,48548,20241,447,69236,67362,25646,483,93491,Saturday
2023-03-18,Lok Ma Chau Spur Line,35403,24644,372,60419,50929,20355,286,71570,Saturday
2023-03-18,Heung Yuen Wai,9546,7858,39,17443,13640,4340,32,18012,Saturday
2023-03-18,Hong Kong-Zhuhai-Macao Bridge,20821,5514,5646,31981,31119,6702,4689,42510,Saturday
2023-03-18,Lok Ma Chau,8793,2892,266,11951,8565,4542,222,13329,Saturday
2023-03-18,Man Kam To,997,1096,12,2105,1315,624,11,1950,Saturday
2023-03-18,Sha Tau Kok,0,0,0,0,0,0,0,0,Saturday
2023-03-18,Shenzhen Bay,16343,13984,752,31079,23199,12107,643,35949,Saturday
2023-03-18,China Ferry Terminal,599,868,76,1543,870,409,35,1314,Saturday
2023-03-18,Harbour Control,0,0,0,0,0,0,0,0,Saturday
2023-03-18,Kai Tak Cruise Terminal,0,0,0,0,0,0,0,0,Saturday
2023-03-18,Macau Ferry Terminal,5651,1126,1736,8513,9362,1083,1409,11854,Saturday
2023-03-18,Total,172905,102458,19800,295163,238776,90946,16808,346530,Saturday
2023-03-20,Airport,20381,7708,9943,38032,18250,5980,8466,32696,Monday
2023-03-20,Express Rail Link West Kowloon,9312,9503,497,19312,8172,9179,524,17875,Monday
2023-03-20,Hung Hom,0,0,0,0,0,0,0,0,Monday
2023-03-20,Lo Wu,44928,10134,256,55318,41162,11967,309,53438,Monday
2023-03-20,Lok Ma Chau Spur Line,33445,9068,139,42652,31200,8733,213,40146,Monday
2023-03-20,Heung Yuen Wai,7813,6586,27,14426,7736,3043,15,10794,Monday
2023-03-20,Hong Kong-Zhuhai-Macao Bridge,17809,4521,2822,25152,15346,7446,3171,25963,Monday
2023-03-20,Lok Ma Chau,8224,2044,130,10398,5499,2730,276,8505,Monday
2023-03-20,Man Kam To,1817,539,10,2366,1563,407,6,1976,Monday
2023-03-20,Sha Tau Kok,0,0,0,0,0,0,0,0,Monday
2023-03-20,Shenzhen Bay,17483,7219,436,25138,14563,7281,807,22651,Monday
2023-03-20,China Ferry Terminal,694,473,30,1197,710,490,39,1239,Monday
2023-03-20,Harbour Control,0,0,0,0,0,0,0,0,Monday
2023-03-20,Kai Tak Cruise Terminal,0,0,0,0,0,0,0,0,Monday
2023-03-20,Macau Ferry Terminal,6754,624,1230,8608,4904,1077,1182,7163,Monday
2023-03-20,Total,168660,58419,15520,242599,149105,58333,15008,222446,Monday
2023-03-19,Airport,23592,6934,9626,40152,19497,6715,11008,37220,Sunday
2023-03-19,Express Rail Link West Kowloon,12696,12417,518,25631,7471,13678,680,21829,Sunday
2023-03-19,Hung Hom,0,0,0,0,0,0,0,0,Sunday
2023-03-19,Lo Wu,72595,13911,279,86785,44483,22770,448,67701,Sunday
2023-03-19,Lok Ma Chau Spur Line,52186,14194,264,66644,33811,18275,413,52499,Sunday
2023-03-19,Heung Yuen Wai,14235,8937,31,23203,10408,3774,21,14203,Sunday
2023-03-19,Hong Kong-Zhuhai-Macao Bridge,36916,5094,4581,46591,21695,6834,5480,34009,Sunday
2023-03-19,Lok Ma Chau,13489,1735,173,15397,6704,5642,256,12602,Sunday
2023-03-19,Man Kam To,1553,729,9,2291,839,548,9,1396,Sunday
2023-03-19,Sha Tau Kok,0,0,0,0,0,0,0,0,Sunday
2023-03-19,Shenzhen Bay,29788,9448,539,39775,16753,12731,914,30398,Sunday
2023-03-19,China Ferry Terminal,1178,635,47,1860,457,700,74,1231,Sunday
2023-03-19,Harbour Control,0,0,0,0,0,0,0,0,Sunday
2023-03-19,Kai Tak Cruise Terminal,1338,37,39,1414,379,54,15,448,Sunday
2023-03-19,Macau Ferry Terminal,9233,745,1011,10989,6059,1215,1563,8837,Sunday
2023-03-19,Total,268799,74816,17117,360732,168556,92936,20881,282373,Sunday
2023-03-21,Airport,18316,6826,8892,34034,17193,5556,8808,31557,Tuesday
2023-03-21,Express Rail Link West Kowloon,7016,9299,618,16933,7368,8045,546,15959,Tuesday
2023-03-21,Hung Hom,0,0,0,0,0,0,0,0,Tuesday
2023-03-21,Lo Wu,41518,11591,358,53467,41224,13794,384,55402,Tuesday
2023-03-21,Lok Ma Chau Spur Line,30726,9526,175,40427,30732,8695,195,39622,Tuesday
2023-03-21,Heung Yuen Wai,7313,6778,23,14114,7980,3109,27,11116,Tuesday
2023-03-21,Hong Kong-Zhuhai-Macao Bridge,14490,4181,2406,21077,13767,8613,2669,25049,Tuesday
2023-03-21,Lok Ma Chau,6285,1816,149,8250,5420,1984,235,7639,Tuesday
2023-03-21,Man Kam To,1675,559,4,2238,1528,435,5,1968,Tuesday
2023-03-21,Sha Tau Kok,0,0,0,0,0,0,0,0,Tuesday
2023-03-21,Shenzhen Bay,15293,7314,543,23150,14200,7014,703,21917,Tuesday
2023-03-21,China Ferry Terminal,519,494,49,1062,548,353,22,923,Tuesday
2023-03-21,Harbour Control,0,0,0,0,0,0,0,0,Tuesday
2023-03-21,Kai Tak Cruise Terminal,3,0,209,212,0,0,0,0,Tuesday
2023-03-21,Macau Ferry Terminal,5057,742,1217,7016,4736,1138,1243,7117,Tuesday
2023-03-21,Total,148211,59126,14643,221980,144696,58736,14837,218269,Tuesday
2023-03-22,Airport,18217,7537,9405,35159,19207,5553,8322,33082,Wednesday
2023-03-22,Express Rail Link West Kowloon,6536,9465,527,16528,6905,7672,497,15074,Wednesday
2023-03-22,Hung Hom,0,0,0,0,0,0,0,0,Wednesday
2023-03-22,Lo Wu,40647,11335,348,52330,39849,13627,418,53894,Wednesday
2023-03-22,Lok Ma Chau Spur Line,29971,9275,181,39427,29877,8809,201,38887,Wednesday
2023-03-22,Heung Yuen Wai,7089,7443,14,14546,7648,2663,20,10331,Wednesday
2023-03-22,Hong Kong-Zhuhai-Macao Bridge,13505,3967,2283,19755,13154,8591,2412,24157,Wednesday
2023-03-22,Lok Ma Chau,6357,1792,179,8328,5231,2111,266,7608,Wednesday
2023-03-22,Man Kam To,1582,494,4,2080,1476,354,3,1833,Wednesday
2023-03-22,Sha Tau Kok,0,0,0,0,0,0,0,0,Wednesday
2023-03-22,Shenzhen Bay,14790,7263,517,22570,13570,7042,637,21249,Wednesday
2023-03-22,China Ferry Terminal,436,481,36,953,476,353,38,867,Wednesday
2023-03-22,Harbour Control,0,0,0,0,0,0,0,0,Wednesday
2023-03-22,Kai Tak Cruise Terminal,379,54,15,448,806,53,193,1052,Wednesday
2023-03-22,Macau Ferry Terminal,4913,811,1085,6809,4718,1358,1055,7131,Wednesday
2023-03-22,Total,144422,59917,14594,218933,142917,58186,14062,215165,Wednesday
2023-03-23,Airport,17309,7993,10153,35455,21103,5491,8390,34984,Thursday
2023-03-23,Express Rail Link West Kowloon,6808,12013,620,19441,8111,8246,389,16746,Thursday
2023-03-23,Hung Hom,0,0,0,0,0,0,0,0,Thursday
2023-03-23,Lo Wu,40797,11683,350,52830,42424,14424,470,57318,Thursday
2023-03-23,Lok Ma Chau Spur Line,30484,9660,236,40380,31254,9570,201,41025,Thursday
2023-03-23,Heung Yuen Wai,7312,6471,46,13829,7930,2306,20,10256,Thursday
2023-03-23,Hong Kong-Zhuhai-Macao Bridge,13734,3963,2333,20030,14564,8345,2453,25362,Thursday
2023-03-23,Lok Ma Chau,6548,1896,215,8659,5262,2473,200,7935,Thursday
2023-03-23,Man Kam To,1710,588,14,2312,1545,414,14,1973,Thursday
2023-03-23,Sha Tau Kok,0,0,0,0,0,0,0,0,Thursday
2023-03-23,Shenzhen Bay,14157,7539,636,22332,14293,7439,591,22323,Thursday
2023-03-23,China Ferry Terminal,534,555,30,1119,515,400,27,942,Thursday
2023-03-23,Harbour Control,0,0,0,0,0,0,0,0,Thursday
2023-03-23,Kai Tak Cruise Terminal,0,0,0,0,0,0,0,0,Thursday
2023-03-23,Macau Ferry Terminal,4701,791,1245,6737,5264,1171,1281,7716,Thursday
2023-03-23,Total,144094,63152,15878,223124,152265,60279,14036,226580,Thursday
2023-03-24,Airport,18689,8532,10183,37404,23581,6429,9468,39478,Friday
2023-03-24,Express Rail Link West Kowloon,6507,18953,672,26132,12049,7753,406,20208,Friday
2023-03-24,Hung Hom,0,0,0,0,0,0,0,0,Friday
2023-03-24,Lo Wu,43351,14531,410,58292,53780,17258,428,71466,Friday
2023-03-24,Lok Ma Chau Spur Line,32642,13500,331,46473,41564,10904,243,52711,Friday
2023-03-24,Heung Yuen Wai,7477,5288,29,12794,10094,2917,21,13032,Friday
2023-03-24,Hong Kong-Zhuhai-Macao Bridge,15293,5121,2856,23270,19716,7292,2732,29740,Friday
2023-03-24,Lok Ma Chau,7267,2502,281,10050,6811,3161,234,10206,Friday
2023-03-24,Man Kam To,1630,621,10,2261,1807,432,8,2247,Friday
2023-03-24,Sha Tau Kok,0,0,0,0,0,0,0,0,Friday
2023-03-24,Shenzhen Bay,15604,10143,834,26581,20465,8802,603,29870,Friday
2023-03-24,China Ferry Terminal,597,811,67,1475,851,439,23,1313,Friday
2023-03-24,Harbour Control,0,0,0,0,0,0,0,0,Friday
2023-03-24,Kai Tak Cruise Terminal,806,52,8,866,1466,54,25,1545,Friday
2023-03-24,Macau Ferry Terminal,5350,1098,1349,7797,8012,1313,1150,10475,Friday
2023-03-24,Total,155213,81152,17030,253395,200196,66754,15341,282291,Friday
2023-03-25,Airport,20412,7074,8458,35944,20723,6388,9564,36675,Saturday
2023-03-25,Express Rail Link West Kowloon,6686,18042,648,25376,13428,10830,407,24665,Saturday
2023-03-25,Hung Hom,0,0,0,0,0,0,0,0,Saturday
2023-03-25,Lo Wu,44854,17455,468,62777,65048,23513,505,89066,Saturday
2023-03-25,Lok Ma Chau Spur Line,32781,21222,372,54375,47695,18508,300,66503,Saturday
2023-03-25,Heung Yuen Wai,8376,8334,24,16734,13178,4008,21,17207,Saturday
2023-03-25,Hong Kong-Zhuhai-Macao Bridge,18254,5536,5081,28871,28071,8407,4272,40750,Saturday
2023-03-25,Lok Ma Chau,9232,2766,321,12319,9487,6140,216,15843,Saturday
2023-03-25,Man Kam To,749,704,6,1459,1157,457,9,1623,Saturday
2023-03-25,Sha Tau Kok,0,0,0,0,0,0,0,0,Saturday
2023-03-25,Shenzhen Bay,14202,13467,828,28497,21256,12099,584,33939,Saturday
2023-03-25,China Ferry Terminal,509,853,67,1429,646,519,29,1194,Saturday
2023-03-25,Harbour Control,0,0,0,0,0,0,0,0,Saturday
2023-03-25,Kai Tak Cruise Terminal,0,0,0,0,0,0,0,0,Saturday
2023-03-25,Macau Ferry Terminal,6019,1096,1690,8805,9225,1212,1313,11750,Saturday
2023-03-25,Total,162074,96549,17963,276586,229914,92081,17220,339215,Saturday
2023-03-26,Airport,23755,7758,9221,40734,21607,8545,12243,42395,Sunday
2023-03-26,Express Rail Link West Kowloon,11513,12471,430,24414,7577,15692,598,23867,Sunday
2023-03-26,Hung Hom,0,0,0,0,0,0,0,0,Sunday
2023-03-26,Lo Wu,65990,11061,264,77315,41001,18631,394,60026,Sunday
2023-03-26,Lok Ma Chau Spur Line,48907,9939,218,59064,31322,13288,349,44959,Sunday
2023-03-26,Heung Yuen Wai,13419,6423,22,19864,8834,3105,28,11967,Sunday
2023-03-26,Hong Kong-Zhuhai-Macao Bridge,31166,4721,3572,39459,17550,6176,4611,28337,Sunday
2023-03-26,Lok Ma Chau,11506,1863,174,13543,6349,5287,299,11935,Sunday
2023-03-26,Man Kam To,1257,342,8,1607,718,280,10,1008,Sunday
2023-03-26,Sha Tau Kok,0,0,0,0,0,0,0,0,Sunday
2023-03-26,Shenzhen Bay,25773,7578,455,33806,15576,10670,953,27199,Sunday
2023-03-26,China Ferry Terminal,1099,422,41,1562,426,733,44,1203,Sunday
2023-03-26,Harbour Control,0,0,0,0,0,0,0,0,Sunday
2023-03-26,Kai Tak Cruise Terminal,1471,54,856,2381,637,149,856,1642,Sunday
2023-03-26,Macau Ferry Terminal,8945,695,930,10570,5681,1195,1296,8172,Sunday
2023-03-26,Total,244801,63327,16191,324319,157278,83751,21681,262710,Sunday
2023-03-27,Airport,20658,7454,9445,37557,20524,6639,10259,37422,Monday
2023-03-27,Express Rail Link West Kowloon,8910,8793,508,18211,8356,10448,603,19407,Monday
2023-03-27,Hung Hom,0,0,0,0,0,0,0,0,Monday
2023-03-27,Lo Wu,43615,9096,280,52991,39096,10644,341,50081,Monday
2023-03-27,Lok Ma Chau Spur Line,32876,7988,168,41032,30885,8027,191,39103,Monday
2023-03-27,Heung Yuen Wai,7540,5727,21,13288,7456,1939,30,9425,Monday
2023-03-27,Hong Kong-Zhuhai-Macao Bridge,15830,3483,2256,21569,14232,5923,2423,22578,Monday
2023-03-27,Lok Ma Chau,7426,2123,160,9709,5729,3161,290,9180,Monday
2023-03-27,Man Kam To,1776,438,4,2218,1621,325,5,1951,Monday
2023-03-27,Sha Tau Kok,0,0,0,0,0,0,0,0,Monday
2023-03-27,Shenzhen Bay,15467,6655,447,22569,14167,6916,854,21937,Monday
2023-03-27,China Ferry Terminal,531,364,34,929,635,376,45,1056,Monday
2023-03-27,Harbour Control,0,0,0,0,0,0,0,0,Monday
2023-03-27,Kai Tak Cruise Terminal,0,0,0,0,0,0,0,0,Monday
2023-03-27,Macau Ferry Terminal,5979,597,983,7559,5109,1035,1025,7169,Monday
2023-03-27,Total,160608,52718,14306,227632,147810,55433,16066,219309,Monday
2023-03-28,Airport,18349,6594,7599,32542,21442,6426,8948,36816,Tuesday
2023-03-28,Express Rail Link West Kowloon,7224,8452,495,16171,8461,8652,529,17642,Tuesday
2023-03-28,Hung Hom,0,0,0,0,0,0,0,0,Tuesday
2023-03-28,Lo Wu,41424,11348,369,53141,41302,13343,412,55057,Tuesday
2023-03-28,Lok Ma Chau Spur Line,30574,8684,216,39474,30906,7968,168,39042,Tuesday
2023-03-28,Heung Yuen Wai,7281,6714,20,14015,7664,3066,22,10752,Tuesday
2023-03-28,Hong Kong-Zhuhai-Macao Bridge,13305,3977,2094,19376,13166,8191,2235,23592,Tuesday
2023-03-28,Lok Ma Chau,6470,1753,174,8397,5461,1827,223,7511,Tuesday
2023-03-28,Man Kam To,1731,498,3,2232,1575,333,3,1911,Tuesday
2023-03-28,Sha Tau Kok,0,0,0,0,0,0,0,0,Tuesday
2023-03-28,Shenzhen Bay,14462,6785,500,21747,14047,6802,685,21534,Tuesday
2023-03-28,China Ferry Terminal,454,325,35,814,497,345,34,876,Tuesday
2023-03-28,Harbour Control,0,0,0,0,0,0,0,0,Tuesday
2023-03-28,Kai Tak Cruise Terminal,5,0,2166,2171,0,0,0,0,Tuesday
2023-03-28,Macau Ferry Terminal,5041,684,1020,6745,4969,1131,1009,7109,Tuesday
2023-03-28,Total,146320,55814,14691,216825,149490,58084,14268,221842,Tuesday
2023-03-29,Airport,18069,6851,9820,34740,23914,5504,10131,39549,Wednesday
2023-03-29,Express Rail Link West Kowloon,6754,8801,555,16110,8611,8189,520,17320,Wednesday
2023-03-29,Hung Hom,0,0,0,0,0,0,0,0,Wednesday
2023-03-29,Lo Wu,41124,11381,351,52856,42206,14055,424,56685,Wednesday
2023-03-29,Lok Ma Chau Spur Line,30763,9304,201,40268,31624,8892,174,40690,Wednesday
2023-03-29,Heung Yuen Wai,7418,6011,26,13455,8255,2726,22,11003,Wednesday
2023-03-29,Hong Kong-Zhuhai-Macao Bridge,13075,3532,2270,18877,12979,6496,2303,21778,Wednesday
2023-03-29,Lok Ma Chau,6309,1752,207,8268,5330,2164,232,7726,Wednesday
2023-03-29,Man Kam To,1712,578,7,2297,1622,414,5,2041,Wednesday
2023-03-29,Sha Tau Kok,0,0,0,0,0,0,0,0,Wednesday
2023-03-29,Shenzhen Bay,13922,6859,630,21411,14359,7154,633,22146,Wednesday
2023-03-29,China Ferry Terminal,493,397,50,940,605,323,42,970,Wednesday
2023-03-29,Harbour Control,0,0,0,0,0,0,0,0,Wednesday
2023-03-29,Kai Tak Cruise Terminal,647,150,2156,2953,959,52,2172,3183,Wednesday
2023-03-29,Macau Ferry Terminal,5065,768,907,6740,4678,1048,901,6627,Wednesday
2023-03-29,Total,145351,56384,17180,218915,155142,57017,17559,229718,Wednesday
2023-03-30,Airport,19113,7936,9672,36721,29192,5335,8650,43177,Thursday
2023-03-30,Express Rail Link West Kowloon,7127,8668,663,16458,11049,8380,600,20029,Thursday
2023-03-30,Hung Hom,0,0,0,0,0,0,0,0,Thursday
2023-03-30,Lo Wu,41479,11030,423,52932,44510,13658,443,58611,Thursday
2023-03-30,Lok Ma Chau Spur Line,30858,8672,205,39735,33512,8548,181,42241,Thursday
2023-03-30,Heung Yuen Wai,7491,4323,16,11830,8489,2807,18,11314,Thursday
2023-03-30,Hong Kong-Zhuhai-Macao Bridge,13638,3702,2069,19409,14687,7637,2126,24450,Thursday
2023-03-30,Lok Ma Chau,6627,1594,298,8519,5634,2092,250,7976,Thursday
2023-03-30,Man Kam To,1653,555,6,2214,1656,404,6,2066,Thursday
2023-03-30,Sha Tau Kok,0,0,0,0,0,0,0,0,Thursday
2023-03-30,Shenzhen Bay,14235,6702,652,21589,15798,7642,677,24117,Thursday
2023-03-30,China Ferry Terminal,531,591,32,1154,616,491,32,1139,Thursday
2023-03-30,Harbour Control,0,0,0,0,0,0,0,0,Thursday
2023-03-30,Kai Tak Cruise Terminal,4,0,8,12,18,0,2127,2145,Thursday
2023-03-30,Macau Ferry Terminal,5099,783,918,6800,5435,1160,861,7456,Thursday
2023-03-30,Total,147855,54556,14962,217373,170596,58154,15971,244721,Thursday
2023-03-31,Airport,20670,8068,11162,39900,38933,4640,6930,50503,Friday
2023-03-31,Express Rail Link West Kowloon,7011,11852,996,19859,19446,6291,385,26122,Friday
2023-03-31,Hung Hom,0,0,0,0,0,0,0,0,Friday
2023-03-31,Lo Wu,42533,12248,407,55188,61148,16252,549,77949,Friday
2023-03-31,Lok Ma Chau Spur Line,31885,10127,288,42300,49543,10775,225,60543,Friday
2023-03-31,Heung Yuen Wai,7689,4382,39,12110,10826,2303,19,13148,Friday
2023-03-31,Hong Kong-Zhuhai-Macao Bridge,15200,3948,2877,22025,20614,5636,2611,28861,Friday
2023-03-31,Lok Ma Chau,6942,1795,318,9055,7914,2662,249,10825,Friday
2023-03-31,Man Kam To,1670,509,16,2195,1990,460,12,2462,Friday
2023-03-31,Sha Tau Kok,0,0,0,0,0,0,0,0,Friday
2023-03-31,Shenzhen Bay,15041,7628,905,23574,24675,8725,685,34085,Friday
2023-03-31,China Ferry Terminal,731,659,57,1447,896,546,29,1471,Friday
2023-03-31,Harbour Control,0,0,0,0,0,0,0,0,Friday
2023-03-31,Kai Tak Cruise Terminal,959,51,24,1034,1730,31,26,1787,Friday
2023-03-31,Macau Ferry Terminal,4826,821,923,6570,6255,1194,933,8382,Friday
2023-03-31,Total,155157,62088,18012,235257,243970,59515,12653,316138,Friday
2023-04-01,Airport,20233,7497,12238,39968,42951,3696,6133,52780,Saturday
2023-04-01,Express Rail Link West Kowloon,7968,23269,986,32223,32084,15758,656,48498,Saturday
2023-04-01,Hung Hom,0,0,0,0,0,0,0,0,Saturday
2023-04-01,Lo Wu,44644,16741,437,61822,77681,21782,509,99972,Saturday
2023-04-01,Lok Ma Chau Spur Line,33847,18555,353,52755,62429,16588,306,79323,Saturday
2023-04-01,Heung Yuen Wai,9211,6871,40,16122,15150,3156,27,18333,Saturday
2023-04-01,Hong Kong-Zhuhai-Macao Bridge,17811,4113,4539,26463,29512,5581,3841,38934,Saturday
2023-04-01,Lok Ma Chau,8303,2138,275,10716,10567,3325,251,14143,Saturday
2023-04-01,Man Kam To,926,796,28,1750,2052,565,11,2628,Saturday
2023-04-01,Sha Tau Kok,0,0,0,0,0,0,0,0,Saturday
2023-04-01,Shenzhen Bay,15025,12100,806,27931,34367,11303,781,46451,Saturday
2023-04-01,China Ferry Terminal,456,962,78,1496,1518,529,32,2079,Saturday
2023-04-01,Harbour Control,0,0,0,0,0,0,0,0,Saturday
2023-04-01,Kai Tak Cruise Terminal,0,0,0,0,0,0,0,0,Saturday
2023-04-01,Macau Ferry Terminal,5275,935,1701,7911,8812,1058,1298,11168,Saturday
2023-04-01,Total,163699,93977,21481,279157,317123,83341,13845,414309,Saturday
2023-04-02,Airport,23030,6101,10358,39489,37175,5536,9270,51981,Sunday
2023-04-02,Express Rail Link West Kowloon,13412,11805,744,25961,24664,19622,992,45278,Sunday
2023-04-02,Hung Hom,0,0,0,0,0,0,0,0,Sunday
2023-04-02,Lo Wu,60267,10617,310,71194,50187,16730,452,67369,Sunday
2023-04-02,Lok Ma Chau Spur Line,46867,11073,258,58198,42139,13460,361,55960,Sunday
2023-04-02,Heung Yuen Wai,13839,3797,10,17646,11280,2723,20,14023,Sunday
2023-04-02,Hong Kong-Zhuhai-Macao Bridge,27992,2927,3584,34503,22391,6143,4719,33253,Sunday
2023-04-02,Lok Ma Chau,12130,1373,145,13648,7339,4171,325,11835,Sunday
2023-04-02,Man Kam To,1501,535,11,2047,1464,484,11,1959,Sunday
2023-04-02,Sha Tau Kok,0,0,0,0,0,0,0,0,Sunday
2023-04-02,Shenzhen Bay,24898,7431,556,32885,25181,10623,859,36663,Sunday
2023-04-02,China Ferry Terminal,727,467,47,1241,901,766,57,1724,Sunday
2023-04-02,Harbour Control,0,0,0,0,0,0,0,0,Sunday
2023-04-02,Kai Tak Cruise Terminal,1728,31,17,1776,836,0,54,890,Sunday
2023-04-02,Macau Ferry Terminal,8416,715,1094,10225,6549,1081,1443,9073,Sunday
2023-04-02,Total,234807,56872,17134,308813,230106,81339,18563,330008,Sunday
2023-04-03,Airport,17354,5598,8827,31779,31278,4536,10036,45850,Monday
2023-04-03,Express Rail Link West Kowloon,9556,8254,694,18504,24381,10259,808,35448,Monday
2023-04-03,Hung Hom,0,0,0,0,0,0,0,0,Monday
2023-04-03,Lo Wu,40810,8009,278,49097,53312,10004,416,63732,Monday
2023-04-03,Lok Ma Chau Spur Line,31420,7272,181,38873,39654,7641,246,47541,Monday
2023-04-03,Heung Yuen Wai,7868,3811,18,11697,9285,1352,18,10655,Monday
2023-04-03,Hong Kong-Zhuhai-Macao Bridge,16605,1929,2402,20936,20034,3071,2858,25963,Monday
2023-04-03,Lok Ma Chau,7447,1554,157,9158,6681,2808,265,9754,Monday
2023-04-03,Man Kam To,1580,468,4,2052,1699,368,7,2074,Monday
2023-04-03,Sha Tau Kok,0,0,0,0,0,0,0,0,Monday
2023-04-03,Shenzhen Bay,14443,5584,544,20571,24727,6953,785,32465,Monday
2023-04-03,China Ferry Terminal,499,353,58,910,1118,453,59,1630,Monday
2023-04-03,Harbour Control,0,0,0,0,0,0,0,0,Monday
2023-04-03,Kai Tak Cruise Terminal,0,0,0,0,0,0,0,0,Monday
2023-04-03,Macau Ferry Terminal,6387,777,1281,8445,6604,1319,1424,9347,Monday
2023-04-03,Total,153969,43609,14444,212022,218773,48764,16922,284459,Monday
2023-04-07,Airport,25465,5401,11774,42640,33517,4187,8081,45785,Friday
2023-04-07,Express Rail Link West Kowloon,16769,9233,574,26576,38695,6354,588,45637,Friday
2023-04-07,Hung Hom,0,0,0,0,0,0,0,0,Friday
2023-04-07,Lo Wu,56725,10211,360,67296,91412,11320,541,103273,Friday
2023-04-07,Lok Ma Chau Spur Line,41615,7559,228,49402,78555,6426,221,85202,Friday
2023-04-07,Heung Yuen Wai,10056,2774,25,12855,18876,930,17,19823,Friday
2023-04-07,Hong Kong-Zhuhai-Macao Bridge,32215,3201,7118,42534,56257,3875,6118,66250,Friday
2023-04-07,Lok Ma Chau,9585,1182,156,10923,11494,1548,253,13295,Friday
2023-04-07,Man Kam To,962,398,11,1371,1703,280,34,2017,Friday
2023-04-07,Sha Tau Kok,0,0,0,0,0,0,0,0,Friday
2023-04-07,Shenzhen Bay,21281,5325,491,27097,45219,4357,816,50392,Friday
2023-04-07,China Ferry Terminal,1097,432,43,1572,4044,310,40,4394,Friday
2023-04-07,Harbour Control,1,0,36,37,3,1,42,46,Friday
2023-04-07,Kai Tak Cruise Terminal,729,0,132,861,1763,43,72,1878,Friday
2023-04-07,Macau Ferry Terminal,9724,964,2475,13163,13467,996,1809,16272,Friday
2023-04-07,Total,226224,46680,23423,296327,395005,40627,18632,454264,Friday
2023-04-08,Airport,31803,4777,8523,45103,23236,4935,10075,38246,Saturday
2023-04-08,Express Rail Link West Kowloon,22944,18995,802,42741,20922,13599,705,35226,Saturday
2023-04-08,Hung Hom,0,0,0,0,0,0,0,0,Saturday
2023-04-08,Lo Wu,65735,15265,440,81440,61187,17883,384,79454,Saturday
2023-04-08,Lok Ma Chau Spur Line,47457,16980,271,64708,47096,14089,230,61415,Saturday
2023-04-08,Heung Yuen Wai,10351,7133,27,17511,12430,2749,15,15194,Saturday
2023-04-08,Hong Kong-Zhuhai-Macao Bridge,41134,3439,5190,49763,35938,4559,6379,46876,Saturday
2023-04-08,Lok Ma Chau,11559,1764,168,13491,7718,2289,257,10264,Saturday
2023-04-08,Man Kam To,1128,671,9,1808,1077,403,5,1485,Saturday
2023-04-08,Sha Tau Kok,0,0,0,0,0,0,0,0,Saturday
2023-04-08,Shenzhen Bay,25534,10105,556,36195,26077,8447,749,35273,Saturday
2023-04-08,China Ferry Terminal,1774,692,49,2515,2295,403,43,2741,Saturday
2023-04-08,Harbour Control,44,0,14,58,13,1,31,45,Saturday
2023-04-08,Kai Tak Cruise Terminal,0,0,0,0,0,0,0,0,Saturday
2023-04-08,Macau Ferry Terminal,10397,711,1912,13020,11409,1059,2129,14597,Saturday
2023-04-08,Total,269860,80532,17961,368353,249398,70416,21002,340816,Saturday
2023-04-09,Airport,43770,3770,7061,54601,26634,7025,13112,46771,Sunday
2023-04-09,Express Rail Link West Kowloon,34919,11454,582,46955,11709,15848,959,28516,Sunday
2023-04-09,Hung Hom,0,0,0,0,0,0,0,0,Sunday
2023-04-09,Lo Wu,99560,11902,362,111824,50735,16118,381,67234,Sunday
2023-04-09,Lok Ma Chau Spur Line,70587,12196,267,83050,40832,12969,320,54121,Sunday
2023-04-09,Heung Yuen Wai,14551,7801,38,22390,9504,2758,21,12283,Sunday
2023-04-09,Hong Kong-Zhuhai-Macao Bridge,52680,4373,4580,61633,37083,6709,6304,50096,Sunday
2023-04-09,Lok Ma Chau,14579,1829,147,16555,6772,2780,256,9808,Sunday
2023-04-09,Man Kam To,1445,779,10,2234,776,414,9,1199,Sunday
2023-04-09,Sha Tau Kok,0,0,0,0,0,0,0,0,Sunday
2023-04-09,Shenzhen Bay,45945,6855,474,53274,16661,8173,865,25699,Sunday
2023-04-09,China Ferry Terminal,3635,334,34,4003,1005,477,52,1534,Sunday
2023-04-09,Harbour Control,0,0,55,55,0,0,26,26,Sunday
2023-04-09,Kai Tak Cruise Terminal,1762,43,56,1861,1006,0,125,1131,Sunday
2023-04-09,Macau Ferry Terminal,12294,547,1342,14183,10951,938,2094,13983,Sunday
2023-04-09,Total,395727,61883,15008,472618,213668,74209,24524,312401,Sunday
2023-04-10,Airport,48380,3499,5143,57022,24601,4959,11284,40844,Monday
2023-04-10,Express Rail Link West Kowloon,42287,9217,409,51913,8847,6098,413,15358,Monday
2023-04-10,Hung Hom,0,0,0,0,0,0,0,0,Monday
2023-04-10,Lok Ma Chau Spur Line,96444,9489,227,106160,29619,5816,119,35554,Monday
2023-04-10,Heung Yuen Wai,21457,6069,28,27554,8887,1803,8,10698,Monday
2023-04-10,Hong Kong-Zhuhai-Macao Bridge,62603,4077,2926,69606,24822,8402,3933,37157,Monday
2023-04-10,Lok Ma Chau,22601,3960,229,26790,5775,1427,177,7379,Monday
2023-04-10,Man Kam To,2799,535,14,3348,733,243,7,983,Monday
2023-04-10,Sha Tau Kok,0,0,0,0,0,0,0,0,Monday
2023-04-10,Shenzhen Bay,60361,10325,485,71171,13504,4213,413,18130,Monday
2023-04-10,China Ferry Terminal,4302,597,41,4940,629,306,26,961,Monday
2023-04-10,Harbour Control,0,0,15,15,0,0,31,31,Monday
2023-04-10,Kai Tak Cruise Terminal,0,0,0,0,0,0,0,0,Monday
2023-04-10,Macau Ferry Terminal,14126,542,991,15659,8706,871,1499,11076,Monday
2023-04-10,Total,485979,58830,10959,555768,163679,42203,18200,224082,Monday
2023-04-12,Airport,35053,5086,13008,53147,22287,4604,9201,36092,Wednesday
2023-04-12,Express Rail Link West Kowloon,21970,16116,790,38876,8665,12478,749,21892,Wednesday
2023-04-12,Hung Hom,0,0,0,0,0,0,0,0,Wednesday
2023-04-12,Lo Wu,48560,12119,466,61145,38559,14314,516,53389,Wednesday
2023-04-12,Lok Ma Chau Spur Line,36035,10772,316,47123,28360,9792,288,38440,Wednesday
2023-04-12,Heung Yuen Wai,8160,6085,31,14276,7270,2706,24,10000,Wednesday
2023-04-12,Hong Kong-Zhuhai-Macao Bridge,23670,5055,2270,30995,17057,7632,2183,26872,Wednesday
2023-04-12,Lok Ma Chau,8066,3062,251,11379,5278,2883,277,8438,Wednesday
2023-04-12,Man Kam To,1187,543,7,1737,898,394,25,1317,Wednesday
2023-04-12,Sha Tau Kok,0,0,0,0,0,0,0,0,Wednesday
2023-04-12,Shenzhen Bay,23333,11006,620,34959,14310,8028,701,23039,Wednesday
2023-04-12,China Ferry Terminal,1058,964,93,2115,605,604,67,1276,Wednesday
2023-04-12,Harbour Control,0,0,76,76,1,2,16,19,Wednesday
2023-04-12,Kai Tak Cruise Terminal,1030,0,2851,3881,344,0,759,1103,Wednesday
2023-04-12,Macau Ferry Terminal,8233,890,1182,10305,6920,1412,1140,9472,Wednesday
2023-04-12,Total,216355,71698,21961,310014,150554,64849,15946,231349,Wednesday
2023-04-11,Airport,41402,4912,8422,54736,25537,4674,9068,39279,Tuesday
2023-04-11,Express Rail Link West Kowloon,31455,16159,735,48349,9617,8913,424,18954,Tuesday
2023-04-11,Hung Hom,0,0,0,0,0,0,0,0,Tuesday
2023-04-11,Lo Wu,56998,12351,445,69794,37455,12063,349,49867,Tuesday
2023-04-11,Lok Ma Chau Spur Line,42195,10585,262,53042,28021,8365,203,36589,Tuesday
2023-04-11,Heung Yuen Wai,9093,7067,35,16195,7106,2558,18,9682,Tuesday
2023-04-11,Hong Kong-Zhuhai-Macao Bridge,30628,4661,2469,37758,19525,8259,2273,30057,Tuesday
2023-04-11,Lok Ma Chau,12435,4154,293,16882,5278,2163,234,7675,Tuesday
2023-04-11,Man Kam To,1419,617,11,2047,843,394,12,1249,Tuesday
2023-04-11,Sha Tau Kok,0,0,0,0,0,0,0,0,Tuesday
2023-04-11,Shenzhen Bay,31565,12153,651,44369,14134,6236,592,20962,Tuesday
2023-04-11,China Ferry Terminal,1715,1291,77,3083,643,345,30,1018,Tuesday
2023-04-11,Harbour Control,8,0,53,61,0,1,26,27,Tuesday
2023-04-11,Kai Tak Cruise Terminal,0,0,0,0,0,0,0,0,Tuesday
2023-04-11,Macau Ferry Terminal,9389,764,1172,11325,7427,1066,1156,9649,Tuesday
2023-04-11,Total,268302,74714,14625,357641,155586,55037,14385,225008,Tuesday
2023-04-13,Airport,32049,6152,11956,50157,21549,4774,7444,33767,Thursday
2023-04-13,Express Rail Link West Kowloon,16500,15680,888,33068,8843,14317,963,24123,Thursday
2023-04-13,Hung Hom,0,0,0,0,0,0,0,0,Thursday
2023-04-13,Lo Wu,46472,12468,415,59355,39908,14756,533,55197,Thursday
2023-04-13,Lok Ma Chau Spur Line,34586,10866,240,45692,29625,10518,311,40454,Thursday
2023-04-13,Heung Yuen Wai,8277,6113,40,14430,7838,2272,26,10136,Thursday
2023-04-13,Hong Kong-Zhuhai-Macao Bridge,20664,5002,2344,28010,18232,8026,2326,28584,Thursday
2023-04-13,Lok Ma Chau,7474,2300,222,9996,5507,2946,345,8798,Thursday
2023-04-13,Man Kam To,1149,518,8,1675,1005,365,6,1376,Thursday
2023-04-13,Sha Tau Kok,0,0,0,0,0,0,0,0,Thursday
2023-04-13,Shenzhen Bay,20296,9719,573,30588,14671,8421,858,23950,Thursday
2023-04-13,China Ferry Terminal,835,980,81,1896,662,804,76,1542,Thursday
2023-04-13,Harbour Control,18,0,67,85,1,0,87,88,Thursday
2023-04-13,Kai Tak Cruise Terminal,0,0,0,0,33,0,2090,2123,Thursday
2023-04-13,Macau Ferry Terminal,7104,832,1233,9169,6898,1406,1211,9515,Thursday
2023-04-13,Total,195424,70630,18067,284121,154772,68605,16276,239653,Thursday
2023-04-14,Airport,34359,6142,11124,51625,23216,6439,9099,38754,Friday
2023-04-14,Express Rail Link West Kowloon,16554,19760,915,37229,13717,15341,2436,31494,Friday
2023-04-14,Hung Hom,0,0,0,0,0,0,0,0,Friday
2023-04-14,Lo Wu,47000,13903,584,61487,46176,15591,734,62501,Friday
2023-04-14,Lok Ma Chau Spur Line,34983,12458,334,47775,35595,10958,354,46907,Friday
2023-04-14,Heung Yuen Wai,8315,6431,50,14796,9213,2479,22,11714,Friday
2023-04-14,Hong Kong-Zhuhai-Macao Bridge,20415,5221,2942,28578,20697,8046,2525,31268,Friday
2023-04-14,Lok Ma Chau,8268,2502,266,11036,6703,4835,435,11973,Friday
2023-04-14,Man Kam To,1285,584,4,1873,1202,516,14,1732,Friday
2023-04-14,Sha Tau Kok,0,0,0,0,0,0,0,0,Friday
2023-04-14,Shenzhen Bay,20860,10511,747,32118,20582,11441,1445,33468,Friday
2023-04-14,China Ferry Terminal,906,1092,80,2078,1106,1011,131,2248,Friday
2023-04-14,Harbour Control,0,0,11,11,0,0,22,22,Friday
2023-04-14,Kai Tak Cruise Terminal,335,0,95,430,948,93,82,1123,Friday
2023-04-14,Macau Ferry Terminal,7123,1272,1616,10011,7800,1242,1497,10539,Friday
2023-04-14,Total,200403,79876,18768,299047,186955,77992,18796,283743,Friday
2023-04-15,Airport,36669,5257,8455,50381,21533,6475,10417,38425,Saturday
2023-04-15,Express Rail Link West Kowloon,18782,29682,822,49286,13983,19578,2027,35588,Saturday
2023-04-15,Hung Hom,0,0,0,0,0,0,0,0,Saturday
2023-04-15,Lo Wu,49735,20848,552,71135,57351,27664,821,85836,Saturday
2023-04-15,Lok Ma Chau Spur Line,38832,26438,382,65652,45605,22710,410,68725,Saturday
2023-04-15,Heung Yuen Wai,10624,9701,64,20389,13793,4362,51,18206,Saturday
2023-04-15,Hong Kong-Zhuhai-Macao Bridge,22005,6954,4790,33749,25743,8961,4052,38756,Saturday
2023-04-15,Lok Ma Chau,9659,2976,224,12859,8648,6366,445,15459,Saturday
2023-04-15,Man Kam To,1203,1059,14,2276,1321,659,14,1994,Saturday
2023-04-15,Sha Tau Kok,0,0,0,0,0,0,0,0,Saturday
2023-04-15,Shenzhen Bay,21577,17552,787,39916,23045,15265,1337,39647,Saturday
2023-04-15,China Ferry Terminal,904,1196,62,2162,1439,1079,113,2631,Saturday
2023-04-15,Harbour Control,7,0,18,25,1,0,1,2,Saturday
2023-04-15,Kai Tak Cruise Terminal,0,1,104,105,0,0,0,0,Saturday
2023-04-15,Macau Ferry Terminal,7026,1413,1946,10385,8517,1334,1737,11588,Saturday
2023-04-15,Total,217023,123077,18220,358320,220979,114453,21425,356857,Saturday
2023-04-16,Airport,39806,5666,8401,53873,23427,7818,12355,43600,Sunday
2023-04-22,Airport,19916,6743,12337,38996,20295,6883,12780,39958,Saturday
2023-04-16,Express Rail Link West Kowloon,22979,19677,748,43404,8817,24222,1672,34711,Sunday
2023-04-16,Hung Hom,0,0,0,0,0,0,0,0,Sunday
2023-04-16,Lo Wu,70697,15256,426,86379,43727,22442,620,66789,Sunday
2023-04-16,Lok Ma Chau Spur Line,51617,16761,278,68656,34421,18266,368,53055,Sunday
2023-04-16,Heung Yuen Wai,16374,8076,33,24483,11266,4893,30,16189,Sunday
2023-04-16,Hong Kong-Zhuhai-Macao Bridge,33087,6377,4418,43882,19623,7344,4893,31860,Sunday
2023-04-16,Lok Ma Chau,13897,2027,179,16103,6950,5692,529,13171,Sunday
2023-04-16,Man Kam To,1673,702,10,2385,909,572,21,1502,Sunday
2023-04-16,Sha Tau Kok,0,0,0,0,0,0,0,0,Sunday
2023-04-16,Shenzhen Bay,35013,10748,577,46338,18276,12465,1602,32343,Sunday
2023-04-16,China Ferry Terminal,1871,866,48,2785,682,890,103,1675,Sunday
2023-04-16,Harbour Control,0,0,26,26,4,0,22,26,Sunday
2023-04-16,Kai Tak Cruise Terminal,948,93,76,1117,876,0,996,1872,Sunday
2023-04-16,Macau Ferry Terminal,9218,1054,1497,11769,6599,1376,1820,9795,Sunday
2023-04-16,Total,297180,87303,16717,401200,175577,105980,25031,306588,Sunday
2023-04-17,Airport,27195,8233,11696,47124,21017,6266,9126,36409,Monday
2023-04-17,Express Rail Link West Kowloon,11670,15124,1027,27821,9550,12047,1111,22708,Monday
2023-04-17,Hung Hom,0,0,0,0,0,0,0,0,Monday
2023-04-17,Lo Wu,45751,11329,439,57519,42347,12404,518,55269,Monday
2023-04-17,Lok Ma Chau Spur Line,34674,9636,213,44523,33657,8988,286,42931,Monday
2023-04-17,Heung Yuen Wai,8221,6857,17,15095,8427,2358,30,10815,Monday
2023-04-17,Hong Kong-Zhuhai-Macao Bridge,16679,4244,2412,23335,14804,9140,2587,26531,Monday
2023-04-17,Lok Ma Chau,8457,3780,223,12460,5802,2892,610,9304,Monday
2023-04-17,Man Kam To,1959,662,17,2638,1631,453,18,2102,Monday
2023-04-17,Sha Tau Kok,0,0,0,0,0,0,0,0,Monday
2023-04-17,Shenzhen Bay,19933,11138,577,31648,16315,7619,1416,25350,Monday
2023-04-17,China Ferry Terminal,880,635,61,1576,731,539,69,1339,Monday
2023-04-17,Harbour Control,7,0,50,57,2,0,58,60,Monday
2023-04-17,Kai Tak Cruise Terminal,0,0,0,0,0,0,0,0,Monday
2023-04-17,Macau Ferry Terminal,6698,811,1254,8763,5442,1340,1187,7969,Monday
2023-04-17,Total,182124,72449,17986,272559,159725,64046,17016,240787,Monday
2023-04-18,Airport,22517,7425,12658,42600,20009,5888,8620,34517,Tuesday
2023-04-18,Express Rail Link West Kowloon,9506,15424,1409,26339,8665,12887,861,22413,Tuesday
2023-04-18,Hung Hom,0,0,0,0,0,0,0,0,Tuesday
2023-04-18,Lo Wu,42631,13026,562,56219,41329,15052,562,56943,Tuesday
2023-04-18,Lok Ma Chau Spur Line,32089,10859,265,43213,32418,10397,281,43096,Tuesday
2023-04-18,Heung Yuen Wai,8060,7104,29,15193,8581,2732,23,11336,Tuesday
2023-04-18,Hong Kong-Zhuhai-Macao Bridge,14159,4417,2687,21263,13912,9179,2772,25863,Tuesday
2023-04-18,Lok Ma Chau,6600,2908,366,9874,5857,2369,481,8707,Tuesday
2023-04-18,Man Kam To,1719,672,16,2407,1564,500,12,2076,Tuesday
2023-04-18,Sha Tau Kok,0,0,0,0,0,0,0,0,Tuesday
2023-04-18,Shenzhen Bay,17203,11106,930,29239,15629,8662,1021,25312,Tuesday
2023-04-18,China Ferry Terminal,679,726,103,1508,651,526,65,1242,Tuesday
2023-04-18,Harbour Control,8,0,41,49,4,0,56,60,Tuesday
2023-04-18,Kai Tak Cruise Terminal,0,0,0,0,0,0,0,0,Tuesday
2023-04-18,Macau Ferry Terminal,5439,1069,1266,7774,4955,1650,1264,7869,Tuesday
2023-04-18,Total,160610,74736,20332,255678,153574,69842,16018,239434,Tuesday
2023-04-19,Airport,20224,7128,13218,40570,20275,5843,9151,35269,Wednesday
2023-04-19,Express Rail Link West Kowloon,8476,13402,1812,23690,8302,12162,823,21287,Wednesday
2023-04-19,Hung Hom,0,0,0,0,0,0,0,0,Wednesday
2023-04-19,Lo Wu,38985,11169,572,50726,38106,13687,573,52366,Wednesday
2023-04-19,Lok Ma Chau Spur Line,29868,8923,310,39101,30164,9011,264,39439,Wednesday
2023-04-19,Heung Yuen Wai,6755,5566,50,12371,6958,3173,16,10147,Wednesday
2023-04-19,Hong Kong-Zhuhai-Macao Bridge,12628,5011,2208,19847,12230,7463,2426,22119,Wednesday
2023-04-19,Lok Ma Chau,6863,2454,424,9741,5548,2608,343,8499,Wednesday
2023-04-19,Man Kam To,1636,518,13,2167,1513,424,11,1948,Wednesday
2023-04-19,Sha Tau Kok,0,0,0,0,0,0,0,0,Wednesday
2023-04-19,Shenzhen Bay,14941,8622,1270,24833,13606,8326,914,22846,Wednesday
2023-04-19,China Ferry Terminal,581,450,117,1148,573,418,77,1068,Wednesday
2023-04-19,Harbour Control,9,0,72,81,0,0,48,48,Wednesday
2023-04-19,Kai Tak Cruise Terminal,864,0,342,1206,379,0,355,734,Wednesday
2023-04-19,Macau Ferry Terminal,4738,849,1209,6796,4488,1427,1206,7121,Wednesday
2023-04-19,Total,146568,64092,21617,232277,142142,64542,16207,222891,Wednesday
2023-04-20,Airport,18904,7472,14328,40704,21368,6320,10495,38183,Thursday
2023-04-20,Express Rail Link West Kowloon,8231,13725,1571,23527,9040,12221,1046,22307,Thursday
2023-04-20,Hung Hom,0,0,0,0,0,0,0,0,Thursday
2023-04-20,Lo Wu,39727,11368,572,51667,39814,13796,554,54164,Thursday
2023-04-20,Lok Ma Chau Spur Line,30509,9703,398,40610,31091,9302,293,40686,Thursday
2023-04-20,Heung Yuen Wai,7107,5976,100,13183,7458,2238,25,9721,Thursday
2023-04-20,Hong Kong-Zhuhai-Macao Bridge,12274,4071,2237,18582,13363,8212,2542,24117,Thursday
2023-04-20,Lok Ma Chau,6622,2173,562,9357,5382,2501,388,8271,Thursday
2023-04-20,Man Kam To,1691,588,18,2297,1605,470,10,2085,Thursday
2023-04-20,Sha Tau Kok,0,0,0,0,0,0,0,0,Thursday
2023-04-20,Shenzhen Bay,14730,7731,1408,23869,14736,8218,857,23811,Thursday
2023-04-20,China Ferry Terminal,593,496,100,1189,536,457,34,1027,Thursday
2023-04-20,Harbour Control,6,0,39,45,1,3,29,33,Thursday
2023-04-20,Kai Tak Cruise Terminal,0,0,0,0,0,0,0,0,Thursday
2023-04-20,Macau Ferry Terminal,4845,949,1416,7210,4830,1489,1577,7896,Thursday
2023-04-20,Total,145239,64252,22749,232240,149224,65227,17850,232301,Thursday
2023-04-21,Airport,20900,7272,14676,42848,23506,6734,12037,42277,Friday
2023-04-21,Express Rail Link West Kowloon,9054,18782,1274,29110,14881,14041,1250,30172,Friday
2023-04-21,Hung Hom,0,0,0,0,0,0,0,0,Friday
2023-04-21,Lo Wu,41163,12922,601,54686,49508,15743,571,65822,Friday
2023-04-21,Lok Ma Chau Spur Line,31892,11898,350,44140,39658,11018,258,50934,Friday
2023-04-21,Heung Yuen Wai,7488,7524,41,15053,9784,2557,23,12364,Friday
2023-04-21,Hong Kong-Zhuhai-Macao Bridge,13731,4859,3031,21621,18061,9679,3127,30867,Friday
2023-04-21,Lok Ma Chau,7053,2296,547,9896,6896,4541,356,11793,Friday
2023-04-21,Man Kam To,1663,627,38,2328,1824,543,13,2380,Friday
2023-04-21,Sha Tau Kok,0,0,0,0,0,0,0,0,Friday
2023-04-21,Shenzhen Bay,15467,8781,1223,25471,21021,11271,897,33189,Friday
2023-04-21,China Ferry Terminal,753,632,108,1493,979,473,51,1503,Friday
2023-04-21,Harbour Control,2,0,50,52,0,0,51,51,Friday
2023-04-21,Kai Tak Cruise Terminal,377,0,202,579,1318,170,122,1610,Friday
2023-04-21,Macau Ferry Terminal,5241,1052,1774,8067,7188,1484,1749,10421,Friday
2023-04-22,Express Rail Link West Kowloon,8923,20639,1099,30661,14689,20559,2275,37523,Saturday
2023-04-22,Hung Hom,0,0,0,0,0,0,0,0,Saturday
2023-04-22,Lo Wu,47015,16338,590,63943,63547,22886,640,87073,Saturday
2023-04-22,Lok Ma Chau Spur Line,36642,18633,365,55640,52247,18815,302,71364,Saturday
2023-04-22,Heung Yuen Wai,10198,9411,36,19645,15553,4323,23,19899,Saturday
2023-04-22,Hong Kong-Zhuhai-Macao Bridge,17382,6368,4667,28417,27006,9881,4229,41116,Saturday
2023-04-22,Lok Ma Chau,9022,2289,351,11662,9284,4939,404,14627,Saturday
2023-04-22,Man Kam To,1083,812,10,1905,1642,655,15,2312,Saturday
2023-04-22,Sha Tau Kok,0,0,0,0,0,0,0,0,Saturday
2023-04-22,Shenzhen Bay,17331,11819,875,30025,24951,12765,1088,38804,Saturday
2023-04-22,China Ferry Terminal,695,775,93,1563,1130,564,67,1761,Saturday
2023-04-22,Harbour Control,0,0,24,24,3,0,23,26,Saturday
2023-04-22,Kai Tak Cruise Terminal,0,0,0,0,0,0,0,0,Saturday
2023-04-22,Macau Ferry Terminal,5490,1077,2413,8980,9510,1329,1987,12826,Saturday
2023-04-22,Total,173697,94904,22860,291461,239857,103599,23833,367289,Saturday
2023-04-23,Airport,25392,7717,12055,45164,21021,7053,14928,43002,Sunday
2023-04-23,Express Rail Link West Kowloon,17548,14603,857,33008,9714,17853,1650,29217,Sunday
2023-04-23,Hung Hom,0,0,0,0,0,0,0,0,Sunday
2023-04-23,Lo Wu,67183,13031,419,80633,45292,16661,483,62436,Sunday
2023-04-23,Lok Ma Chau Spur Line,51802,12382,298,64482,36360,11331,285,47976,Sunday
2023-04-23,Heung Yuen Wai,17180,8680,26,25886,12099,4435,16,16550,Sunday
2023-04-23,Hong Kong-Zhuhai-Macao Bridge,32197,7174,4522,43893,19793,8747,5382,33922,Sunday
2023-04-23,Lok Ma Chau,13813,1944,204,15961,6992,3364,371,10727,Sunday
2023-04-23,Man Kam To,1572,785,19,2376,871,562,12,1445,Sunday
2023-04-23,Sha Tau Kok,0,0,0,0,0,0,0,0,Sunday
2023-04-23,Shenzhen Bay,29572,8686,735,38993,17846,8923,935,27704,Sunday
2023-04-23,China Ferry Terminal,1301,728,52,2081,565,640,52,1257,Sunday
2023-04-23,Harbour Control,0,0,33,33,0,0,43,43,Sunday
2023-04-23,Kai Tak Cruise Terminal,1318,170,113,1601,808,0,202,1010,Sunday
2023-04-23,Macau Ferry Terminal,9333,884,1770,11987,6381,1310,2201,9892,Sunday
2023-04-23,Total,268211,76784,21103,366098,177742,80879,26560,285181,Sunday
2023-04-24,Airport,21930,7549,11171,40650,18645,5541,12126,36312,Monday
2023-04-24,Express Rail Link West Kowloon,10719,12268,888,23875,10243,11083,1059,22385,Monday
2023-04-24,Hung Hom,0,0,0,0,0,0,0,0,Monday
2023-04-24,Lo Wu,44836,10533,345,55714,41495,11632,383,53510,Monday
2023-04-24,Lok Ma Chau Spur Line,33780,9772,201,43753,32888,9291,244,42423,Monday
2023-04-24,Heung Yuen Wai,8578,9239,17,17834,8408,2918,24,11350,Monday
2023-04-24,Hong Kong-Zhuhai-Macao Bridge,17283,4460,2737,24480,15265,10664,2920,28849,Monday
2023-04-24,Lok Ma Chau,8160,2405,224,10789,5675,2875,362,8912,Monday
2023-04-24,Man Kam To,1753,607,11,2371,1526,461,12,1999,Monday
2023-04-24,Sha Tau Kok,0,0,0,0,0,0,0,0,Monday
2023-04-24,Shenzhen Bay,18113,7753,610,26476,16220,7627,894,24741,Monday
2023-04-24,China Ferry Terminal,750,555,73,1378,780,421,65,1266,Monday
2023-04-24,Harbour Control,2,0,28,30,0,3,44,47,Monday
2023-04-24,Kai Tak Cruise Terminal,0,0,0,0,0,0,0,0,Monday
2023-04-24,Macau Ferry Terminal,6734,915,1808,9457,5728,1154,1615,8497,Monday
2023-04-24,Total,172638,66056,18113,256807,156873,63670,19748,240291,Monday
2023-04-25,Airport,22169,7722,9146,39037,17427,6213,12788,36428,Tuesday
2023-04-25,Express Rail Link West Kowloon,9618,11099,1178,21895,9614,10401,867,20882,Tuesday
2023-04-25,Hung Hom,0,0,0,0,0,0,0,0,Tuesday
2023-04-25,Lo Wu,41810,11656,476,53942,41341,13422,527,55290,Tuesday
2023-04-25,Lok Ma Chau Spur Line,31728,9196,207,41131,32288,9114,219,41621,Tuesday
2023-04-25,Heung Yuen Wai,7911,6038,31,13980,8502,3083,23,11608,Tuesday
2023-04-25,Hong Kong-Zhuhai-Macao Bridge,14273,4909,2787,21969,13922,10421,2659,27002,Tuesday
2023-04-25,Lok Ma Chau,6837,1883,299,9019,5750,1969,286,8005,Tuesday
2023-04-25,Man Kam To,1694,526,5,2225,1629,414,3,2046,Tuesday
2023-04-25,Sha Tau Kok,0,0,0,0,0,0,0,0,Tuesday
2023-04-25,Shenzhen Bay,15956,7686,767,24409,14827,7331,646,22804,Tuesday
2023-04-25,China Ferry Terminal,610,573,93,1276,666,566,39,1271,Tuesday
2023-04-25,Harbour Control,0,0,41,41,10,2,39,51,Tuesday
2023-04-25,Kai Tak Cruise Terminal,31,0,2078,2109,0,0,0,0,Tuesday
2023-04-25,Macau Ferry Terminal,5484,928,1626,8038,4993,1436,1603,8032,Tuesday
2023-04-25,Total,158121,62216,18734,239071,150969,64372,19699,235040,Tuesday
2023-04-26,Airport,20500,8106,10938,39544,19435,7176,13638,40249,Wednesday
2023-04-26,Express Rail Link West Kowloon,9573,12525,1461,23559,8996,10472,717,20185,Wednesday
2023-04-26,Hung Hom,0,0,0,0,0,0,0,0,Wednesday
2023-04-26,Lo Wu,42749,13045,452,56246,42175,14400,393,56968,Wednesday
2023-04-26,Lok Ma Chau Spur Line,32631,10566,262,43459,33185,9686,202,43073,Wednesday
2023-04-26,Heung Yuen Wai,8445,6080,25,14550,8928,2898,21,11847,Wednesday
2023-04-26,Hong Kong-Zhuhai-Macao Bridge,14309,5469,2735,22513,14225,8325,2737,25287,Wednesday
2023-04-26,Lok Ma Chau,7086,2252,424,9762,5897,2331,253,8481,Wednesday
2023-04-26,Man Kam To,1664,561,12,2237,1593,446,8,2047,Wednesday
2023-04-26,Sha Tau Kok,0,0,0,0,0,0,0,0,Wednesday
2023-04-26,Shenzhen Bay,15940,8952,1033,25925,15535,8082,732,24349,Wednesday
2023-04-26,China Ferry Terminal,685,637,91,1413,559,469,34,1062,Wednesday
2023-04-26,Harbour Control,2,0,49,51,2,0,56,58,Wednesday
2023-04-26,Kai Tak Cruise Terminal,731,0,464,1195,335,0,455,790,Wednesday
2023-04-26,Macau Ferry Terminal,5473,1038,1502,8013,5599,1559,1343,8501,Wednesday
2023-04-26,Total,159788,69231,19448,248467,156464,65844,20589,242897,Wednesday
2023-04-27,Airport,19034,9994,11568,40596,21255,9467,12242,42964,Thursday
2023-04-27,Express Rail Link West Kowloon,9697,14843,1619,26159,9776,11675,645,22096,Thursday
2023-04-27,Hung Hom,0,0,0,0,0,0,0,0,Thursday
2023-04-27,Lo Wu,43936,12511,482,56929,44109,14535,425,59069,Thursday
2023-04-27,Lok Ma Chau Spur Line,33869,10585,338,44792,35301,10127,201,45629,Thursday
2023-04-27,Heung Yuen Wai,8650,5851,31,14532,9521,2125,20,11666,Thursday
2023-04-27,Hong Kong-Zhuhai-Macao Bridge,15023,4318,2720,22061,16403,7799,2745,26947,Thursday
2023-04-27,Lok Ma Chau,7372,2374,503,10249,5954,2370,228,8552,Thursday
2023-04-27,Man Kam To,1723,697,23,2443,1696,558,7,2261,Thursday
2023-04-27,Sha Tau Kok,0,0,0,0,0,0,0,0,Thursday
2023-04-27,Shenzhen Bay,16845,9684,1313,27842,17262,8295,618,26175,Thursday
2023-04-27,China Ferry Terminal,612,694,87,1393,627,518,45,1190,Thursday
2023-04-27,Harbour Control,1,1,57,59,1,1,35,37,Thursday
2023-04-27,Kai Tak Cruise Terminal,0,1,677,678,5,3,2256,2264,Thursday
2023-04-27,Macau Ferry Terminal,5538,1059,1688,8285,5677,1625,1618,8920,Thursday
2023-04-27,Total,162300,72612,21106,256018,167587,69098,21085,257770,Thursday
2023-04-28,Airport,18518,11095,14462,44075,25757,12030,11397,49184,Friday
2023-04-28,Express Rail Link West Kowloon,10816,25918,1522,38256,15318,11334,529,27181,Friday
2023-04-28,Hung Hom,0,0,0,0,0,0,0,0,Friday
2023-04-28,Lo Wu,45754,16426,636,62816,58374,16416,478,75268,Friday
2023-04-28,Lok Ma Chau Spur Line,35716,14278,426,50420,44245,11367,198,55810,Friday
2023-04-28,Heung Yuen Wai,8707,4688,42,13437,12002,2770,29,14801,Friday
2023-04-28,Hong Kong-Zhuhai-Macao Bridge,17212,5778,3579,26569,23208,7093,3067,33368,Friday
2023-04-28,Lok Ma Chau,7881,3412,570,11863,7383,2853,207,10443,Friday
2023-04-28,Man Kam To,1571,835,23,2429,1826,539,11,2376,Friday
2023-04-28,Sha Tau Kok,0,0,0,0,0,0,0,0,Friday
2023-04-28,Shenzhen Bay,19412,13928,1541,34881,25190,8942,574,34706,Friday
2023-04-28,China Ferry Terminal,816,1039,129,1984,1334,515,55,1904,Friday
2023-04-28,Harbour Control,3,3,52,58,0,0,61,61,Friday
2023-04-28,Kai Tak Cruise Terminal,414,0,341,755,1390,282,923,2595,Friday
2023-04-28,Macau Ferry Terminal,5603,1216,1616,8435,7727,1577,1375,10679,Friday
2023-04-28,Total,172423,98616,24939,295978,223754,75718,18904,318376,Friday
2023-04-29,Airport,17557,12068,15082,44707,22088,13292,11190,46570,Saturday
2023-04-29,Express Rail Link West Kowloon,8700,44988,1396,55084,20323,17190,642,38155,Saturday
2023-04-29,Hung Hom,0,0,0,0,0,0,0,0,Saturday
2023-04-29,Lo Wu,43576,26854,683,71113,77224,25772,620,103616,Saturday
2023-04-29,Lok Ma Chau Spur Line,33918,29406,473,63797,57752,20853,301,78906,Saturday
2023-04-29,Heung Yuen Wai,10197,9213,82,19492,17761,3322,26,21109,Saturday
2023-04-29,Hong Kong-Zhuhai-Macao Bridge,18738,7329,5264,31331,30246,7844,4479,42569,Saturday
2023-04-29,Lok Ma Chau,10035,6000,632,16667,10823,5367,274,16464,Saturday
2023-04-29,Man Kam To,1208,1544,29,2781,1870,720,12,2602,Saturday
2023-04-29,Sha Tau Kok,0,0,0,0,0,0,0,0,Saturday
2023-04-29,Shenzhen Bay,16749,23853,1416,42018,33249,13042,585,46876,Saturday
2023-04-29,China Ferry Terminal,866,2557,142,3565,2452,852,68,3372,Saturday
2023-04-29,Harbour Control,32,2,18,52,1,0,38,39,Saturday
2023-04-29,Kai Tak Cruise Terminal,0,0,0,0,0,0,0,0,Saturday
2023-04-29,Macau Ferry Terminal,6501,1855,2411,10767,8976,2293,2164,13433,Saturday
2023-04-29,Total,168077,165669,27628,361374,282765,110547,20399,413711,Saturday
2023-04-30,Airport,22969,9444,10032,42445,17714,9184,13214,40112,Sunday
2023-04-30,Express Rail Link West Kowloon,12516,36327,1016,49859,12689,20247,1015,33951,Sunday
2023-04-30,Hung Hom,0,0,0,0,0,0,0,0,Sunday
2023-04-30,Lo Wu,58583,26579,651,85813,63373,33579,772,97724,Sunday
2023-04-30,Lok Ma Chau Spur Line,45655,32651,544,78850,54446,27115,428,81989,Sunday
2023-04-30,Heung Yuen Wai,12705,10723,54,23482,15736,3778,27,19541,Sunday
2023-04-30,Hong Kong-Zhuhai-Macao Bridge,27635,9623,6036,43294,28705,10998,5897,45600,Sunday
2023-04-30,Lok Ma Chau,13647,4751,347,18745,10265,6884,297,17446,Sunday
2023-04-30,Man Kam To,1131,1523,14,2668,1289,799,11,2099,Sunday
2023-04-30,Sha Tau Kok,0,0,0,0,0,0,0,0,Sunday
2023-04-30,Shenzhen Bay,23560,19837,1048,44445,24323,15604,878,40805,Sunday
2023-04-30,China Ferry Terminal,1127,2001,98,3226,1015,1076,93,2184,Sunday
2023-04-30,Harbour Control,0,0,36,36,0,1,27,28,Sunday
2023-04-30,Kai Tak Cruise Terminal,1390,281,234,1905,1153,0,354,1507,Sunday
2023-04-30,Macau Ferry Terminal,6874,2573,2399,11846,7310,3221,2402,12933,Sunday
2023-04-30,Total,227792,156313,22509,406614,238018,132486,25415,395919,Sunday
2023-05-01,Airport,30221,7340,7966,45527,13817,7776,16127,37720,Monday
2023-05-01,Express Rail Link West Kowloon,25928,30999,836,57763,6995,24182,921,32098,Monday
2023-05-01,Hung Hom,0,0,0,0,0,0,0,0,Monday
2023-05-01,Lo Wu,75276,20459,534,96269,31010,29304,527,60841,Monday
2023-05-01,Lok Ma Chau Spur Line,58532,26375,346,85253,26188,25857,299,52344,Monday
2023-05-01,Heung Yuen Wai,18772,7528,56,26356,9412,4261,39,13712,Monday
2023-05-01,Hong Kong-Zhuhai-Macao Bridge,37769,9937,3460,51166,14700,12289,4718,31707,Monday
2023-05-01,Lok Ma Chau,17680,3733,221,21634,5576,7272,296,13144,Monday
2023-05-01,Man Kam To,2139,1257,18,3414,808,719,5,1532,Monday
2023-05-01,Sha Tau Kok,0,0,0,0,0,0,0,0,Monday
2023-05-01,Shenzhen Bay,38379,16480,607,55466,12137,16061,782,28980,Monday
2023-05-01,China Ferry Terminal,2692,1966,80,4738,464,1573,65,2102,Monday
2023-05-01,Harbour Control,0,0,37,37,1,0,21,22,Monday
2023-05-01,Kai Tak Cruise Terminal,0,0,0,0,0,0,0,0,Monday
2023-05-01,Macau Ferry Terminal,8887,3275,1512,13674,3890,4883,1781,10554,Monday
2023-05-01,Total,316275,129349,15673,461297,124998,134177,25581,284756,Monday
2023-05-02,Airport,22359,8947,8618,39924,15314,9974,11928,37216,Tuesday
2023-05-02,Express Rail Link West Kowloon,9881,26453,983,37317,7020,32926,869,40815,Tuesday
2023-05-02,Hung Hom,0,0,0,0,0,0,0,0,Tuesday
2023-05-02,Lo Wu,37715,17018,371,55104,32215,32193,544,64952,Tuesday
2023-05-02,Lok Ma Chau Spur Line,28818,22179,297,51294,27590,29822,350,57762,Tuesday
2023-05-02,Heung Yuen Wai,7221,5671,34,12926,6768,4002,25,10795,Tuesday
2023-05-02,Hong Kong-Zhuhai-Macao Bridge,12088,6591,2169,20848,9861,10517,2473,22851,Tuesday
2023-05-02,Lok Ma Chau,8490,3038,184,11712,5155,6412,318,11885,Tuesday
2023-05-02,Man Kam To,1654,1153,11,2818,1554,928,6,2488,Tuesday
2023-05-02,Sha Tau Kok,0,0,0,0,0,0,0,0,Tuesday
2023-05-02,Shenzhen Bay,15450,14312,718,30480,12817,22155,957,35929,Tuesday
2023-05-02,China Ferry Terminal,976,1637,82,2695,650,2149,66,2865,Tuesday
2023-05-02,Harbour Control,0,0,34,34,43,0,49,92,Tuesday
2023-05-02,Kai Tak Cruise Terminal,0,0,0,0,0,0,0,0,Tuesday
2023-05-02,Macau Ferry Terminal,3835,2618,1436,7889,3172,3545,1471,8188,Tuesday
2023-05-02,Total,148487,109617,14937,273041,122159,154623,19056,295838,Tuesday
2023-05-03,Airport,17070,13733,11080,41883,16996,10803,9811,37610,Wednesday
2023-05-03,Express Rail Link West Kowloon,6955,12617,952,20524,8329,36954,1262,46545,Wednesday
2023-05-03,Hung Hom,0,0,0,0,0,0,0,0,Wednesday
2023-05-03,Lo Wu,33924,9712,308,43944,33748,20054,465,54267,Wednesday
2023-05-03,Lok Ma Chau Spur Line,25959,10519,182,36660,28544,18416,383,47343,Wednesday
2023-05-03,Heung Yuen Wai,6518,2926,44,9488,7228,3339,41,10608,Wednesday
2023-05-03,Hong Kong-Zhuhai-Macao Bridge,10047,3460,2068,15575,10106,5957,2485,18548,Wednesday
2023-05-03,Lok Ma Chau,6220,1825,178,8223,5397,5906,405,11708,Wednesday
2023-05-03,Man Kam To,1671,607,8,2286,1585,738,3,2326,Wednesday
2023-05-03,Sha Tau Kok,0,0,0,0,0,0,0,0,Wednesday
2023-05-03,Shenzhen Bay,12395,7293,646,20334,13699,18745,1308,33752,Wednesday
2023-05-03,China Ferry Terminal,553,585,60,1198,792,2112,89,2993,Wednesday
2023-05-03,Harbour Control,0,0,25,25,2,0,20,22,Wednesday
2023-05-03,Kai Tak Cruise Terminal,1011,0,516,1527,275,2,522,799,Wednesday
2023-05-03,Macau Ferry Terminal,3088,1313,1235,5636,3317,1881,1412,6610,Wednesday
2023-05-03,Total,125411,64590,17302,207303,130018,124907,18206,273131,Wednesday
2023-05-04,Airport,14277,11613,12063,37953,19030,7694,8460,35184,Thursday
2023-05-04,Express Rail Link West Kowloon,7891,10159,983,19033,8977,11441,733,21151,Thursday
2023-05-04,Hung Hom,0,0,0,0,0,0,0,0,Thursday
2023-05-04,Lo Wu,38725,9745,366,48836,38400,11327,444,50171,Thursday
2023-05-04,Lok Ma Chau Spur Line,29965,8364,169,38498,32561,9532,224,42317,Thursday
2023-05-04,Heung Yuen Wai,7935,2583,34,10552,8777,1533,41,10351,Thursday
2023-05-04,Hong Kong-Zhuhai-Macao Bridge,11136,2966,2318,16420,12496,3802,2389,18687,Thursday
2023-05-04,Lok Ma Chau,6761,1471,166,8398,5892,3552,316,9760,Thursday
2023-05-04,Man Kam To,1661,487,7,2155,1508,391,14,1913,Thursday
2023-05-04,Sha Tau Kok,0,0,0,0,0,0,0,0,Thursday
2023-05-04,Shenzhen Bay,14007,6411,558,20976,14603,8325,722,23650,Thursday
2023-05-04,China Ferry Terminal,503,513,40,1056,557,506,36,1099,Thursday
2023-05-04,Harbour Control,3,0,29,32,0,0,61,61,Thursday
2023-05-04,Kai Tak Cruise Terminal,0,0,0,0,0,0,0,0,Thursday
2023-05-04,Macau Ferry Terminal,2926,896,1333,5155,3785,1320,1486,6591,Thursday
2023-05-04,Total,135790,55208,18066,209064,146586,59423,14926,220935,Thursday
2023-05-05,Airport,14450,8908,11971,35329,22283,6145,9834,38262,Friday
2023-05-05,Express Rail Link West Kowloon,8269,14144,1090,23503,12619,10085,688,23392,Friday
2023-05-05,Hung Hom,0,0,0,0,0,0,0,0,Friday
2023-05-05,Lo Wu,40765,11654,367,52786,46835,13607,407,60849,Friday
2023-05-05,Lok Ma Chau Spur Line,32265,11081,223,43569,38989,10885,220,50094,Friday
2023-05-05,Heung Yuen Wai,7946,3212,53,11211,10107,1896,32,12035,Friday
2023-05-05,Hong Kong-Zhuhai-Macao Bridge,12989,3476,2841,19306,17173,3842,2493,23508,Friday
2023-05-05,Lok Ma Chau,7076,2127,189,9392,6882,3517,283,10682,Friday
2023-05-05,Man Kam To,1676,609,14,2299,1743,480,4,2227,Friday
2023-05-05,Sha Tau Kok,0,0,0,0,0,0,0,0,Friday
2023-05-05,Shenzhen Bay,15192,8334,655,24181,18237,8267,586,27090,Friday
2023-05-05,China Ferry Terminal,617,647,63,1327,737,407,38,1182,Friday
2023-05-05,Harbour Control,0,0,22,22,0,0,10,10,Friday
2023-05-05,Kai Tak Cruise Terminal,416,0,299,715,1209,95,195,1499,Friday
2023-05-05,Macau Ferry Terminal,4361,1111,2375,7847,6757,1245,1824,9826,Friday
2023-05-05,Total,146022,65303,20162,231487,183571,60471,16614,260656,Friday
2023-05-06,Airport,16141,7992,9535,33668,19910,6882,11076,37868,Saturday
2023-05-06,Express Rail Link West Kowloon,8284,16120,940,25344,14171,13023,719,27913,Saturday
2023-05-06,Hung Hom,0,0,0,0,0,0,0,0,Saturday
2023-05-06,Lo Wu,45069,12099,301,57469,61844,14032,348,76224,Saturday
2023-05-06,Lok Ma Chau Spur Line,37306,12563,240,50109,52830,12266,230,65326,Saturday
2023-05-06,Heung Yuen Wai,10820,3889,33,14742,15807,2175,50,18032,Saturday
2023-05-06,Hong Kong-Zhuhai-Macao Bridge,16881,3715,4537,25133,25558,4673,3926,34157,Saturday
2023-05-06,Lok Ma Chau,9045,2093,173,11311,9550,4727,244,14521,Saturday
2023-05-06,Man Kam To,1172,686,12,1870,1566,501,12,2079,Saturday
2023-05-06,Sha Tau Kok,0,0,0,0,0,0,0,0,Saturday
2023-05-06,Shenzhen Bay,16577,8833,623,26033,22575,8563,673,31811,Saturday
2023-05-06,China Ferry Terminal,525,776,69,1370,742,494,49,1285,Saturday
2023-05-06,Harbour Control,0,0,18,18,3,0,20,23,Saturday
2023-05-06,Kai Tak Cruise Terminal,0,0,0,0,0,0,0,0,Saturday
2023-05-06,Macau Ferry Terminal,5692,894,2469,9055,9833,1180,2223,13236,Saturday
2023-05-06,Total,167512,69660,18950,256122,234389,68516,19570,322475,Saturday
2023-05-08,Airport,18962,7790,10602,37354,21235,6004,9948,37187,Monday
2023-05-08,Express Rail Link West Kowloon,8732,10583,543,19858,9858,10279,761,20898,Monday
2023-05-08,Hung Hom,0,0,0,0,0,0,0,0,Monday
2023-05-08,Lo Wu,43257,9541,333,53131,41367,10042,453,51862,Monday
2023-05-08,Lok Ma Chau Spur Line,32875,8467,214,41556,33860,8108,281,42249,Monday
2023-05-08,Heung Yuen Wai,7948,4905,21,12874,8159,1483,52,9694,Monday
2023-05-08,Hong Kong-Zhuhai-Macao Bridge,14613,3361,2390,20364,13562,6812,2480,22854,Monday
2023-05-08,Lok Ma Chau,7908,2324,132,10364,6564,5633,450,12647,Monday
2023-05-08,Man Kam To,1777,510,5,2292,1616,354,1,1971,Monday
2023-05-08,Sha Tau Kok,0,0,0,0,0,0,0,0,Monday
2023-05-08,Shenzhen Bay,15185,6866,434,22485,15680,6998,880,23558,Monday
2023-05-08,China Ferry Terminal,534,470,45,1049,757,508,61,1326,Monday
2023-05-08,Harbour Control,0,0,28,28,0,1,38,39,Monday
2023-05-08,Kai Tak Cruise Terminal,0,0,0,0,0,0,0,0,Monday
2023-05-08,Macau Ferry Terminal,6440,674,1207,8321,5088,1017,1246,7351,Monday
2023-05-08,Total,158231,55491,15954,229676,157746,57239,16651,231636,Monday
2023-05-07,Airport,21682,9280,10247,41209,19720,7596,14718,42034,Sunday
2023-05-07,Express Rail Link West Kowloon,14450,16738,634,31822,8624,16305,1015,25944,Sunday
2023-05-07,Hung Hom,0,0,0,0,0,0,0,0,Sunday
2023-05-07,Lo Wu,59317,11195,315,70827,38568,14242,367,53177,Sunday
2023-05-07,Lok Ma Chau Spur Line,45638,13351,176,59165,31991,12666,304,44961,Sunday
2023-05-07,Heung Yuen Wai,14369,5611,34,20014,10091,2559,51,12701,Sunday
2023-05-07,Hong Kong-Zhuhai-Macao Bridge,28258,4020,3667,35945,17906,5252,4450,27608,Sunday
2023-05-07,Lok Ma Chau,12562,2110,114,14786,6674,5051,431,12156,Sunday
2023-05-07,Man Kam To,1218,500,11,1729,720,362,8,1090,Sunday
2023-05-07,Sha Tau Kok,0,0,0,0,0,0,0,0,Sunday
2023-05-07,Shenzhen Bay,23872,9150,423,33445,14917,10112,1110,26139,Sunday
2023-05-07,China Ferry Terminal,975,670,37,1682,382,625,69,1076,Sunday
2023-05-07,Harbour Control,1,0,38,39,38,2,25,65,Sunday
2023-05-07,Kai Tak Cruise Terminal,1208,95,183,1486,996,0,293,1289,Sunday
2023-05-07,Macau Ferry Terminal,9590,793,1405,11788,6321,1099,1710,9130,Sunday
2023-05-07,Total,233140,73513,17284,323937,156948,75871,24551,257370,Sunday
2023-05-09,Airport,17266,7557,9850,34673,20849,5757,9279,35885,Tuesday
2023-05-09,Express Rail Link West Kowloon,8155,11356,591,20102,9400,9311,753,19464,Tuesday
2023-05-09,Hung Hom,0,0,0,0,0,0,0,0,Tuesday
2023-05-09,Lo Wu,43159,10183,333,53675,42442,10729,401,53572,Tuesday
2023-05-09,Lok Ma Chau Spur Line,34333,10570,202,45105,36328,10351,234,46913,Tuesday
2023-05-09,Heung Yuen Wai,8837,5033,32,13902,9550,2163,47,11760,Tuesday
2023-05-09,Hong Kong-Zhuhai-Macao Bridge,14347,4018,2529,20894,14245,5979,2567,22791,Tuesday
2023-05-09,Lok Ma Chau,7588,1766,150,9504,6336,2078,317,8731,Tuesday
2023-05-09,Man Kam To,1688,571,10,2269,1620,475,13,2108,Tuesday
2023-05-09,Sha Tau Kok,0,0,0,0,0,0,0,0,Tuesday
2023-05-09,Shenzhen Bay,16189,7411,506,24106,16241,6803,720,23764,Tuesday
2023-05-09,China Ferry Terminal,468,579,74,1121,637,451,44,1132,Tuesday
2023-05-09,Harbour Control,0,0,50,50,0,0,20,20,Tuesday
2023-05-09,Kai Tak Cruise Terminal,0,0,0,0,0,0,0,0,Tuesday
2023-05-09,Macau Ferry Terminal,5123,908,1321,7352,5080,1208,1404,7692,Tuesday
2023-05-09,Total,157153,59952,15648,232753,162728,55305,15799,233832,Tuesday
